game_ID, date, away_name, away_record, away_half1, away_half2, away_OT, away_final, home_name, home_record, home_half1, home_half2, home_OT, home_final
400585875, 2014-11-14, Texas Southern, (0-1; 0-1 away), 30, 32, 0, 62, E Washington, (1-0; 1-0 home), 32, 54, 0, 86
400595560, 2014-11-14, Non D-I School, NA, 22, 30, 0, 52, Sam Houston, (1-0; 1-0 home), 55, 45, 0, 100
400587365, 2014-11-14, Non D-I School, NA, 30, 22, 0, 52, E Michigan, (1-0; 1-0 home), 32, 32, 0, 64
400586110, 2014-11-14, Cent Conn St, (0-1; 0-0 away), 26, 37, 0, 63, Fairfield, (1-0; 0-0 home), 35, 36, 0, 71
400586111, 2014-11-14, Yale, (0-1; 0-1 away), 40, 27, 18, 85, Quinnipiac, (1-0; 1-0 home), 38, 29, 21, 88
400589067, 2014-11-14, Non D-I School, NA, 21, 32, 0, 53, Chattanooga, (1-0; 1-0 home), 62, 48, 0, 110
400589070, 2014-11-14, The Citadel, (0-1; 0-0 away), 38, 27, 0, 65, VMI, (1-0; 0-0 home), 32, 34, 0, 66
400587747, 2014-11-14, Presbyterian, (0-1; 0-1 away), 19, 25, 0, 44, Duke, (1-0; 1-0 home), 57, 56, 0, 113
400597287, 2014-11-14, William & Mary, (0-1; 0-1 away), 18, 27, 0, 45, Florida, (1-0; 1-0 home), 42, 26, 0, 68
400591336, 2014-11-14, Non D-I School, NA, 30, 32, 0, 62, North Texas, (1-0; 1-0 home), 42, 42, 0, 84
400591082, 2014-11-14, Tennessee, (0-1; 0-0 away), 30, 39, 0, 69, VCU, (1-0; 0-0 home), 48, 37, 0, 85
400587210, 2014-11-14, Boise State, (1-0; 0-0 away), 35, 46, 0, 81, San Diego, (0-1; 0-0 home), 33, 42, 0, 75
400589073, 2014-11-14, W Carolina, (0-1; 0-1 away), 30, 26, 0, 56, Miss St, (1-0; 1-0 home), 31, 35, 0, 66
400587753, 2014-11-14, UVA, (1-0; 1-0 away), 51, 28, 0, 79, JMU, (0-1; 0-1 home), 33, 18, 0, 51
400586485, 2014-11-14, Bryant, (0-1; 0-1 away), 34, 19, 0, 53, UConn, (1-0; 1-0 home), 28, 38, 0, 66
400595357, 2014-11-14, UMass Lowell, (0-1; 0-1 away), 25, 30, 0, 55, OSU, (1-0; 1-0 home), 47, 45, 0, 92
400588634, 2014-11-14, Kennesaw St, (0-1; 0-1 away), 16, 26, 0, 42, Syracuse, (1-0; 1-0 home), 36, 53, 0, 89
400591290, 2014-11-14, Non D-I School, NA, 27, 25, 0, 52, Harvard, (1-0; 1-0 home), 42, 31, 0, 73
400585675, 2014-11-14, Monmouth, (0-1; 0-1 away), 26, 28, 0, 54, West Virginia, (1-0; 1-0 home), 21, 43, 0, 64
400585874, 2014-11-14, N Arizona, (0-1; 0-1 away), 22, 38, 0, 60, Xavier, (1-0; 1-0 home), 48, 45, 0, 93
400586107, 2014-11-14, Marist, (0-1; 0-1 away), 33, 39, 0, 72, Bucknell, (1-0; 1-0 home), 37, 38, 0, 75
400586108, 2014-11-14, Cleveland State, (0-1; 0-1 away), 32, 41, 0, 73, Iona, (1-0; 1-0 home), 39, 39, 0, 78
400586109, 2014-11-14, Niagara, (0-1; 0-1 away), 22, 23, 0, 45, Pitt, (1-0; 1-0 home), 46, 32, 0, 78
400586112, 2014-11-14, Rider, (0-1; 0-1 away), 25, 33, 0, 58, Princeton, (1-0; 1-0 home), 28, 36, 0, 64
400586113, 2014-11-14, Siena, (0-1; 0-1 away), 41, 46, 0, 87, UMass, (1-0; 1-0 home), 36, 59, 0, 95
400586481, 2014-11-14, Non D-I School, NA, 27, 54, 0, 81, ECU, (1-0; 1-0 home), 48, 51, 0, 99
400586482, 2014-11-14, Non D-I School, NA, 27, 34, 0, 61, USF, (1-0; 1-0 home), 45, 30, 0, 75
400586864, 2014-11-14, Non D-I School, NA, 26, 24, 0, 50, IPFW, (1-0; 1-0 home), 41, 33, 0, 74
400587028, 2014-11-14, Lafayette, (1-0; 1-0 away), 36, 41, 0, 77, Robert Morris, (0-1; 0-1 home), 16, 34, 0, 50
400587214, 2014-11-14, LBSU, (0-1; 0-1 away), 47, 43, 0, 90, BYU, (1-0; 1-0 home), 46, 49, 0, 95
400587387, 2014-11-14, Alma,  , 30, 34, 0, 64, Cent Michigan, (1-0; 1-0 home), 61, 45, 0, 106
400587749, 2014-11-14, MD-E Shore, (0-1; 0-1 away), 20, 26, 0, 46, VT, (1-0; 1-0 home), 30, 41, 0, 71
400587750, 2014-11-14, UNH, (0-1; 0-1 away), 18, 32, 0, 50, Boston College, (1-0; 1-0 home), 28, 30, 0, 58
400587751, 2014-11-14, Florida A&M, (0-1; 0-1 away), 18, 23, 0, 41, Clemson, (1-0; 1-0 home), 41, 45, 0, 86
400587752, 2014-11-14, Georgia, (0-1; 0-1 away), 32, 41, 0, 73, Georgia Tech, (1-0; 1-0 home), 42, 38, 0, 80
400587754, 2014-11-14, UNC Asheville, (0-1; 0-1 away), 32, 37, 0, 69, Wake Forest, (1-0; 1-0 home), 37, 43, 0, 80
400587756, 2014-11-14, Howard, (0-1; 0-1 away), 21, 28, 0, 49, Miami (FL), (1-0; 1-0 home), 45, 39, 0, 84
400587757, 2014-11-14, Jackson State, (0-1; 0-1 away), 26, 32, 0, 58, NC State, (1-0; 1-0 home), 47, 46, 0, 93
400588485, 2014-11-14, NJIT, (0-1; 0-1 away), 19, 39, 0, 58, St John's, (1-0; 1-0 home), 37, 40, 0, 77
400588631, 2014-11-14, North Florida, (0-1; 0-1 away), 27, 29, 0, 56, South Carolina, (1-0; 1-0 home), 48, 33, 0, 81
400589068, 2014-11-14, Piedmont,  , 21, 27, 0, 48, Mercer, (1-0; 1-0 home), 42, 46, 0, 88
400589069, 2014-11-14, Non D-I School, NA, 25, 37, 0, 62, UNC Greensboro, (1-0; 1-0 home), 44, 32, 0, 76
400589072, 2014-11-14, Samford, (0-1; 0-1 away), 16, 24, 0, 40, Purdue, (1-0; 1-0 home), 43, 37, 0, 80
400589239, 2014-11-14, Charleston So, (1-0; 1-0 away), 29, 28, 9, 66, Ole Miss, (0-1; 0-1 home), 17, 40, 8, 65
400589241, 2014-11-14, Averett,  , 24, 29, 0, 53, Longwood, (1-0; 1-0 home), 45, 34, 0, 79
400591080, 2014-11-14, Grambling St, (0-1; 0-1 away), 15, 25, 0, 40, G Washington, (1-0; 1-0 home), 47, 45, 0, 92
400591081, 2014-11-14, Alabama A&M, (0-1; 0-1 away), 25, 27, 0, 52, Dayton, (1-0; 1-0 home), 43, 33, 0, 76
400591084, 2014-11-14, Pace,  , 22, 32, 0, 54, URI, (1-0; 1-0 home), 51, 43, 0, 94
400591085, 2014-11-14, Fair Dickinson, (1-0; 1-0 away), 28, 30, 0, 58, Saint Joe's, (0-1; 0-1 home), 25, 32, 0, 57
400591238, 2014-11-14, Columbia, (0-1; 0-1 away), 31, 25, 0, 56, Stony Brook, (1-0; 1-0 home), 25, 32, 0, 57
400591334, 2014-11-14, Jacksonville St, (0-1; 0-1 away), 24, 31, 0, 55, Marshall, (1-0; 1-0 home), 35, 39, 0, 74
400594865, 2014-11-14, Non D-I School, NA, 25, 30, 0, 55, Georgia State, (1-0; 1-0 home), 54, 61, 0, 115
400595356, 2014-11-14, Miss Valley St, (0-1; 0-1 away), 31, 34, 0, 65, Indiana, (1-0; 1-0 home), 54, 62, 0, 116
400595358, 2014-11-14, Morgan State, (0-1; 0-1 away), 25, 23, 0, 48, Penn State, (1-0; 1-0 home), 31, 30, 0, 61
400596307, 2014-11-14, Belmont, (0-1; 0-1 away), 40, 30, 0, 70, Wright State, (1-0; 1-0 home), 37, 36, 0, 73
400596308, 2014-11-14, Savannah State, (0-1; 0-1 away), 27, 26, 0, 53, E Kentucky, (1-0; 1-0 home), 36, 40, 0, 76
400597749, 2014-11-14, Non D-I School, NA, 20, 34, 0, 54, Detroit, (1-0; 1-0 home), 45, 32, 0, 77
400607613, 2014-11-14, Non D-I School, NA, 15, 14, 0, 29, Tenn Tech, (1-0; 1-0 home), 42, 41, 0, 83
400587748, 2014-11-14, Minnesota, (0-1; 0-0 away), 30, 38, 0, 68, Louisville, (1-0; 0-0 home), 43, 38, 0, 81
400586667, 2014-11-14, American U, (0-1; 0-1 away), 11, 26, 0, 37, Temple, (1-0; 1-0 home), 23, 17, 0, 40
400586863, 2014-11-14, South Dakota St, (0-1; 0-1 away), 28, 39, 0, 67, Buffalo, (1-0; 1-0 home), 27, 42, 0, 69
400589240, 2014-11-14, Radford, (0-1; 0-1 away), 22, 24, 0, 46, Richmond, (1-0; 1-0 home), 29, 35, 0, 64
400589242, 2014-11-14, Non D-I School, NA, 24, 34, 0, 58, Campbell, (1-0; 1-0 home), 43, 54, 0, 97
400589243, 2014-11-14, Non D-I School, NA, 14, 22, 0, 36, Coast Carolina, (1-0; 1-0 home), 38, 41, 0, 79
400591083, 2014-11-14, Cornell, (1-0; 1-0 away), 34, 34, 0, 68, George Mason, (0-1; 0-1 home), 31, 29, 0, 60
400591333, 2014-11-14, Non D-I School, NA, 14, 28, 0, 42, FIU, (1-0; 1-0 home), 33, 31, 0, 64
400595359, 2014-11-14, Wagner, (0-1; 0-1 away), 17, 31, 0, 48, Maryland, (1-0; 1-0 home), 43, 39, 0, 82
400589702, 2014-11-14, Grand Canyon, (0-1; 0-1 away), 16, 29, 0, 45, Kentucky, (1-0; 1-0 home), 43, 42, 0, 85
400591790, 2014-11-14, Mt St Mary's, (0-1; 0-1 away), 25, 30, 0, 55, Arizona, (1-0; 1-0 home), 40, 38, 0, 78
400585668, 2014-11-14, UCSB, (0-1; 0-1 away), 23, 36, 0, 59, Kansas, (1-0; 1-0 home), 31, 38, 0, 69
400587755, 2014-11-14, NC Central, (0-1; 0-1 away), 19, 41, 0, 60, UNC, (1-0; 1-0 home), 28, 48, 0, 76
400587025, 2014-11-14, Lehigh, (0-1; 0-0 away), 30, 36, 0, 66, Villanova, (1-0; 0-0 home), 32, 45, 0, 77
400585667, 2014-11-14, Oakland, (0-1; 0-1 away), 38, 44, 0, 82, Iowa State, (1-0; 1-0 home), 45, 48, 0, 93
400585669, 2014-11-14, SE Louisiana, (0-1; 0-1 away), 33, 22, 0, 55, Oklahoma State, (1-0; 1-0 home), 35, 48, 0, 83
400585673, 2014-11-14, PV A&M, (0-1; 0-1 away), 23, 31, 0, 54, TCU, (1-0; 1-0 home), 30, 41, 0, 71
400586114, 2014-11-14, St Peter's, (0-1; 0-1 away), 22, 36, 0, 58, Brown, (1-0; 1-0 home), 32, 38, 0, 70
400586292, 2014-11-14, UT-Arlington, (1-0; 1-0 away), 48, 38, 0, 86, Bradley, (0-1; 0-1 home), 29, 46, 0, 75
400586296, 2014-11-14, Indiana State, (1-0; 1-0 away), 32, 32, 15, 79, IUPUI, (0-1; 0-1 home), 34, 30, 2, 66
400586483, 2014-11-14, Houston, (1-0; 1-0 away), 38, 39, 0, 77, Murray State, (0-1; 0-1 home), 42, 32, 0, 74
400586486, 2014-11-14, St Francis (PA), (0-1; 0-1 away), 17, 20, 0, 37, Cincinnati, (1-0; 1-0 home), 29, 23, 0, 52
400586866, 2014-11-14, Pacific, (1-0; 1-0 away), 36, 31, 6, 73, W Illinois, (0-1; 0-1 home), 31, 36, 4, 71
400587027, 2014-11-14, Air Force, (0-1; 0-1 away), 38, 40, 0, 78, Army, (1-0; 1-0 home), 48, 36, 0, 84
400587366, 2014-11-14, UMBC, (0-1; 0-1 away), 26, 31, 0, 57, Akron, (1-0; 1-0 home), 37, 37, 0, 74
400588632, 2014-11-14, Non D-I School, NA, 36, 25, 0, 61, Stetson, (1-0; 1-0 home), 34, 41, 0, 75
400589705, 2014-11-14, Non D-I School, NA, 34, 46, 0, 80, UT Pan American, (1-0; 1-0 home), 33, 55, 0, 88
400591086, 2014-11-14, Non D-I School, NA, 38, 39, 0, 77, Fordham, (1-0; 1-0 home), 51, 43, 0, 94
400591332, 2014-11-14, FAU, (0-1; 0-1 away), 37, 21, 0, 58, Elon, (1-0; 1-0 home), 32, 32, 0, 64
400591335, 2014-11-14, Non D-I School, NA, 35, 25, 0, 60, Mid Tennessee, (1-0; 1-0 home), 38, 39, 0, 77
400591338, 2014-11-14, Non D-I School, NA, 33, 30, 0, 63, Southern Miss, (1-0; 1-0 home), 37, 49, 0, 86
400591340, 2014-11-14, Non D-I School, NA, 16, 58, 0, 74, UTSA, (1-0; 1-0 home), 40, 52, 0, 92
400591550, 2014-11-14, Non D-I School, NA, 23, 21, 0, 44, San Jose State, (1-0; 1-0 home), 38, 29, 0, 67
400593187, 2014-11-14, Drexel, (0-1; 0-1 away), 29, 19, 0, 48, Colorado, (1-0; 1-0 home), 33, 32, 0, 65
400595187, 2014-11-14, Non D-I School, NA, 34, 37, 0, 71, Troy, (1-0; 1-0 home), 36, 49, 0, 85
400595188, 2014-11-14, Non D-I School, NA, 28, 29, 0, 57, LA-Lafayette, (1-0; 1-0 home), 35, 50, 0, 85
400595360, 2014-11-14, Houston Baptist, (0-1; 0-1 away), 31, 27, 0, 58, Northwestern, (1-0; 1-0 home), 28, 37, 0, 65
400595561, 2014-11-14, Northwestern St, (0-1; 0-1 away), 22, 46, 0, 68, Texas A&M, (1-0; 1-0 home), 55, 54, 0, 109
400595562, 2014-11-14, Non D-I School, NA, 26, 35, 0, 61, Abil Christian, (1-0; 1-0 home), 47, 54, 0, 101
400595563, 2014-11-14, Non D-I School, NA, 21, 28, 0, 49, SF Austin, (1-0; 1-0 home), 45, 30, 0, 75
400595564, 2014-11-14, Non D-I School, NA, 29, 29, 0, 58, Texas A&M-CC, (1-0; 1-0 home), 41, 32, 0, 73
400596016, 2014-11-14, Hartford, (0-1; 0-0 away), 21, 32, 0, 53, Sacred Heart, (1-0; 0-0 home), 28, 43, 0, 71
400596309, 2014-11-14, Harris Stowe,  , 33, 23, 0, 56, SIU-ED, (1-0; 1-0 home), 50, 54, 0, 104
400596310, 2014-11-14, Non D-I School, NA, 45, 21, 0, 66, Tennessee St, (1-0; 1-0 home), 47, 50, 0, 97
400598547, 2014-11-14, Pfeiffer,  , 24, 19, 0, 43, Norfolk State, (1-0; 1-0 home), 46, 35, 0, 81
400598548, 2014-11-14, Non D-I School, NA, 25, 36, 0, 61, NC A&T, (1-0; 1-0 home), 34, 57, 0, 91
400586294, 2014-11-14, E Illinois, (0-1; 0-1 away), 29, 24, 0, 53, Missouri State, (1-0; 1-0 home), 27, 37, 0, 64
400594866, 2014-11-14, Non D-I School, NA, 26, 38, 0, 64, South Alabama, (1-0; 1-0 home), 37, 46, 0, 83
400585674, 2014-11-14, North Dakota St, (0-1; 0-1 away), 18, 32, 0, 50, Texas, (1-0; 1-0 home), 38, 47, 0, 85
400586293, 2014-11-14, Non D-I School, NA, 30, 28, 0, 58, Loyola (CHI), (1-0; 1-0 home), 29, 42, 0, 71
400588629, 2014-11-14, Jacksonville, (0-1; 0-1 away), 32, 29, 0, 61, Hofstra, (1-0; 1-0 home), 53, 41, 0, 94
400589071, 2014-11-14, East Tenn St, (0-1; 0-1 away), 34, 42, 0, 76, Valparaiso, (1-0; 1-0 home), 42, 48, 0, 90
400589244, 2014-11-14, Non D-I School, NA, 24, 21, 0, 45, Liberty, (1-0; 1-0 home), 38, 31, 0, 69
400597833, 2014-11-14, Charleston, (1-0; 1-0 away), 32, 43, 0, 75, Furman, (0-1; 0-1 home), 21, 19, 0, 40
400598788, 2014-11-14, Non D-I School, NA, 33, 31, 0, 64, Alabama State, (1-0; 1-0 home), 53, 52, 0, 105
400588633, 2014-11-14, N Kentucky, (0-1; 0-1 away), 15, 16, 0, 31, Wisconsin, (1-0; 1-0 home), 28, 34, 0, 62
400586295, 2014-11-14, New Mexico St, (0-1; 0-1 away), 21, 33, 0, 54, Wichita State, (1-0; 1-0 home), 38, 33, 0, 71
400585873, 2014-11-14, Sacramento St, (0-1; 0-1 away), 26, 32, 0, 58, Gonzaga, (1-0; 1-0 home), 60, 44, 0, 104
400585670, 2014-11-14, Southern Utah, (0-1; 0-1 away), 36, 32, 0, 68, Kansas State, (1-0; 1-0 home), 44, 54, 0, 98
400585672, 2014-11-14, Loyola (MD), (0-1; 0-1 away), 33, 26, 0, 59, Texas Tech, (1-0; 1-0 home), 35, 36, 0, 71
400585876, 2014-11-14, Non D-I School, NA, 35, 27, 0, 62, N Colorado, (1-0; 1-0 home), 44, 39, 0, 83
400587211, 2014-11-14, SE Missouri St, (0-1; 0-1 away), 34, 32, 0, 66, Loyola Mary, (1-0; 1-0 home), 40, 36, 0, 76
400587758, 2014-11-14, Binghamton, (0-1; 0-1 away), 23, 16, 0, 39, Notre Dame, (1-0; 1-0 home), 41, 41, 0, 82
400588630, 2014-11-14, Berry,  , 34, 36, 0, 70, Lipscomb, (1-0; 1-0 home), 46, 45, 0, 91
400589703, 2014-11-14, UMKC, (1-0; 1-0 away), 33, 36, 0, 69, Missouri, (0-1; 0-1 home), 24, 37, 0, 61
400591007, 2014-11-14, LA Tech, (1-0; 1-0 away), 35, 50, 0, 85, Southern, (0-1; 0-1 home), 32, 44, 0, 76
400594864, 2014-11-14, Ga Southern, (0-1; 0-1 away), 31, 40, 0, 71, Illinois, (1-0; 1-0 home), 31, 49, 0, 80
400595565, 2014-11-14, Non D-I School, NA, 21, 28, 0, 49, Incarnate Word, (1-0; 1-0 home), 43, 46, 0, 89
400597288, 2014-11-14, Towson, (0-1; 0-1 away), 30, 24, 0, 54, Alabama, (1-0; 1-0 home), 39, 43, 0, 82
400588320, 2014-11-14, Cent Arkansas, (0-1; 0-1 away), 34, 43, 0, 77, Creighton, (1-0; 1-0 home), 55, 49, 0, 104
400585870, 2014-11-14, Weber State, (0-1; 0-1 away), 47, 14, 0, 61, Utah State, (1-0; 1-0 home), 29, 43, 0, 72
400586865, 2014-11-14, South Dakota, (0-1; 0-1 away), 23, 29, 0, 52, Utah Valley, (1-0; 1-0 home), 31, 29, 0, 60
400587026, 2014-11-14, Michigan State, (1-0; 1-0 away), 36, 28, 0, 64, Navy, (0-1; 0-1 home), 29, 30, 0, 59
400586484, 2014-11-14, Lamar, (0-1; 0-1 away), 20, 34, 0, 54, SMU, (1-0; 1-0 home), 46, 47, 0, 93
400585671, 2014-11-14, McNeese State, (0-1; 0-1 away), 17, 22, 0, 39, Baylor, (1-0; 1-0 home), 39, 41, 0, 80
400588321, 2014-11-14, UT Martin, (0-1; 0-1 away), 30, 33, 0, 63, Marquette, (1-0; 1-0 home), 38, 41, 0, 79
400595361, 2014-11-14, Hampton, (0-1; 0-1 away), 28, 28, 0, 56, Iowa, (1-0; 1-0 home), 53, 37, 0, 90
400591552, 2014-11-14, CS Northridge, (0-1; 0-1 away), 21, 37, 0, 58, San Diego State, (1-0; 1-0 home), 41, 38, 0, 79
400587388, 2014-11-14, Ball State, (0-1; 0-1 away), 30, 42, 0, 72, Utah, (1-0; 1-0 home), 35, 55, 0, 90
400585872, 2014-11-14, Non D-I School, NA, 36, 29, 0, 65, Idaho, (1-0; 1-0 home), 37, 40, 0, 77
400585877, 2014-11-14, Idaho State, (0-1; 0-1 away), 20, 35, 0, 55, New Mexico, (1-0; 1-0 home), 42, 37, 0, 79
400587212, 2014-11-14, Concordia (OR),  , 20, 39, 0, 59, Portland, (1-0; 1-0 home), 39, 48, 0, 87
400587213, 2014-11-14, Fresno State, (0-1; 0-1 away), 35, 39, 0, 74, Pepperdine, (1-0; 1-0 home), 41, 48, 0, 89
400588322, 2014-11-14, UIC, (0-1; 0-1 away), 30, 41, 0, 71, DePaul, (1-0; 1-0 home), 46, 26, 0, 72
400589245, 2014-11-14, CSU Bakersfield, (0-1; 0-0 away), 22, 38, 39, 99, High Point, (1-0; 0-0 home), 22, 38, 40, 100
400589701, 2014-11-14, Chicago State, (0-1; 0-1 away), 28, 22, 0, 50, Arizona State, (1-0; 1-0 home), 40, 46, 0, 86
400589704, 2014-11-14, Texas State, (1-0; 1-0 away), 26, 36, 0, 62, Seattle, (0-1; 0-1 home), 33, 20, 0, 53
400591060, 2014-11-14, Alcorn State, (0-1; 0-1 away), 32, 25, 0, 57, Cal, (1-0; 1-0 home), 50, 41, 0, 91
400591337, 2014-11-14, Rice, (0-1; 0-1 away), 22, 32, 0, 54, Oregon State, (1-0; 1-0 home), 32, 35, 0, 67
400591339, 2014-11-14, Washington St, (0-1; 0-1 away), 26, 26, 0, 52, UTEP, (1-0; 1-0 home), 32, 33, 0, 65
400593188, 2014-11-14, S Carolina St, (0-1; 0-1 away), 23, 36, 0, 59, Washington, (1-0; 1-0 home), 39, 38, 0, 77
400595897, 2014-11-14, CS Fullerton, (0-1; 0-1 away), 22, 50, 0, 72, Santa Clara, (1-0; 1-0 home), 40, 49, 0, 89
400595898, 2014-11-14, Chapman,  , 16, 20, 0, 36, UC Irvine, (1-0; 1-0 home), 40, 47, 0, 87
400597289, 2014-11-14, Milwaukee, (0-1; 0-1 away), 32, 41, 0, 73, Auburn, (1-0; 1-0 home), 29, 54, 0, 83
400599888, 2014-11-14, Cal State-LA,  , 34, 33, 0, 67, Saint Mary's, (1-0; 1-0 home), 31, 46, 0, 77
400591551, 2014-11-14, Morehead State, (0-1; 0-1 away), 36, 23, 0, 59, UNLV, (1-0; 1-0 home), 31, 29, 0, 60
400585871, 2014-11-14, Montana State, (0-1; 0-1 away), 32, 46, 0, 78, UCLA, (1-0; 1-0 home), 60, 53, 0, 113
400589074, 2014-11-14, Wofford, (0-1; 0-1 away), 27, 32, 0, 59, Stanford, (1-0; 1-0 home), 36, 38, 0, 74
400598549, 2014-11-14, Coppin State, (0-1; 0-1 away), 27, 38, 0, 65, Oregon, (1-0; 1-0 home), 60, 47, 0, 107
400601593, 2014-11-14, AR-Pine Bluff, (0-1; 0-1 away), 32, 25, 0, 57, Hawaii, (1-0; 1-0 home), 33, 52, 0, 85
400588323, 2014-11-15, St Francis (BKN), (0-1; 0-1 away), 31, 31, 0, 62, Georgetown, (1-0; 1-0 home), 37, 46, 0, 83
400598550, 2014-11-15, Non D-I School, NA, 42, 27, 0, 69, Bethune-Cookman, (1-0; 1-0 home), 42, 49, 0, 91
400586115, 2014-11-15, Manhattan, (0-1; 0-1 away), 31, 35, 0, 66, FSU, (1-0; 1-0 home), 37, 44, 0, 81
400589246, 2014-11-15, Gardner-Webb, (0-1; 0-1 away), 43, 39, 0, 82, LSU, (1-0; 1-0 home), 42, 51, 0, 93
400595362, 2014-11-15, Non D-I School, NA, 33, 35, 0, 68, Michigan, (1-0; 1-0 home), 50, 42, 0, 92
400585878, 2014-11-15, North Dakota, (0-1; 0-1 away), 29, 23, 0, 52, Northern Iowa, (1-0; 1-0 home), 31, 33, 0, 64
400586116, 2014-11-15, UVM, (0-1; 0-1 away), 26, 34, 0, 60, Canisius, (1-0; 1-0 home), 22, 42, 0, 64
400587389, 2014-11-15, Appalachian St, (0-1; 0-1 away), 27, 20, 0, 47, Ohio, (1-0; 1-0 home), 35, 38, 0, 73
400588636, 2014-11-15, Non D-I School, NA, 33, 18, 0, 51, FGCU, (1-0; 1-0 home), 34, 29, 0, 63
400591087, 2014-11-15, Non D-I School, NA, 23, 43, 0, 66, Davidson, (1-0; 1-0 home), 47, 55, 0, 102
400591088, 2014-11-15, Non D-I School, NA, 25, 26, 0, 51, Duquesne, (1-0; 1-0 home), 52, 39, 0, 91
400587029, 2014-11-15, Colgate, (0-1; 0-1 away), 21, 31, 0, 52, La Salle, (1-0; 1-0 home), 22, 35, 0, 57
400586297, 2014-11-15, Non D-I School, NA, 24, 21, 0, 45, Evansville, (1-0; 1-0 home), 54, 62, 0, 116
400586299, 2014-11-15, Bowling Green, (1-0; 1-0 away), 47, 30, 0, 77, Drake, (0-1; 0-1 home), 31, 27, 0, 58
400587390, 2014-11-15, Aurora,  , 25, 31, 0, 56, N Illinois, (1-0; 1-0 home), 42, 44, 0, 86
400589247, 2014-11-15, Pfeiffer,  , 21, 38, 0, 59, Winthrop, (1-0; 1-0 home), 40, 42, 0, 82
400597767, 2014-11-15, Non D-I School, NA, 25, 32, 0, 57, Green Bay, (1-0; 1-0 home), 46, 42, 0, 88
400588324, 2014-11-15, Maine, (0-1; 0-1 away), 27, 30, 0, 57, Butler, (1-0; 1-0 home), 43, 56, 0, 99
400591303, 2014-11-15, Delaware State, (1-0; 1-0 away), 34, 31, 12, 77, Penn, (0-1; 0-1 home), 35, 30, 10, 75
400591343, 2014-11-15, Austin Peay, (0-1; 0-1 away), 35, 35, 0, 70, W Kentucky, (1-0; 1-0 home), 42, 35, 0, 77
400587215, 2014-11-15, SE Missouri St, (0-2; 0-1 away), 28, 28, 0, 56, San Diego, (1-1; 0-0 home), 31, 36, 0, 67
400607368, 2014-11-15, The Citadel, (0-2; 0-0 away), 24, 31, 0, 55, Air Force, (1-1; 0-0 home), 29, 39, 0, 68
400591553, 2014-11-15, Cal Poly, (0-1; 0-1 away), 27, 22, 0, 49, Nevada, (1-0; 1-0 home), 26, 39, 0, 65
400587391, 2014-11-15, Kent State, (1-0; 1-0 away), 35, 34, 0, 69, Youngstown St, (0-1; 0-1 home), 33, 28, 0, 61
400588325, 2014-11-15, Albany, (0-1; 0-1 away), 27, 33, 0, 60, Providence, (1-0; 1-0 home), 26, 38, 0, 64
400591089, 2014-11-15, Dartmouth, (0-1; 0-1 away), 27, 30, 0, 57, St Bonaventure, (1-0; 1-0 home), 28, 49, 0, 77
400591341, 2014-11-15, UNC-Wilmington, (0-1; 0-1 away), 32, 24, 0, 56, Old Dominion, (1-0; 1-0 home), 28, 48, 0, 76
400595899, 2014-11-15, Non D-I School, NA, 28, 36, 0, 64, LBSU, (1-1; 1-0 home), 33, 41, 0, 74
400595900, 2014-11-15, Non D-I School, NA, 24, 28, 0, 52, UC Riverside, (1-0; 1-0 home), 29, 46, 0, 75
400588635, 2014-11-15, Florida A&M, (0-2; 0-2 away), 36, 29, 0, 65, USC Upstate, (1-0; 1-0 home), 38, 40, 0, 78
400586117, 2014-11-15, Fairfield, (1-1; 0-1 away), 30, 29, 0, 59, Duke, (2-0; 2-0 home), 44, 65, 0, 109
400586298, 2014-11-15, S Illinois, (0-1; 0-1 away), 37, 22, 0, 59, Saint Louis, (1-0; 1-0 home), 33, 29, 0, 62
400586668, 2014-11-15, Tulsa, (0-1; 0-1 away), 25, 43, 0, 68, Oral Roberts, (1-0; 1-0 home), 29, 48, 0, 77
400587216, 2014-11-15, Boise State, (2-0; 1-0 away), 31, 46, 0, 77, Loyola Mary, (1-1; 1-1 home), 35, 34, 0, 69
400591342, 2014-11-15, UL Monroe, (1-0; 1-0 away), 33, 41, 0, 74, UAB, (0-1; 0-1 home), 25, 40, 0, 65
400607369, 2014-11-15, VMI, (1-1; 0-1 away), 53, 33, 0, 86, Army, (2-0; 2-0 home), 52, 40, 0, 92
400585880, 2014-11-15, Montana, (0-1; 0-1 away), 30, 36, 0, 66, Colorado State, (1-0; 1-0 home), 51, 32, 0, 83
400589248, 2014-11-15, High Point, (2-0; 0-0 away), 32, 42, 0, 74, AR-Pine Bluff, (0-2; 0-0 home), 28, 34, 0, 62
400599889, 2014-11-15, Non D-I School, NA, 29, 29, 0, 58, Santa Clara, (2-0; 2-0 home), 29, 41, 0, 70
400585879, 2014-11-15, Portland State, (1-0; 1-0 away), 39, 37, 0, 76, USC, (0-1; 0-1 home), 32, 36, 0, 68
400595901, 2014-11-15, CSU Bakersfield, (0-2; 0-1 away), 34, 31, 0, 65, Hawaii, (2-0; 2-0 home), 28, 44, 0, 72
400587392, 2014-11-16, Buffalo, (1-1; 0-1 away), 38, 14, 0, 52, Kentucky, (2-0; 2-0 home), 33, 38, 0, 71
400588326, 2014-11-16, Mercer, (1-1; 0-1 away), 24, 23, 0, 47, Seton Hall, (1-0; 1-0 home), 35, 28, 0, 63
400587031, 2014-11-16, Boston U, (0-1; 0-0 away), 36, 29, 0, 65, Northeastern, (1-0; 0-0 home), 27, 44, 0, 71
400589076, 2014-11-16, Chattanooga, (1-1; 0-1 away), 21, 24, 0, 45, Wisconsin, (2-0; 2-0 home), 52, 37, 0, 89
400587762, 2014-11-16, Samford, (0-2; 0-2 away), 23, 33, 0, 56, Pitt, (2-0; 2-0 home), 31, 32, 0, 63
400591091, 2014-11-16, Princeton, (1-1; 0-1 away), 19, 41, 0, 60, George Mason, (1-1; 1-1 home), 32, 31, 0, 63
400588638, 2014-11-16, N Kentucky, (0-2; 0-2 away), 30, 31, 0, 61, Nebraska, (1-0; 1-0 home), 45, 35, 0, 80
400585881, 2014-11-16, N Arizona, (0-2; 0-2 away), 27, 31, 0, 58, Toledo, (1-0; 1-0 home), 31, 40, 0, 71
400585882, 2014-11-16, Southern Utah, (0-2; 0-2 away), 30, 33, 0, 63, Miami (OH), (1-0; 1-0 home), 32, 44, 0, 76
400586118, 2014-11-16, St Peter's, (0-2; 0-2 away), 26, 24, 0, 50, Hartford, (1-1; 1-0 home), 23, 28, 0, 51
400586669, 2014-11-16, Jackson State, (0-2; 0-2 away), 31, 33, 0, 64, USF, (2-0; 2-0 home), 38, 35, 0, 73
400586670, 2014-11-16, UNC Asheville, (1-1; 1-1 away), 38, 45, 0, 83, ECU, (1-1; 1-1 home), 28, 51, 0, 79
400587030, 2014-11-16, Navy, (0-2; 0-1 away), 28, 25, 0, 53, Notre Dame, (2-0; 2-0 home), 36, 56, 0, 92
400588637, 2014-11-16, Non D-I School, NA, 28, 33, 0, 61, Jacksonville, (1-1; 1-0 home), 37, 35, 0, 72
400591092, 2014-11-16, UMass Lowell, (0-2; 0-2 away), 23, 33, 0, 56, URI, (2-0; 2-0 home), 29, 43, 0, 72
400600052, 2014-11-16, Aquinas College,  , 26, 31, 0, 57, W Michigan, (1-0; 1-0 home), 48, 39, 0, 87
400585676, 2014-11-16, SE Louisiana, (0-2; 0-2 away), 19, 34, 0, 53, Oklahoma, (1-0; 1-0 home), 42, 36, 0, 78
400585677, 2014-11-16, PV A&M, (0-2; 0-2 away), 25, 27, 0, 52, Oklahoma State, (2-0; 2-0 home), 31, 43, 0, 74
400585679, 2014-11-16, Lafayette, (1-1; 1-1 away), 24, 32, 0, 56, West Virginia, (2-0; 2-0 home), 39, 44, 0, 83
400586868, 2014-11-16, IUPUI, (0-2; 0-1 away), 38, 19, 0, 57, Purdue, (2-0; 2-0 home), 48, 29, 0, 77
400587759, 2014-11-16, UMass, (17-15; 10-8 A 10), 24, 47, 0, 71, Boston College, (13-19; 4-14 ACC), 32, 30, 0, 62
400595189, 2014-11-16, Non D-I School, NA, 29, 35, 0, 64, AR-Little Rock, (1-0; 1-0 home), 38, 39, 0, 77
400595566, 2014-11-16, Non D-I School, NA, 26, 49, 0, 75, Lamar, (1-1; 1-0 home), 37, 41, 0, 78
400597290, 2014-11-16, Trevecca,  , 30, 26, 0, 56, Vanderbilt, (1-0; 1-0 home), 33, 50, 0, 83
400598551, 2014-11-16, Hampton, (0-2; 0-2 away), 27, 20, 0, 47, Syracuse, (2-0; 2-0 home), 35, 30, 0, 65
400585883, 2014-11-16, N Colorado, (1-1; 0-1 away), 34, 36, 0, 70, Wyoming, (1-0; 1-0 home), 36, 42, 0, 78
400587032, 2014-11-16, Cornell, (1-1; 1-1 away), 27, 44, 0, 71, Loyola (MD), (1-1; 1-0 home), 38, 38, 0, 76
400587217, 2014-11-16, Portland, (2-0; 1-0 away), 26, 36, 11, 73, San Jose State, (1-1; 1-1 home), 37, 25, 6, 68
400591345, 2014-11-16, Savannah State, (0-2; 0-2 away), 22, 25, 0, 47, Marshall, (2-0; 2-0 home), 33, 33, 0, 66
400596311, 2014-11-16, Non D-I School, NA, 38, 25, 0, 63, Austin Peay, (1-1; 1-0 home), 28, 40, 0, 68
400597829, 2014-11-16, Non D-I School, NA, 22, 31, 0, 53, Youngstown St, (1-1; 1-1 home), 29, 42, 0, 71
400586300, 2014-11-16, Utah State, (2-0; 1-0 away), 20, 40, 0, 60, Illinois State, (0-1; 0-1 home), 27, 28, 0, 55
400586867, 2014-11-16, Cent Arkansas, (0-2; 0-2 away), 31, 44, 0, 75, Omaha, (1-0; 1-0 home), 47, 53, 0, 100
400591093, 2014-11-16, Fordham, (1-1; 0-1 away), 21, 33, 0, 54, Penn State, (2-0; 2-0 home), 38, 35, 0, 73
400597292, 2014-11-16, Alabama State, (1-1; 0-1 away), 48, 31, 0, 79, Arkansas, (1-0; 1-0 home), 48, 49, 0, 97
400597825, 2014-11-16, Ohio Dominican,  , 31, 33, 0, 64, Wright State, (2-0; 2-0 home), 32, 44, 0, 76
400587033, 2014-11-16, Harvard, (1-1; 0-0 away), 28, 29, 0, 57, Holy Cross, (1-0; 0-0 home), 27, 31, 0, 58
400588327, 2014-11-16, Chicago State, (0-2; 0-2 away), 27, 39, 0, 66, Creighton, (2-0; 2-0 home), 45, 39, 0, 84
400591344, 2014-11-16, Charlotte, (1-0; 1-0 away), 36, 37, 0, 73, Elon, (1-1; 1-1 home), 25, 35, 0, 60
400587760, 2014-11-16, Robert Morris, (0-2; 0-1 away), 35, 24, 0, 59, UNC, (2-0; 2-0 home), 53, 50, 0, 103
400585884, 2014-11-16, Idaho State, (0-2; 0-2 away), 29, 9, 0, 38, Denver, (1-0; 1-0 home), 31, 23, 0, 54
400586671, 2014-11-16, Stetson, (1-1; 0-1 away), 28, 27, 0, 55, UCF, (1-0; 1-0 home), 34, 30, 0, 64
400586869, 2014-11-16, South Dakota, (0-2; 0-2 away), 26, 47, 0, 73, Stanford, (2-0; 2-0 home), 40, 44, 0, 84
400587218, 2014-11-16, Pacific, (1-1; 1-1 away), 22, 28, 0, 50, UC Irvine, (2-0; 2-0 home), 33, 35, 0, 68
400595364, 2014-11-16, Coppin State, (0-2; 0-2 away), 24, 32, 0, 56, Illinois, (2-0; 2-0 home), 59, 55, 0, 114
400597291, 2014-11-16, Valparaiso, (1-1; 0-1 away), 23, 18, 0, 41, Missouri, (1-1; 1-1 home), 24, 32, 0, 56
400598552, 2014-11-16, Non D-I School, NA, 20, 34, 0, 54, Howard, (1-1; 1-0 home), 46, 55, 0, 101
400587761, 2014-11-16, Norfolk State, (1-1; 0-1 away), 22, 17, 0, 39, UVA, (2-0; 1-0 home), 42, 25, 0, 67
400591090, 2014-11-16, G Washington, (2-0; 1-0 away), 33, 37, 0, 70, Rutgers, (0-1; 0-1 home), 21, 32, 0, 53
400595902, 2014-11-16, Non D-I School, NA, 17, 25, 0, 42, UC Davis, (1-0; 1-0 home), 34, 23, 0, 57
400593190, 2014-11-16, CS Northridge, (0-2; 0-2 away), 23, 45, 0, 68, Arizona, (2-0; 2-0 home), 37, 49, 0, 86
400585678, 2014-11-16, Alcorn State, (0-2; 0-2 away), 22, 31, 0, 53, Texas, (2-0; 2-0 home), 46, 39, 0, 85
400587219, 2014-11-16, S Carolina St, (0-2; 0-2 away), 18, 34, 0, 52, San Francisco, (1-0; 1-0 home), 45, 46, 0, 91
400588639, 2014-11-16, Kennesaw St, (0-2; 0-2 away), 15, 44, 0, 59, Cal, (2-0; 2-0 home), 41, 52, 0, 93
400591554, 2014-11-16, Sam Houston, (1-1; 0-1 away), 30, 27, 0, 57, UNLV, (2-0; 2-0 home), 28, 31, 0, 59
400591555, 2014-11-16, CS Fullerton, (0-2; 0-2 away), 23, 36, 0, 59, New Mexico, (2-0; 2-0 home), 31, 36, 0, 67
400589249, 2014-11-16, Coast Carolina, (1-1; 0-1 away), 28, 43, 0, 71, UCLA, (2-0; 2-0 home), 32, 52, 0, 84
400598833, 2014-11-17, Texas Southern, (0-2; 0-2 away), 29, 35, 0, 64, Indiana, (2-0; 2-0 home), 44, 39, 0, 83
400587765, 2014-11-17, Jacksonville St, (0-2; 0-2 away), 20, 19, 0, 39, Louisville, (2-0; 1-0 home), 50, 38, 0, 88
400587764, 2014-11-17, Miami (FL), (2-0; 1-0 away), 21, 48, 0, 69, Florida, (1-1; 1-1 home), 33, 34, 0, 67
400588328, 2014-11-17, MD-E Shore, (0-2; 0-2 away), 14, 30, 0, 44, Villanova, (2-0; 1-0 home), 45, 36, 0, 81
400586119, 2014-11-17, UVM, (1-1; 1-1 away), 36, 48, 0, 84, Siena, (0-2; 0-1 home), 37, 39, 0, 76
400586674, 2014-11-17, LA Tech, (1-1; 1-1 away), 38, 37, 0, 75, Temple, (2-0; 2-0 home), 34, 48, 0, 82
400587393, 2014-11-17, Non D-I School, NA, 30, 32, 0, 62, Ball State, (1-1; 1-0 home), 62, 39, 0, 101
400587394, 2014-11-17, Oakland, (0-2; 0-2 away), 36, 41, 0, 77, E Michigan, (2-0; 2-0 home), 39, 50, 0, 89
400587763, 2014-11-17, Winthrop, (2-0; 1-0 away), 34, 43, 0, 77, Clemson, (1-1; 1-1 home), 36, 38, 0, 74
400587766, 2014-11-17, Hofstra, (1-1; 0-1 away), 29, 35, 0, 64, NC State, (2-0; 2-0 home), 45, 31, 0, 76
400588641, 2014-11-17, Non D-I School, NA, 31, 24, 0, 55, North Florida, (1-1; 1-0 home), 30, 49, 0, 79
400588643, 2014-11-17, UCSB, (0-2; 0-2 away), 28, 36, 11, 75, FGCU, (2-0; 2-0 home), 32, 32, 17, 81
400589251, 2014-11-17, Delaware, (0-1; 0-1 away), 30, 25, 0, 55, Liberty, (2-0; 2-0 home), 30, 31, 0, 61
400589252, 2014-11-17, Radford, (0-2; 0-2 away), 35, 36, 0, 71, JMU, (1-1; 1-1 home), 38, 36, 0, 74
400591094, 2014-11-17, Saint Joe's, (1-1; 1-0 away), 24, 28, 0, 52, Drexel, (0-2; 0-1 home), 25, 24, 0, 49
400591214, 2014-11-17, Northwestern, (2-0; 1-0 away), 36, 33, 0, 69, Brown, (1-1; 1-1 home), 26, 30, 0, 56
400591321, 2014-11-17, Non D-I School, NA, 19, 32, 0, 51, Yale, (1-1; 1-0 home), 34, 63, 0, 97
400591346, 2014-11-17, Non D-I School, NA, 29, 20, 0, 49, FAU, (1-1; 1-0 home), 33, 41, 0, 74
400591754, 2014-11-17, FDU-Florham,  , 38, 23, 0, 61, Fair Dickinson, (2-0; 1-0 home), 53, 49, 0, 102
400596314, 2014-11-17, Non D-I School, NA, 37, 42, 0, 79, Morehead State, (1-1; 1-0 home), 49, 38, 0, 87
400596501, 2014-11-17, Maine, (0-2; 0-2 away), 35, 51, 0, 86, NJIT, (1-1; 1-0 home), 36, 54, 0, 90
400597729, 2014-11-17, Tiffin,  , 31, 25, 0, 56, Cleveland State, (1-1; 1-0 home), 37, 48, 0, 85
400597936, 2014-11-17, Towson, (1-1; 1-1 away), 25, 26, 0, 51, Morgan State, (0-2; 0-1 home), 22, 24, 0, 46
400598553, 2014-11-17, Non D-I School, NA, 28, 35, 0, 63, Delaware State, (2-0; 1-0 home), 53, 51, 0, 104
400587034, 2014-11-17, St Francis (PA), (0-2; 0-2 away), 23, 23, 0, 46, American U, (1-1; 1-0 home), 25, 24, 0, 49
400588329, 2014-11-17, Non D-I School, NA, 50, 31, 0, 81, St John's, (2-0; 2-0 home), 43, 51, 0, 94
400588640, 2014-11-17, Belmont, (1-1; 1-1 away), 48, 39, 0, 87, Lipscomb, (1-1; 1-1 home), 37, 25, 0, 62
400588642, 2014-11-17, USC Upstate, (2-0; 1-0 away), 29, 34, 0, 63, NC A&T, (1-1; 1-1 home), 20, 26, 0, 46
400589250, 2014-11-17, Gardner-Webb, (1-1; 1-1 away), 32, 48, 0, 80, Charleston, (1-1; 0-1 home), 31, 36, 0, 67
400589253, 2014-11-17, Non D-I School, NA, 21, 29, 0, 50, Charleston So, (2-0; 1-0 home), 48, 44, 0, 92
400591732, 2014-11-17, Cent Conn St, (0-2; 0-1 away), 26, 31, 0, 57, Maryland, (2-0; 2-0 home), 38, 55, 0, 93
400595567, 2014-11-17, Non D-I School, NA, 34, 30, 0, 64, Northwestern St, (1-1; 1-0 home), 46, 29, 0, 75
400587035, 2014-11-17, Bucknell, (1-1; 0-1 away), 19, 34, 0, 53, Michigan, (2-0; 2-0 home), 48, 29, 0, 77
400585680, 2014-11-17, UMKC, (1-1; 1-1 away), 40, 33, 0, 73, Kansas State, (2-0; 2-0 home), 36, 47, 0, 83
400585682, 2014-11-17, Washington St, (0-2; 0-2 away), 26, 28, 0, 54, TCU, (2-0; 2-0 home), 45, 36, 0, 81
400586301, 2014-11-17, McKendree,  , 27, 41, 0, 68, Loyola (CHI), (2-0; 2-0 home), 37, 41, 0, 78
400586870, 2014-11-17, W Illinois, (0-2; 0-1 away), 35, 29, 0, 64, UIC, (1-1; 1-0 home), 35, 32, 0, 67
400586871, 2014-11-17, North Dakota St, (0-2; 0-2 away), 26, 30, 0, 56, Iowa, (2-0; 2-0 home), 43, 44, 0, 87
400586872, 2014-11-17, IPFW, (2-0; 1-0 away), 37, 37, 0, 74, SIU-ED, (1-1; 1-1 home), 32, 39, 0, 71
400587767, 2014-11-17, Wake Forest, (2-0; 1-0 away), 32, 39, 0, 71, Tulane, (0-1; 0-1 home), 27, 22, 0, 49
400590727, 2014-11-17, UT Pan American, (2-0; 1-0 away), 27, 36, 0, 63, UTSA, (1-1; 1-1 home), 27, 35, 0, 62
400591008, 2014-11-17, Non D-I School, NA, 25, 40, 0, 65, Southern, (1-1; 1-1 home), 32, 44, 0, 76
400591348, 2014-11-17, South Alabama, (1-1; 0-1 away), 29, 30, 0, 59, Southern Miss, (2-0; 2-0 home), 22, 46, 0, 68
400591349, 2014-11-17, Non D-I School, NA, 43, 38, 0, 81, UAB, (1-1; 1-1 home), 51, 43, 0, 94
400595190, 2014-11-17, Ole Miss, (1-1; 1-0 away), 34, 40, 0, 74, Troy, (1-1; 1-1 home), 23, 41, 0, 64
400595191, 2014-11-17, Non D-I School, NA, 18, 21, 0, 39, UL Monroe, (2-0; 1-0 home), 53, 53, 0, 106
400595568, 2014-11-17, Non D-I School, NA, 23, 30, 0, 53, Houston Baptist, (1-1; 1-0 home), 52, 37, 0, 89
400596312, 2014-11-17, Non D-I School, NA, 30, 21, 0, 51, E Illinois, (1-1; 1-0 home), 47, 34, 0, 81
400597293, 2014-11-17, Miss Valley St, (0-2; 0-2 away), 34, 34, 0, 68, Miss St, (2-0; 2-0 home), 58, 31, 0, 89
400597795, 2014-11-17, Minn Crookston,  , 25, 29, 0, 54, Milwaukee, (1-1; 1-0 home), 35, 40, 0, 75
400585889, 2014-11-17, Utah Valley, (1-1; 0-1 away), 25, 25, 0, 50, E Washington, (2-0; 2-0 home), 38, 37, 0, 75
400596313, 2014-11-17, UT Martin, (1-1; 1-1 away), 23, 52, 0, 75, Arkansas State, (0-1; 0-1 home), 39, 34, 0, 73
400591347, 2014-11-17, Nicholls State, (0-1; 0-1 away), 21, 36, 0, 57, North Texas, (2-0; 2-0 home), 31, 40, 0, 71
400585681, 2014-11-17, Georgia State, (1-1; 0-1 away), 29, 29, 0, 58, Iowa State, (2-0; 2-0 home), 35, 46, 0, 81
400585886, 2014-11-17, Montana State, (0-2; 0-2 away), 18, 27, 0, 45, Grand Canyon, (1-1; 1-0 home), 28, 33, 0, 61
400588330, 2014-11-17, Binghamton, (0-2; 0-2 away), 29, 16, 0, 45, Providence, (2-0; 2-0 home), 33, 33, 0, 66
400589077, 2014-11-17, W Carolina, (0-2; 0-2 away), 33, 41, 0, 74, Alabama, (2-0; 2-0 home), 41, 39, 0, 80
400593191, 2014-11-17, Bethune-Cookman, (1-1; 0-1 away), 14, 25, 0, 39, Arizona State, (2-0; 2-0 home), 33, 16, 0, 49
400585885, 2014-11-17, Non D-I School, NA, 22, 27, 0, 49, Weber State, (1-1; 1-0 home), 26, 48, 0, 74
400586673, 2014-11-17, LA-Lafayette, (1-1; 0-1 away), 21, 32, 0, 53, Tulsa, (1-1; 1-0 home), 32, 32, 0, 64
400585887, 2014-11-17, South Dakota St, (0-2; 0-2 away), 36, 41, 0, 77, Idaho, (2-0; 2-0 home), 41, 41, 0, 82
400585888, 2014-11-17, Sacramento St, (1-1; 1-1 away), 31, 39, 0, 70, UC Riverside, (1-1; 1-1 home), 29, 40, 0, 69
400591556, 2014-11-17, Non D-I School, NA, 34, 21, 0, 55, Fresno State, (1-1; 1-0 home), 37, 56, 0, 93
400591557, 2014-11-17, Non D-I School, NA, 24, 40, 0, 64, Nevada, (2-0; 2-0 home), 35, 34, 0, 69
400599887, 2014-11-17, Cal Lutheran,  , 26, 35, 0, 61, Pepperdine, (2-0; 2-0 home), 36, 40, 0, 76
400601534, 2014-11-17, AR-Pine Bluff, (1-2; 0-1 away), 28, 28, 0, 56, CSU Bakersfield, (0-3; 0-0 home), 21, 28, 0, 49
400586672, 2014-11-17, SMU, (1-1; 0-1 away), 27, 29, 0, 56, Gonzaga, (2-0; 2-0 home), 37, 35, 0, 72
400593192, 2014-11-17, Detroit, (1-1; 0-1 away), 35, 31, 0, 66, Oregon, (2-0; 2-0 home), 35, 48, 0, 83
400593193, 2014-11-17, Tenn Tech, (1-1; 0-1 away), 24, 34, 0, 58, USC, (1-1; 1-1 home), 29, 41, 0, 70
400593194, 2014-11-17, Auburn, (1-1; 0-1 away), 34, 25, 0, 59, Colorado, (2-0; 2-0 home), 38, 52, 0, 90
400587220, 2014-11-17, New Mexico St, (0-2; 0-2 away), 31, 40, 0, 71, Saint Mary's, (2-0; 2-0 home), 45, 38, 0, 83
400589255, 2014-11-17, High Point, (3-0; 1-0 away), 27, 35, 0, 62, Hawaii, (2-1; 2-1 home), 31, 23, 0, 54
400586122, 2014-11-18, Iona, (1-1; 0-1 away), 42, 31, 0, 73, Wofford, (1-1; 1-0 home), 39, 47, 0, 86
400586304, 2014-11-18, Northern Iowa, (2-0; 1-0 away), 35, 35, 9, 79, SF Austin, (1-1; 1-1 home), 39, 31, 7, 77
400586123, 2014-11-18, Manhattan, (0-2; 0-2 away), 28, 33, 7, 68, UMass, (3-0; 2-0 home), 28, 33, 16, 77
400585683, 2014-11-18, Baylor, (2-0; 1-0 away), 30, 39, 0, 69, South Carolina, (1-1; 1-1 home), 27, 38, 0, 65
400586306, 2014-11-18, Wichita State, (2-0; 0-0 away), 29, 42, 0, 71, Memphis, (0-1; 0-0 home), 22, 34, 0, 56
400591558, 2014-11-18, Utah, (1-1; 0-1 away), 18, 31, 0, 49, San Diego State, (2-0; 2-0 home), 17, 36, 0, 53
400587395, 2014-11-18, Toledo, (1-1; 0-1 away), 45, 33, 0, 78, VCU, (2-0; 1-0 home), 42, 45, 0, 87
400587768, 2014-11-18, Michigan State, (1-1; 1-0 away), 33, 38, 0, 71, Duke, (3-0; 2-0 home), 40, 41, 0, 81
400587771, 2014-11-18, S Carolina St, (0-3; 0-3 away), 20, 35, 0, 55, UVA, (3-0; 2-0 home), 41, 34, 0, 75
400585890, 2014-11-18, Non D-I School, NA, 24, 15, 0, 39, North Dakota, (1-1; 1-0 home), 38, 38, 0, 76
400586120, 2014-11-18, Rider, (1-1; 1-1 away), 40, 33, 0, 73, Penn, (0-2; 0-2 home), 26, 31, 0, 57
400586124, 2014-11-18, Canisius, (2-0; 1-0 away), 24, 39, 0, 63, Lehigh, (0-2; 0-1 home), 26, 25, 0, 51
400587036, 2014-11-18, Colgate, (0-2; 0-1 away), 31, 21, 0, 52, Cornell, (2-1; 1-0 home), 22, 36, 0, 58
400587397, 2014-11-18, Youngstown St, (1-2; 0-1 away), 25, 38, 0, 63, Cent Michigan, (2-0; 2-0 home), 36, 39, 0, 75
400587769, 2014-11-18, Alabama A&M, (0-2; 0-2 away), 20, 26, 0, 46, Georgia Tech, (2-0; 2-0 home), 34, 32, 0, 66
400587770, 2014-11-18, Northeastern, (2-0; 1-0 away), 40, 36, 0, 76, FSU, (1-1; 1-1 home), 38, 35, 0, 73
400588331, 2014-11-18, LBSU, (1-2; 0-2 away), 38, 36, 0, 74, Xavier, (2-0; 2-0 home), 51, 46, 0, 97
400588332, 2014-11-18, Texas A&M-CC, (1-1; 0-1 away), 34, 28, 0, 62, Georgetown, (2-0; 2-0 home), 34, 44, 0, 78
400588644, 2014-11-18, Jackson State, (1-2; 1-2 away), 27, 39, 0, 66, Jacksonville, (1-2; 1-1 home), 27, 30, 0, 57
400588645, 2014-11-18, FIU, (2-0; 1-0 away), 25, 28, 0, 53, Stetson, (1-2; 1-1 home), 32, 20, 0, 52
400589078, 2014-11-18, Non D-I School, NA, 21, 45, 0, 66, East Tenn St, (1-1; 1-0 home), 61, 50, 0, 111
400589079, 2014-11-18, UNC-Wilmington, (1-1; 1-1 away), 39, 45, 0, 84, UNC Greensboro, (1-1; 1-1 home), 31, 41, 0, 72
400589080, 2014-11-18, Non D-I School, NA, 16, 26, 0, 42, VMI, (2-1; 1-0 home), 62, 62, 0, 124
400589254, 2014-11-18, Campbell, (1-1; 0-1 away), 23, 28, 0, 51, Davidson, (2-0; 2-0 home), 43, 43, 0, 86
400589256, 2014-11-18, Non D-I School, NA, 28, 23, 0, 51, Coast Carolina, (2-1; 2-0 home), 45, 37, 0, 82
400591239, 2014-11-18, Wagner, (0-2; 0-2 away), 23, 33, 0, 56, Columbia, (1-1; 1-0 home), 35, 35, 0, 70
400591350, 2014-11-18, Non D-I School, NA, 27, 38, 0, 65, Marshall, (3-0; 3-0 home), 48, 39, 0, 87
400596315, 2014-11-18, KY Christian,  , 10, 25, 0, 35, E Kentucky, (2-0; 2-0 home), 51, 64, 0, 115
400597294, 2014-11-18, Stony Brook, (1-1; 0-1 away), 41, 29, 0, 70, Georgia, (1-1; 1-0 home), 48, 32, 0, 80
400597708, 2014-11-18, Non D-I School, NA, 14, 22, 0, 36, UNH, (1-1; 1-0 home), 37, 47, 0, 84
400597942, 2014-11-18, Howard, (1-2; 0-2 away), 16, 33, 0, 49, William & Mary, (1-1; 1-0 home), 33, 23, 0, 56
400598554, 2014-11-18, Non D-I School, NA, 24, 41, 0, 65, NC Central, (1-1; 1-0 home), 50, 73, 0, 123
400586303, 2014-11-18, Saint Louis, (2-0; 1-0 away), 28, 41, 0, 69, Indiana State, (1-1; 0-1 home), 27, 29, 0, 56
400588333, 2014-11-18, Marquette, (1-1; 0-1 away), 26, 37, 0, 63, OSU, (2-0; 2-0 home), 33, 41, 0, 74
400589257, 2014-11-18, Piedmont,  , 32, 40, 0, 72, Presbyterian, (1-1; 1-0 home), 35, 47, 0, 82
400595192, 2014-11-18, Non D-I School, NA, 21, 28, 0, 49, Ga Southern, (1-1; 1-0 home), 45, 41, 0, 86
400595367, 2014-11-18, Cent Arkansas, (0-3; 0-2 away), 34, 22, 0, 56, Nebraska, (2-0; 2-0 home), 43, 39, 0, 82
400585684, 2014-11-18, NW Oklahoma St,  , 20, 25, 0, 45, Oklahoma State, (3-0; 3-0 home), 49, 42, 0, 91
400586121, 2014-11-18, La Salle, (2-0; 1-0 away), 19, 41, 0, 60, Quinnipiac, (1-1; 1-1 home), 26, 32, 0, 58
400586305, 2014-11-18, S Illinois, (1-1; 1-1 away), 46, 38, 0, 84, Tennessee St, (1-1; 1-1 home), 26, 41, 0, 67
400587396, 2014-11-18, Buffalo, (2-1; 1-1 away), 35, 39, 0, 74, UT-Arlington, (1-1; 0-1 home), 31, 37, 0, 68
400587398, 2014-11-18, Non D-I School, NA, 30, 22, 0, 52, Kent State, (2-0; 1-0 home), 22, 40, 0, 62
400590728, 2014-11-18, Non D-I School, NA, 27, 24, 0, 51, Chicago State, (1-2; 1-0 home), 53, 49, 0, 102
400591095, 2014-11-18, Richmond, (1-1; 0-1 away), 24, 33, 0, 57, Old Dominion, (2-0; 2-0 home), 32, 31, 0, 63
400591351, 2014-11-18, Murray State, (1-1; 1-0 away), 37, 31, 0, 68, Mid Tennessee, (1-1; 1-1 home), 25, 24, 0, 49
400591352, 2014-11-18, W Kentucky, (1-1; 0-1 away), 28, 26, 0, 54, Minnesota, (1-1; 1-0 home), 46, 30, 0, 76
400595569, 2014-11-18, Non D-I School, NA, 30, 33, 0, 63, Incarnate Word, (2-0; 2-0 home), 44, 50, 0, 94
400595570, 2014-11-18, Non D-I School, NA, 29, 34, 0, 63, McNeese State, (1-1; 1-0 home), 42, 48, 0, 90
400595571, 2014-11-18, Pensacola,  , 34, 27, 0, 61, New Orleans, (1-0; 1-0 home), 47, 41, 0, 88
400596316, 2014-11-18, Hannibal-LaGrange Co,  , 29, 20, 0, 49, SE Missouri St, (1-2; 1-0 home), 42, 44, 0, 86
400598803, 2014-11-18, Non D-I School, NA, 18, 31, 0, 49, Grambling St, (1-1; 1-0 home), 24, 31, 0, 55
400586302, 2014-11-18, Drake, (0-2; 0-1 away), 25, 37, 0, 62, DePaul, (2-0; 2-0 home), 38, 42, 0, 80
400588334, 2014-11-18, Chattanooga, (1-2; 0-2 away), 22, 26, 0, 48, Butler, (2-0; 2-0 home), 25, 45, 0, 70
400591559, 2014-11-18, Non D-I School, NA, 25, 21, 0, 46, Wyoming, (2-0; 2-0 home), 31, 30, 0, 61
400585685, 2014-11-18, Kansas, (1-1; 0-0 away), 28, 12, 0, 40, Kentucky, (3-0; 2-0 home), 38, 34, 0, 72
400585686, 2014-11-18, Texas Tech, (1-1; 0-1 away), 36, 23, 5, 64, LSU, (2-0; 2-0 home), 24, 35, 10, 69
400587221, 2014-11-18, AR-Little Rock, (1-1; 0-1 away), 28, 34, 0, 62, BYU, (2-0; 2-0 home), 37, 54, 0, 91
400585892, 2014-11-18, Montana, (0-2; 0-2 away), 30, 21, 16, 67, Boise State, (3-0; 1-0 home), 20, 31, 21, 72
400593195, 2014-11-18, Non D-I School, NA, 29, 33, 0, 62, Oregon State, (2-0; 2-0 home), 48, 38, 0, 86
400595903, 2014-11-18, Non D-I School, NA, 20, 24, 0, 44, Cal Poly, (1-1; 1-0 home), 32, 33, 0, 65
400585891, 2014-11-18, Willamette,  , 27, 36, 0, 63, Portland State, (2-0; 1-0 home), 48, 36, 0, 84
400587399, 2014-11-19, Wright State, (2-1; 0-1 away), 28, 27, 0, 55, Bowling Green, (2-0; 1-0 home), 27, 43, 0, 70
400589081, 2014-11-19, Non D-I School, NA, 23, 35, 0, 58, The Citadel, (1-2; 1-0 home), 38, 33, 0, 71
400586125, 2014-11-19, Siena, (1-2; 1-1 away), 38, 35, 0, 73, St Bonaventure, (1-1; 1-1 home), 28, 42, 0, 70
400586308, 2014-11-19, Evansville, (2-0; 1-0 away), 26, 43, 0, 69, Miami (OH), (1-1; 1-1 home), 20, 30, 0, 50
400586676, 2014-11-19, Morehead State, (1-2; 0-2 away), 25, 36, 0, 61, Cincinnati, (2-0; 2-0 home), 30, 39, 0, 69
400587037, 2014-11-19, Army, (3-0; 1-0 away), 35, 39, 0, 74, St Francis (BKN), (0-2; 0-1 home), 34, 37, 0, 71
400587038, 2014-11-19, Boston U, (1-1; 1-0 away), 32, 39, 0, 71, Norfolk State, (1-2; 1-1 home), 34, 29, 0, 63
400587039, 2014-11-19, Princeton, (1-2; 0-2 away), 44, 22, 0, 66, Lafayette, (2-1; 1-0 home), 47, 36, 0, 83
400587400, 2014-11-19, Ohio, (1-1; 0-1 away), 20, 42, 0, 62, FGCU, (3-0; 3-0 home), 45, 34, 0, 79
400587772, 2014-11-19, Coppin State, (0-3; 0-3 away), 23, 44, 0, 67, Notre Dame, (3-0; 3-0 home), 53, 51, 0, 104
400587773, 2014-11-19, Liberty, (2-1; 0-1 away), 28, 35, 0, 63, VT, (2-0; 2-0 home), 31, 42, 0, 73
400588646, 2014-11-19, NC A&T, (1-2; 0-1 away), 16, 39, 0, 55, N Kentucky, (1-2; 1-0 home), 33, 35, 0, 68
400588647, 2014-11-19, Kennesaw St, (0-3; 0-3 away), 25, 41, 0, 66, Mercer, (2-1; 2-0 home), 42, 32, 0, 74
400589082, 2014-11-19, Appalachian St, (0-2; 0-2 away), 30, 35, 0, 65, Furman, (1-1; 1-1 home), 47, 37, 0, 84
400589258, 2014-11-19, Longwood, (1-1; 0-1 away), 32, 28, 0, 60, JMU, (2-1; 2-1 home), 38, 44, 0, 82
400589259, 2014-11-19, Non D-I School, NA, 21, 27, 0, 48, UNC Asheville, (2-1; 1-0 home), 42, 45, 0, 87
400591273, 2014-11-19, Dartmouth, (0-2; 0-2 away), 26, 22, 0, 48, Hartford, (2-1; 2-0 home), 30, 23, 0, 53
400591791, 2014-11-19, MD-E Shore, (1-2; 1-2 away), 26, 27, 0, 53, Mt St Mary's, (0-2; 0-1 home), 11, 30, 0, 41
400596317, 2014-11-19, Jacksonville St, (0-3; 0-3 away), 21, 25, 0, 46, Cleveland State, (2-1; 2-0 home), 34, 26, 0, 60
400596454, 2014-11-19, NJIT, (1-2; 0-2 away), 17, 31, 0, 48, Albany, (1-1; 1-0 home), 36, 29, 0, 65
400596470, 2014-11-19, Hartwick,  , 25, 26, 0, 51, Binghamton, (1-2; 1-0 home), 41, 41, 0, 82
400597727, 2014-11-19, Southern VT,  , 19, 22, 0, 41, UVM, (2-1; 1-0 home), 37, 49, 0, 86
400597808, 2014-11-19, W Michigan, (2-0; 1-0 away), 35, 47, 0, 82, Oakland, (0-3; 0-1 home), 29, 42, 0, 71
400587040, 2014-11-19, Brown, (1-2; 0-1 away), 25, 40, 0, 65, Holy Cross, (2-0; 1-0 home), 40, 40, 0, 80
400588335, 2014-11-19, LIU Brooklyn, (0-1; 0-1 away), 26, 27, 0, 53, St John's, (3-0; 3-0 home), 32, 34, 0, 66
400591755, 2014-11-19, Fair Dickinson, (2-1; 1-1 away), 16, 28, 0, 44, Rutgers, (1-1; 1-1 home), 37, 24, 0, 61
400585687, 2014-11-19, Oklahoma, (1-1; 0-1 away), 35, 28, 0, 63, Creighton, (3-0; 3-0 home), 24, 41, 0, 65
400586307, 2014-11-19, Robert Morris, (1-2; 1-1 away), 30, 38, 0, 68, Bradley, (0-2; 0-2 home), 28, 33, 0, 61
400586873, 2014-11-19, Oral Roberts, (1-1; 0-1 away), 40, 24, 0, 64, Missouri, (2-1; 2-1 home), 38, 40, 0, 78
400586875, 2014-11-19, IUPUI, (1-2; 1-1 away), 33, 37, 0, 70, Milwaukee, (1-2; 1-1 home), 40, 28, 0, 68
400587041, 2014-11-19, UMBC, (0-2; 0-2 away), 20, 18, 0, 38, Loyola (MD), (2-1; 2-0 home), 20, 25, 0, 45
400589083, 2014-11-19, Austin Peay, (1-2; 0-2 away), 30, 37, 0, 67, Samford, (1-2; 1-0 home), 41, 27, 0, 68
400590729, 2014-11-19, Non D-I School, NA, 39, 38, 0, 77, UMKC, (2-1; 1-0 home), 51, 39, 0, 90
400591353, 2014-11-19, Delaware State, (2-1; 1-1 away), 27, 28, 0, 55, North Texas, (3-0; 3-0 home), 27, 35, 0, 62
400591354, 2014-11-19, PV A&M, (0-3; 0-3 away), 25, 39, 0, 64, Rice, (1-1; 1-0 home), 29, 39, 0, 68
400595194, 2014-11-19, Lamar, (1-2; 0-2 away), 17, 38, 0, 55, Texas State, (2-0; 1-0 home), 30, 35, 0, 65
400596318, 2014-11-19, Trevecca,  , 32, 44, 0, 76, Belmont, (2-1; 1-0 home), 43, 53, 0, 96
400586309, 2014-11-19, Avila,  , 14, 25, 0, 39, Missouri State, (2-0; 2-0 home), 47, 40, 0, 87
400586675, 2014-11-19, Abil Christian, (1-1; 0-1 away), 19, 20, 0, 39, Tulsa, (2-1; 2-0 home), 33, 32, 0, 65
400587225, 2014-11-19, Santa Clara, (2-1; 0-1 away), 31, 23, 0, 54, Utah State, (3-0; 2-0 home), 26, 34, 0, 60
400597817, 2014-11-19, IND South Bend,  , 29, 26, 0, 55, Valparaiso, (2-1; 2-0 home), 47, 44, 0, 91
400593196, 2014-11-19, UC Irvine, (2-1; 0-1 away), 29, 25, 0, 54, Arizona, (3-0; 3-0 home), 26, 45, 0, 71
400595369, 2014-11-19, Green Bay, (1-1; 0-1 away), 29, 31, 0, 60, Wisconsin, (3-0; 3-0 home), 38, 46, 0, 84
400587226, 2014-11-19, Southern VA,  , 22, 26, 0, 48, BYU, (3-0; 3-0 home), 49, 52, 0, 101
400587774, 2014-11-19, Wake Forest, (2-1; 1-1 away), 30, 23, 0, 53, Arkansas, (2-0; 2-0 home), 44, 39, 0, 83
400591560, 2014-11-19, Non D-I School, NA, 26, 21, 0, 47, Air Force, (2-1; 1-0 home), 32, 38, 0, 70
400600649, 2014-11-19, N Colorado, (1-2; 0-2 away), 30, 35, 0, 65, New Mexico St, (1-2; 1-0 home), 41, 45, 0, 86
400585895, 2014-11-19, Non D-I School, NA, 19, 15, 0, 34, E Washington, (3-0; 3-0 home), 53, 42, 0, 95
400585893, 2014-11-19, Montana State, (0-3; 0-3 away), 21, 44, 0, 65, CS Northridge, (1-2; 1-0 home), 35, 37, 0, 72
400586874, 2014-11-19, Omaha, (1-1; 0-1 away), 29, 45, 0, 74, Seattle, (1-1; 1-1 home), 53, 45, 0, 98
400587222, 2014-11-19, Non D-I School, NA, 21, 25, 0, 46, San Francisco, (2-0; 2-0 home), 39, 47, 0, 86
400587224, 2014-11-19, Florida A&M, (0-3; 0-3 away), 17, 24, 0, 41, San Diego, (2-1; 1-0 home), 45, 27, 0, 72
400591561, 2014-11-19, Pepperdine, (3-0; 1-0 away), 26, 37, 0, 63, San Jose State, (1-2; 1-2 home), 22, 22, 0, 44
400585894, 2014-11-19, Non D-I School, NA, 17, 25, 0, 42, Sacramento St, (2-1; 1-0 home), 45, 29, 0, 74
400587223, 2014-11-19, Saint Joe's, (1-2; 1-1 away), 10, 32, 0, 42, Gonzaga, (3-0; 3-0 home), 48, 46, 0, 94
400595904, 2014-11-19, Non D-I School, NA, 39, 32, 0, 71, Hawaii, (3-1; 3-1 home), 48, 41, 0, 89
400591096, 2014-11-20, Texas A&M, (1-1; 0-0 away), 21, 32, 0, 53, Dayton, (2-0; 1-0 home), 22, 33, 0, 55
400587401, 2014-11-20, USC, (1-2; 0-0 away), 24, 22, 0, 46, Akron, (2-0; 1-0 home), 36, 30, 0, 66
400586677, 2014-11-20, Charleston, (1-2; 1-0 away), 21, 36, 0, 57, UConn, (2-0; 1-0 home), 30, 35, 0, 65
400587775, 2014-11-20, Drexel, (0-3; 0-1 away), 20, 26, 0, 46, Miami (FL), (3-0; 1-0 home), 28, 38, 0, 66
400587776, 2014-11-20, New Mexico, (2-1; 0-0 away), 30, 35, 0, 65, Boston College, (2-1; 1-0 home), 36, 33, 0, 69
400591355, 2014-11-20, Penn State, (2-1; 0-0 away), 34, 49, 14, 97, Charlotte, (2-0; 0-0 home), 40, 43, 23, 106
400595371, 2014-11-20, Detroit, (1-2; 0-2 away), 28, 34, 0, 62, Michigan, (3-0; 3-0 home), 27, 44, 0, 71
400585688, 2014-11-20, Texas, (3-0; 0-0 away), 24, 47, 0, 71, Iowa, (2-1; 2-0 home), 30, 27, 0, 57
400591097, 2014-11-20, MD-E Shore, (1-3; 1-3 away), 30, 36, 0, 66, VCU, (3-0; 2-0 home), 61, 45, 0, 106
400586284, 2014-11-20, Niagara, (1-1; 1-0 MAAC), 24, 37, 0, 61, St Peter's, (0-3; 0-1 MAAC), 20, 39, 0, 59
400586678, 2014-11-20, Non D-I School, NA, 24, 27, 0, 51, ECU, (2-1; 2-1 home), 51, 41, 0, 92
400586681, 2014-11-20, Non D-I School, NA, 37, 22, 0, 59, UCF, (2-0; 2-0 home), 35, 41, 0, 76
400587042, 2014-11-20, Navy, (0-3; 0-2 away), 20, 31, 0, 51, Providence, (3-0; 3-0 home), 40, 48, 0, 88
400587778, 2014-11-20, Jacksonville, (1-3; 0-2 away), 12, 31, 0, 43, NC State, (3-0; 3-0 home), 35, 44, 0, 79
400588650, 2014-11-20, Non D-I School, NA, 24, 17, 0, 41, USC Upstate, (3-0; 2-0 home), 56, 51, 0, 107
400588651, 2014-11-20, Non D-I School, NA, 34, 51, 0, 85, Stetson, (2-2; 2-1 home), 51, 45, 0, 96
400591712, 2014-11-20, UNH, (1-2; 0-2 away), 26, 37, 0, 63, Bryant, (1-1; 1-0 home), 50, 22, 0, 72
400595372, 2014-11-20, Grambling St, (1-2; 0-2 away), 15, 15, 0, 30, Purdue, (3-0; 3-0 home), 37, 45, 0, 82
400596017, 2014-11-20, UMass Lowell, (1-2; 1-2 away), 31, 26, 0, 57, Sacred Heart, (1-1; 0-1 home), 27, 27, 0, 54
400596040, 2014-11-20, Non D-I School, NA, 17, 32, 0, 49, Wagner, (1-2; 1-0 home), 37, 46, 0, 83
400597295, 2014-11-20, Texas Southern, (0-3; 0-3 away), 30, 28, 0, 58, Tennessee, (1-1; 1-0 home), 30, 40, 0, 70
400598686, 2014-11-20, Non D-I School, NA, 35, 34, 0, 69, St Francis (PA), (1-2; 1-0 home), 62, 40, 0, 102
400606487, 2014-11-20, Non D-I School, NA, 15, 42, 0, 57, William & Mary, (2-1; 2-0 home), 48, 52, 0, 100
400585689, 2014-11-20, George Mason, (1-2; 0-0 away), 27, 38, 0, 65, West Virginia, (3-0; 2-0 home), 53, 38, 0, 91
400591098, 2014-11-20, Fordham, (1-2; 0-2 away), 18, 32, 0, 50, Maryland, (3-0; 3-0 home), 23, 43, 0, 66
400596319, 2014-11-20, Non D-I School, NA, 14, 15, 0, 29, UT Martin, (2-1; 1-0 home), 58, 57, 0, 115
400589261, 2014-11-20, Howard, (1-3; 0-3 away), 18, 34, 0, 52, Radford, (1-2; 1-0 home), 20, 41, 0, 61
400587043, 2014-11-20, Bucknell, (1-2; 0-2 away), 26, 39, 0, 65, Villanova, (3-0; 2-0 home), 33, 39, 0, 72
400586679, 2014-11-20, SMU, (1-2; 0-2 away), 33, 35, 0, 68, Indiana, (3-0; 3-0 home), 38, 36, 0, 74
400585690, 2014-11-20, New Orleans, (1-1; 0-1 away), 33, 38, 0, 71, TCU, (3-0; 3-0 home), 54, 32, 0, 86
400586680, 2014-11-20, USF, (3-0; 1-0 away), 30, 31, 12, 73, UAB, (1-2; 1-2 home), 33, 28, 10, 71
400588649, 2014-11-20, North Florida, (1-2; 0-2 away), 29, 38, 0, 67, Northwestern, (3-0; 2-0 home), 31, 38, 0, 69
400591291, 2014-11-20, FAU, (1-2; 0-2 away), 20, 29, 0, 49, Harvard, (2-1; 2-0 home), 38, 33, 0, 71
400595373, 2014-11-20, Non D-I School, NA, 31, 26, 0, 57, Minnesota, (2-1; 2-0 home), 55, 54, 0, 109
400595572, 2014-11-20, Northwestern St, (2-1; 1-1 away), 42, 47, 0, 89, Non D-I School, NA, 32, 47, 0, 79
400595905, 2014-11-20, UC Davis, (2-0; 1-0 away), 34, 29, 0, 63, E Illinois, (1-2; 1-1 home), 33, 28, 0, 61
400596320, 2014-11-20, Non D-I School, NA, 24, 32, 0, 56, Murray State, (2-1; 1-1 home), 44, 45, 0, 89
400596321, 2014-11-20, Non D-I School, NA, 22, 38, 0, 60, Tennessee St, (2-1; 2-1 home), 29, 46, 0, 75
400598816, 2014-11-20, Miss Valley St, (0-3; 0-3 away), 27, 34, 0, 61, Tulane, (1-1; 1-1 home), 41, 59, 0, 100
400589260, 2014-11-20, Winthrop, (2-1; 1-1 away), 28, 30, 0, 58, Savannah State, (1-2; 1-0 home), 26, 33, 0, 59
400586310, 2014-11-20, Morgan State, (0-3; 0-2 away), 30, 23, 0, 53, Northern Iowa, (3-0; 2-0 home), 29, 44, 0, 73
400591258, 2014-11-20, Cornell, (2-2; 1-1 away), 21, 24, 0, 45, South Carolina, (2-1; 1-1 home), 35, 34, 0, 69
400591009, 2014-11-20, Southern, (1-2; 0-1 away), 15, 23, 0, 38, Ole Miss, (2-1; 1-1 home), 37, 32, 0, 69
400587227, 2014-11-20, Loyola Mary, (1-2; 0-1 away), 22, 22, 0, 44, Arizona State, (3-0; 3-0 home), 28, 40, 0, 68
400588648, 2014-11-20, Lipscomb, (1-2; 0-1 away), 25, 37, 0, 62, Vanderbilt, (2-0; 2-0 home), 40, 32, 0, 72
400590730, 2014-11-20, UT-Arlington, (2-1; 2-0 away), 27, 39, 0, 66, Grand Canyon, (1-2; 1-1 home), 31, 33, 0, 64
400591356, 2014-11-20, Southern Miss, (2-1; 0-1 away), 30, 37, 0, 67, Alabama, (3-0; 3-0 home), 38, 43, 0, 81
400585897, 2014-11-20, Idaho, (2-1; 0-1 away), 27, 40, 0, 67, N Illinois, (2-0; 2-0 home), 39, 39, 0, 78
400587777, 2014-11-20, Syracuse, (2-1; 0-0 away), 22, 37, 0, 59, Cal, (3-0; 2-0 home), 34, 39, 0, 73
400585898, 2014-11-20, Fresno State, (1-2; 0-2 away), 23, 29, 0, 52, N Arizona, (1-2; 1-0 home), 39, 34, 0, 73
400586876, 2014-11-20, Denver, (1-1; 0-1 away), 26, 36, 0, 62, Saint Mary's, (3-0; 3-0 home), 34, 44, 0, 78
400599867, 2014-11-20, Pacific Union,  , 27, 29, 0, 56, Pacific, (2-1; 1-0 home), 41, 40, 0, 81
400590731, 2014-11-20, CSU Bakersfield, (0-4; 0-2 away), 12, 15, 0, 27, San Diego State, (3-0; 3-0 home), 22, 29, 0, 51
400593197, 2014-11-20, Nicholls State, (0-2; 0-2 away), 29, 45, 0, 74, UCLA, (3-0; 3-0 home), 60, 47, 0, 107
400607988, 2014-11-21, USC, (2-2; 0-0 away), 28, 44, 0, 72, Drexel, (0-4; 0-1 home), 40, 30, 0, 70
400608011, 2014-11-21, Texas A&M, (2-1; 0-0 away), 20, 39, 0, 59, Charleston, (1-3; 0-1 home), 26, 24, 0, 50
400589263, 2014-11-21, Clemson, (1-2; 0-0 away), 36, 34, 0, 70, Gardner-Webb, (2-1; 0-0 home), 34, 38, 0, 72
400608010, 2014-11-21, Dayton, (2-1; 0-0 away), 41, 23, 0, 64, UConn, (3-0; 1-0 home), 41, 34, 0, 75
400607989, 2014-11-21, Akron, (2-1; 0-0 away), 30, 21, 0, 51, Miami (FL), (4-0; 1-0 home), 35, 44, 0, 79
400588336, 2014-11-21, Seton Hall, (2-0; 0-0 away), 37, 31, 0, 68, Nevada, (2-1; 2-0 home), 27, 33, 0, 60
400589262, 2014-11-21, UNC Greensboro, (1-2; 0-0 away), 28, 41, 10, 79, Longwood, (2-1; 1-0 home), 28, 41, 12, 81
400600644, 2014-11-21, Valparaiso, (3-1; 0-1 away), 35, 24, 0, 59, AR-Pine Bluff, (1-3; 0-0 home), 26, 20, 0, 46
400607994, 2014-11-21, Syracuse, (3-1; 0-0 away), 34, 32, 0, 66, Iowa, (2-2; 2-0 home), 29, 34, 0, 63
400591322, 2014-11-21, UIC, (1-2; 0-1 away), 26, 32, 0, 58, Yale, (2-1; 1-0 home), 40, 30, 0, 70
400591733, 2014-11-21, Cent Conn St, (0-3; 0-1 away), 15, 34, 0, 49, Towson, (2-1; 0-0 home), 26, 32, 0, 58
400607992, 2014-11-21, Boston College, (2-2; 0-0 away), 32, 34, 0, 66, West Virginia, (4-0; 2-0 home), 21, 49, 0, 70
400591061, 2014-11-21, Alcorn State, (0-3; 0-2 away), 30, 39, 0, 69, Hampton, (1-2; 0-0 home), 43, 39, 0, 82
400591359, 2014-11-21, LSU, (2-1; 0-0 away), 30, 31, 0, 61, Old Dominion, (3-0; 2-0 home), 33, 37, 0, 70
400587045, 2014-11-21, Boston U, (1-2; 1-1 away), 35, 30, 0, 65, Kentucky, (4-0; 3-0 home), 40, 49, 0, 89
400587781, 2014-11-21, G Washington, (2-1; 1-1 away), 26, 16, 0, 42, UVA, (4-0; 3-0 home), 22, 37, 0, 59
400586311, 2014-11-21, Loyola (CHI), (2-1; 0-1 away), 14, 38, 0, 52, Michigan State, (2-1; 1-0 home), 38, 49, 0, 87
400585693, 2014-11-21, PV A&M, (0-4; 0-4 away), 22, 23, 0, 45, Baylor, (3-0; 2-0 home), 37, 23, 0, 60
400586128, 2014-11-21, Wofford, (2-1; 1-1 away), 20, 34, 0, 54, Fairfield, (1-2; 0-1 home), 12, 24, 0, 36
400586129, 2014-11-21, Lehigh, (0-3; 0-1 away), 32, 42, 0, 74, Rider, (2-1; 1-0 home), 38, 40, 0, 78
400586877, 2014-11-21, IPFW, (2-1; 1-1 away), 26, 43, 0, 69, Georgia Tech, (3-0; 3-0 home), 32, 46, 0, 78
400587402, 2014-11-21, Toledo, (1-2; 0-2 away), 34, 34, 0, 68, Oregon, (3-0; 3-0 home), 36, 42, 0, 78
400587403, 2014-11-21, Youngstown St, (1-3; 0-2 away), 33, 29, 0, 62, E Michigan, (3-0; 3-0 home), 33, 38, 0, 71
400589084, 2014-11-21, Non D-I School, NA, 26, 27, 0, 53, W Carolina, (1-2; 1-0 home), 28, 44, 0, 72
400591562, 2014-11-21, UNLV, (2-1; 0-0 away), 29, 31, 0, 60, Stanford, (3-0; 2-0 home), 52, 37, 0, 89
400595195, 2014-11-21, Troy, (1-2; 0-1 away), 23, 37, 0, 60, Georgia, (2-1; 2-0 home), 38, 44, 0, 82
400597687, 2014-11-21, Stony Brook, (1-2; 0-2 away), 30, 35, 0, 65, Hofstra, (2-1; 2-0 home), 25, 41, 0, 66
400600050, 2014-11-21, Maine, (0-3; 0-3 away), 21, 27, 0, 48, Cent Michigan, (3-0; 3-0 home), 44, 32, 0, 76
400607996, 2014-11-21, Charlotte, (3-0; 1-0 away), 29, 36, 0, 65, South Carolina, (2-2; 1-1 home), 36, 27, 0, 63
400607995, 2014-11-21, Texas, (4-0; 0-0 away), 31, 40, 0, 71, Cal, (3-1; 2-0 home), 21, 34, 0, 55
400586127, 2014-11-21, Bethune-Cookman, (1-2; 0-2 away), 19, 31, 0, 50, Monmouth, (1-1; 1-0 home), 32, 41, 0, 73
400586312, 2014-11-21, S Illinois, (1-2; 1-2 away), 28, 23, 0, 51, Kent State, (3-0; 2-0 home), 43, 31, 0, 74
400591357, 2014-11-21, Non D-I School, NA, 19, 29, 0, 48, FIU, (3-0; 2-0 home), 37, 37, 0, 74
400607993, 2014-11-21, New Mexico, (3-1; 0-0 away), 30, 39, 0, 69, George Mason, (1-3; 1-1 home), 20, 38, 0, 58
400595197, 2014-11-21, UL Monroe, (2-1; 1-1 away), 29, 22, 5, 56, Florida, (2-1; 2-1 home), 27, 24, 10, 61
400585691, 2014-11-21, Milwaukee, (1-3; 0-2 away), 27, 41, 0, 68, Oklahoma State, (4-0; 4-0 home), 44, 38, 0, 82
400585899, 2014-11-21, North Dakota, (1-2; 0-2 away), 44, 28, 0, 72, South Dakota St, (1-2; 1-0 home), 29, 45, 0, 74
400586878, 2014-11-21, Kennesaw St, (0-4; 0-4 away), 19, 36, 0, 55, North Dakota St, (1-2; 1-0 home), 39, 29, 0, 68
400588337, 2014-11-21, SF Austin, (1-2; 0-1 away), 32, 31, 0, 63, Xavier, (3-0; 3-0 home), 39, 42, 0, 81
400591358, 2014-11-21, Morehead State, (1-3; 0-3 away), 25, 39, 0, 64, LA Tech, (2-1; 1-0 home), 33, 40, 0, 73
400595375, 2014-11-21, Austin Peay, (1-3; 0-3 away), 25, 41, 0, 66, Illinois, (3-0; 3-0 home), 46, 61, 0, 107
400595574, 2014-11-21, Non D-I School, NA, 34, 36, 0, 70, McNeese State, (2-1; 2-0 home), 40, 45, 0, 85
400597296, 2014-11-21, Delaware State, (2-2; 1-2 away), 30, 41, 0, 71, Arkansas, (3-0; 3-0 home), 44, 55, 0, 99
400586130, 2014-11-21, Iona, (2-1; 1-1 away), 41, 44, 0, 85, Wake Forest, (2-2; 1-1 home), 33, 48, 0, 81
400587779, 2014-11-21, Marshall, (3-1; 0-1 away), 27, 40, 0, 67, Louisville, (3-0; 2-0 home), 41, 44, 0, 85
400593198, 2014-11-21, UC Riverside, (1-2; 0-1 away), 21, 21, 0, 42, Utah, (2-1; 2-0 home), 48, 40, 0, 88
400585902, 2014-11-21, Idaho State, (0-3; 0-3 away), 31, 37, 0, 68, Washington St, (1-2; 1-0 home), 32, 48, 0, 80
400586879, 2014-11-21, Oral Roberts, (1-2; 0-2 away), 20, 22, 0, 42, Oregon State, (3-0; 3-0 home), 18, 37, 0, 55
400590733, 2014-11-21, Florida A&M, (0-4; 0-4 away), 22, 27, 0, 49, Grand Canyon, (2-2; 2-1 home), 34, 30, 0, 64
400591563, 2014-11-21, Georgia State, (1-2; 0-2 away), 34, 36, 0, 70, Colorado State, (2-0; 2-0 home), 29, 51, 0, 80
400595196, 2014-11-21, LA-Lafayette, (1-2; 0-2 away), 38, 42, 0, 80, Auburn, (2-1; 2-0 home), 45, 60, 0, 105
400607997, 2014-11-21, Penn State, (3-1; 0-0 away), 28, 44, 0, 72, Cornell, (2-3; 1-0 home), 37, 34, 0, 71
400585901, 2014-11-21, Illinois State, (1-1; 0-0 away), 44, 29, 0, 73, Weber State, (1-2; 1-0 home), 28, 36, 0, 64
400586682, 2014-11-21, Temple, (2-1; 0-0 away), 26, 28, 0, 54, Duke, (4-0; 2-0 home), 36, 38, 0, 74
400586880, 2014-11-21, Sam Houston, (2-1; 0-1 away), 30, 35, 28, 93, South Dakota, (0-3; 0-0 home), 33, 32, 20, 85
400590732, 2014-11-21, Washington, (2-0; 1-0 away), 20, 43, 0, 63, Seattle, (1-2; 1-2 home), 21, 27, 0, 48
400595906, 2014-11-21, Delaware, (0-2; 0-2 away), 22, 38, 0, 60, Cal Poly, (2-1; 2-0 home), 48, 30, 0, 78
400585692, 2014-11-21, Kansas State, (2-1; 0-1 away), 26, 34, 0, 60, LBSU, (2-2; 2-0 home), 33, 36, 0, 69
400587044, 2014-11-21, Presbyterian, (1-2; 0-1 away), 19, 19, 0, 38, American U, (2-1; 1-0 home), 26, 37, 0, 63
400587780, 2014-11-21, Pitt, (2-1; 0-1 away), 36, 34, 0, 70, Hawaii, (4-1; 4-1 home), 40, 34, 0, 74
400585900, 2014-11-21, Montana State, (7-23; 4-14 Big Sky),  ,  , 0, 0, Buffalo, (23-9; 12-6 MAC),  ,  , 0, 0
400591312, 2014-11-22, Incarnate Word, (3-0; 1-0 away), 31, 48, 0, 79, Princeton, (1-3; 1-1 home), 27, 41, 0, 68
400587782, 2014-11-22, Notre Dame, (4-0; 0-0 away), 31, 50, 0, 81, UMass, (3-1; 2-0 home), 28, 40, 0, 68
400588338, 2014-11-22, Robert Morris, (1-3; 1-2 away), 24, 42, 0, 66, Georgetown, (3-0; 3-0 home), 36, 44, 0, 80
400586136, 2014-11-22, St Peter's, (0-4; 0-1 MAAC), 14, 36, 0, 50, La Salle, (3-0; 2-0 home), 23, 36, 0, 59
400586313, 2014-11-22, Drake, (0-3; 0-2 away), 46, 29, 0, 75, W Michigan, (3-0; 2-0 home), 41, 50, 0, 91
400586881, 2014-11-22, Ball State, (1-2; 0-2 away), 31, 30, 8, 69, IUPUI, (2-2; 1-1 home), 32, 29, 10, 71
400587785, 2014-11-22, Appalachian St, (1-2; 1-2 away), 29, 36, 0, 65, VT, (2-1; 2-1 home), 28, 35, 0, 63
400591564, 2014-11-22, Utah State, (3-1; 1-1 away), 38, 25, 0, 63, Miss St, (3-0; 3-0 home), 34, 37, 0, 71
400599792, 2014-11-22, High Point, (3-1; 1-1 away), 21, 35, 0, 56, Richmond, (2-1; 2-0 home), 45, 35, 0, 80
400587784, 2014-11-22, UNC, (3-0; 0-0 away), 46, 44, 0, 90, Davidson, (2-1; 2-0 home), 34, 38, 0, 72
400586315, 2014-11-22, North Florida, (1-3; 0-3 away), 18, 31, 0, 49, Northern Iowa, (4-0; 3-0 home), 33, 33, 0, 66
400587046, 2014-11-22, Colgate, (1-2; 1-2 away), 24, 30, 0, 54, Campbell, (1-2; 1-1 home), 25, 23, 0, 48
400595908, 2014-11-22, Samford, (1-3; 0-2 away), 31, 41, 0, 72, CS Northridge, (2-2; 1-0 home), 37, 42, 0, 79
400596533, 2014-11-22, UMass Lowell, (2-2; 2-2 away), 23, 40, 0, 63, NJIT, (1-3; 1-1 home), 25, 36, 0, 61
400586882, 2014-11-22, Omaha, (2-1; 1-1 away), 44, 53, 0, 97, Marquette, (1-2; 1-1 home), 41, 48, 0, 89
400587783, 2014-11-22, FSU, (1-2; 0-0 away), 19, 35, 0, 54, Providence, (4-0; 3-0 home), 34, 46, 0, 80
400608204, 2014-11-22, Clemson, (2-2; 0-0 away), 39, 20, 0, 59, Nevada, (2-2; 2-0 home), 24, 26, 0, 50
400590734, 2014-11-22, Non D-I School, NA, 25, 27, 0, 52, Chicago State, (2-2; 2-0 home), 45, 30, 0, 75
400591361, 2014-11-22, Texas State, (2-1; 1-1 away), 40, 27, 0, 67, UTSA, (2-1; 2-1 home), 33, 47, 0, 80
400595199, 2014-11-22, South Alabama, (1-2; 0-2 away), 20, 33, 0, 53, Detroit, (2-2; 2-0 home), 31, 35, 0, 66
400587406, 2014-11-22, Liberty, (2-2; 0-2 away), 27, 25, 0, 52, Miami (OH), (2-1; 2-1 home), 24, 39, 0, 63
400586137, 2014-11-22, Canisius, (2-1; 1-1 away), 30, 23, 0, 53, St Bonaventure, (2-1; 2-1 home), 28, 31, 0, 59
400591565, 2014-11-22, Non D-I School, NA, 30, 30, 0, 60, Air Force, (3-1; 2-0 home), 45, 45, 0, 90
400595379, 2014-11-22, Elon, (1-2; 0-1 away), 29, 32, 6, 67, Northwestern, (4-0; 3-0 home), 27, 34, 7, 68
400595575, 2014-11-22, SE Missouri St, (2-2; 1-1 away), 39, 35, 0, 74, Cent Arkansas, (0-4; 0-1 home), 33, 35, 0, 68
400597730, 2014-11-22, Cleveland State, (2-2; 0-2 away), 40, 39, 4, 83, Savannah State, (2-2; 2-0 home), 42, 37, 8, 87
400598556, 2014-11-22, MD-E Shore, (1-4; 1-4 away), 26, 27, 0, 53, St Francis (PA), (2-2; 2-0 home), 31, 26, 0, 57
400589264, 2014-11-22, Longwood, (2-2; 0-1 away), 33, 39, 0, 72, Youngstown St, (2-3; 1-1 home), 40, 42, 0, 82
400591010, 2014-11-22, Southern, (1-3; 0-2 away), 27, 21, 0, 48, Mid Tennessee, (2-1; 2-1 home), 38, 28, 0, 66
400595200, 2014-11-22, UMKC, (2-2; 1-2 away), 34, 34, 0, 68, AR-Little Rock, (2-1; 2-0 home), 30, 43, 0, 73
400586316, 2014-11-22, Yale, (3-1; 0-1 away), 27, 26, 0, 53, S Illinois, (1-3; 0-0 home), 23, 23, 0, 46
400586884, 2014-11-22, South Dakota, (0-4; 0-2 away), 27, 41, 0, 68, Wofford, (3-1; 1-0 home), 40, 32, 0, 72
400587047, 2014-11-22, Loyola (MD), (2-2; 0-2 away), 18, 21, 0, 39, Butler, (3-0; 3-0 home), 42, 38, 0, 80
400591099, 2014-11-22, Duquesne, (2-0; 1-0 away), 46, 56, 0, 102, Abil Christian, (1-2; 1-1 home), 38, 43, 0, 81
400591566, 2014-11-22, San Jose State, (1-3; 0-1 away), 26, 40, 0, 66, CS Fullerton, (1-2; 1-0 home), 32, 38, 0, 70
400597937, 2014-11-22, Towson, (3-1; 1-1 away), 24, 39, 0, 63, Bethune-Cookman, (1-3; 1-0 home), 16, 26, 0, 42
400598555, 2014-11-22, Texas Southern, (0-4; 0-4 away), 33, 33, 0, 66, Norfolk State, (2-2; 2-1 home), 37, 39, 0, 76
400608205, 2014-11-22, LSU, (3-1; 0-0 away), 28, 44, 0, 72, Weber State, (1-3; 1-0 home), 27, 31, 0, 58
400586138, 2014-11-22, Binghamton, (1-3; 0-2 away), 27, 36, 0, 63, Manhattan, (1-2; 0-0 home), 43, 35, 0, 78
400589265, 2014-11-22, Wright State, (3-1; 1-1 away), 42, 44, 0, 86, Charleston So, (2-1; 1-1 home), 35, 44, 0, 79
400596322, 2014-11-22, Non D-I School, NA, 40, 31, 0, 71, Jacksonville St, (1-3; 1-0 home), 40, 48, 0, 88
400608201, 2014-11-22, Alcorn State, (0-4; 0-2 away), 29, 51, 0, 80, Kennesaw St, (1-4; 0-0 home), 44, 39, 0, 83
400586314, 2014-11-22, Brown, (1-3; 0-2 away), 25, 41, 0, 66, Indiana State, (2-1; 1-1 home), 36, 42, 0, 78
400589085, 2014-11-22, Non D-I School, NA, 34, 16, 0, 50, The Citadel, (2-2; 2-0 home), 41, 40, 0, 81
400591568, 2014-11-22, Colorado, (2-1; 0-1 away), 24, 9, 0, 33, Wyoming, (3-0; 3-0 home), 26, 30, 0, 56
400595198, 2014-11-22, Johnson Univ (FL),  , 19, 22, 0, 41, Ga Southern, (2-1; 2-0 home), 58, 39, 0, 97
400608187, 2014-11-22, Non D-I School, NA, 15, 18, 0, 33, Coast Carolina, (3-1; 3-0 home), 33, 43, 0, 76
400591101, 2014-11-22, Nebraska, (2-1; 0-1 away), 23, 30, 9, 62, URI, (3-0; 3-0 home), 19, 34, 13, 66
400585904, 2014-11-22, E Washington, (3-1; 0-1 away), 35, 33, 0, 68, SMU, (2-2; 2-0 home), 43, 34, 0, 77
400586132, 2014-11-22, Sam Houston, (3-1; 1-1 away), 35, 39, 0, 74, Fairfield, (1-3; 0-2 home), 33, 27, 0, 60
400586133, 2014-11-22, Hartford, (3-1; 1-0 away), 25, 40, 0, 65, Niagara, (1-2; 1-0 MAAC), 30, 32, 0, 62
400586134, 2014-11-22, Army, (4-0; 2-0 away), 41, 35, 0, 76, Marist, (0-2; 0-1 home), 41, 21, 0, 62
400586135, 2014-11-22, Quinnipiac, (2-1; 1-0 away), 26, 36, 14, 76, Albany, (1-2; 1-1 home), 35, 27, 11, 73
400587048, 2014-11-22, American U, (2-2; 0-2 away), 23, 21, 0, 44, LA Tech, (3-1; 2-0 home), 34, 29, 0, 63
400587049, 2014-11-22, Lafayette, (3-1; 2-1 away), 45, 38, 0, 83, Penn, (0-3; 0-3 home), 30, 47, 0, 77
400587050, 2014-11-22, Mt St Mary's, (1-2; 1-1 away), 36, 37, 0, 73, Bucknell, (1-3; 1-1 home), 41, 28, 0, 69
400587405, 2014-11-22, UNC Greensboro, (1-3; 0-1 away), 19, 43, 0, 62, E Michigan, (4-0; 4-0 home), 30, 40, 0, 70
400588653, 2014-11-22, Non D-I School, NA, 17, 31, 0, 48, N Kentucky, (2-2; 2-0 home), 57, 41, 0, 98
400589086, 2014-11-22, UNC Asheville, (2-2; 1-2 away), 42, 45, 0, 87, East Tenn St, (2-1; 2-0 home), 53, 45, 0, 98
400589088, 2014-11-22, UNC-Wilmington, (2-1; 2-1 away), 46, 64, 0, 110, VMI, (2-2; 1-1 home), 45, 48, 0, 93
400589089, 2014-11-22, Chattanooga, (1-3; 0-3 away), 43, 24, 0, 67, Tenn Tech, (2-1; 2-0 home), 26, 43, 0, 69
400591100, 2014-11-22, UVM, (2-2; 1-2 away), 26, 34, 0, 60, Saint Joe's, (2-2; 1-1 home), 32, 36, 0, 68
400595909, 2014-11-22, Non D-I School, NA, 22, 23, 0, 45, UCSB, (1-2; 1-0 home), 47, 44, 0, 91
400596323, 2014-11-22, Non D-I School, NA, 24, 26, 0, 50, E Kentucky, (3-0; 3-0 home), 58, 57, 0, 115
400608267, 2014-11-22, UNLV, (3-1; 0-0 away), 24, 33, 0, 57, Temple, (2-2; 2-0 home), 27, 23, 0, 50
400586131, 2014-11-22, Cent Conn St, (0-4; 0-2 away), 23, 27, 0, 50, Monmouth, (2-1; 2-0 home), 31, 34, 0, 65
400587404, 2014-11-22, UIC, (1-3; 0-2 away), 29, 31, 0, 60, Kent State, (4-0; 3-0 home), 47, 31, 0, 78
400588652, 2014-11-22, Transylvania,  , 24, 39, 0, 63, Lipscomb, (2-2; 2-1 home), 34, 40, 0, 74
400589087, 2014-11-22, UC Davis, (3-0; 2-0 away), 30, 28, 0, 58, Furman, (1-2; 1-2 home), 27, 28, 0, 55
400585694, 2014-11-22, Missouri State, (2-1; 0-1 away), 38, 30, 0, 68, Texas Tech, (2-1; 2-0 home), 42, 38, 0, 80
400586684, 2014-11-22, Morgan State, (0-4; 0-3 away), 28, 29, 0, 57, Houston, (2-0; 1-0 home), 41, 31, 0, 72
400586883, 2014-11-22, SE Louisiana, (0-3; 0-3 away), 25, 32, 0, 57, W Illinois, (1-2; 1-1 home), 21, 39, 0, 60
400587051, 2014-11-22, Northeastern, (3-0; 1-0 away), 30, 38, 0, 68, Navy, (0-4; 0-1 home), 23, 21, 0, 44
400590735, 2014-11-22, TXAMKing,  , 32, 45, 0, 77, UT Pan American, (3-0; 2-0 home), 41, 41, 0, 82
400591360, 2014-11-22, William & Mary, (3-1; 1-1 away), 38, 31, 0, 69, Rice, (1-2; 1-1 home), 30, 35, 0, 65
400591362, 2014-11-22, Belmont, (3-1; 2-1 away), 26, 38, 0, 64, W Kentucky, (1-2; 1-1 home), 37, 26, 0, 63
400595377, 2014-11-22, Lamar, (1-3; 0-3 away), 34, 38, 0, 72, Indiana, (4-0; 4-0 home), 42, 43, 0, 85
400599464, 2014-11-22, Non D-I School, NA, 21, 24, 0, 45, Tulane, (2-1; 2-1 home), 44, 45, 0, 89
400601530, 2014-11-22, Non D-I School, NA, 24, 37, 0, 61, Alabama A&M, (1-2; 1-0 home), 45, 36, 0, 81
400608202, 2014-11-22, Hampton, (1-3; 0-3 away), 42, 24, 0, 66, North Dakota St, (2-2; 2-0 home), 35, 39, 0, 74
400595201, 2014-11-22, Houston Baptist, (1-2; 0-2 away), 26, 43, 0, 69, UT-Arlington, (3-1; 1-1 home), 44, 43, 0, 87
400595378, 2014-11-22, UMBC, (0-3; 0-3 away), 26, 25, 0, 51, Minnesota, (3-1; 3-0 home), 32, 37, 0, 69
400587229, 2014-11-22, Non D-I School, NA, 26, 29, 0, 55, Gonzaga, (4-0; 4-0 home), 57, 52, 0, 109
400585903, 2014-11-22, Utah Valley, (2-1; 1-1 away), 33, 52, 0, 85, Southern Utah, (0-3; 0-1 home), 34, 41, 0, 75
400590736, 2014-11-22, New Mexico St, (1-3; 0-3 away), 42, 34, 0, 76, UTEP, (2-0; 2-0 home), 30, 47, 0, 77
400608268, 2014-11-22, Stanford, (3-1; 0-0 away), 29, 30, 0, 59, Duke, (5-0; 2-0 home), 40, 30, 0, 70
400589267, 2014-11-22, Morehead State, (2-3; 0-3 away), 29, 40, 0, 69, Presbyterian, (1-3; 1-0 home), 25, 24, 0, 49
400591567, 2014-11-22, Boise State, (3-1; 1-1 away), 24, 30, 0, 54, Wisconsin, (4-0; 4-0 home), 38, 40, 0, 78
400587228, 2014-11-22, SIU-ED, (1-2; 0-1 away), 28, 25, 0, 53, Portland, (3-0; 2-0 home), 46, 29, 0, 75
400600645, 2014-11-23, Valparaiso, (4-1; 0-1 away), 53, 40, 0, 93, Maine, (0-4; 0-0 home), 28, 42, 0, 70
400608195, 2014-11-23, Charleston, (2-3; 1-0 away), 37, 24, 0, 61, George Mason, (1-4; 1-1 home), 34, 26, 0, 60
400587786, 2014-11-23, UMass, (4-1; 0-0 away), 34, 41, 0, 75, FSU, (1-3; 1-1 home), 35, 34, 0, 69
400589091, 2014-11-23, Wofford, (4-1; 1-1 away), 26, 38, 0, 64, Sam Houston, (3-2; 1-0 home), 19, 34, 0, 53
400597830, 2014-11-23, Youngstown St, (3-3; 0-2 away), 32, 44, 0, 76, UNC Greensboro, (1-4; 1-1 home), 34, 33, 0, 67
400600051, 2014-11-23, AR-Pine Bluff, (1-4; 0-2 away), 22, 21, 0, 43, Cent Michigan, (4-0; 4-0 home), 37, 38, 0, 75
400586318, 2014-11-23, S Illinois, (2-3; 1-2 away), 35, 32, 0, 67, UIC, (1-4; 1-0 home), 21, 39, 0, 60
400587052, 2014-11-23, American U, (3-2; 0-2 away), 20, 31, 0, 51, Morehead State, (2-4; 1-0 home), 25, 21, 0, 46
400608210, 2014-11-23, Drexel, (1-4; 0-1 away), 17, 44, 0, 61, Cornell, (2-4; 1-0 home), 26, 33, 0, 59
400586140, 2014-11-23, South Dakota, (0-5; 0-3 away), 29, 39, 4, 72, Fairfield, (2-3; 1-2 home), 29, 39, 12, 80
400587053, 2014-11-23, Columbia, (2-1; 1-1 away), 32, 22, 0, 54, Lehigh, (0-4; 0-2 home), 23, 21, 0, 44
400591102, 2014-11-23, Texas A&M-CC, (2-1; 1-1 away), 24, 38, 0, 62, Saint Louis, (2-1; 1-1 home), 27, 29, 0, 56
400591734, 2014-11-23, Bethune-Cookman, (2-3; 0-2 away), 27, 38, 0, 65, Cent Conn St, (0-5; 0-0 home), 35, 25, 0, 60
400597688, 2014-11-23, Merchant Marine,  , 28, 26, 0, 54, Stony Brook, (2-2; 2-0 home), 43, 46, 0, 89
400608196, 2014-11-23, Texas A&M, (3-1; 0-0 away), 26, 38, 0, 64, New Mexico, (3-2; 2-0 home), 31, 20, 0, 51
400608313, 2014-11-23, CS Northridge, (2-3; 0-3 away), 36, 33, 19, 88, AR-Little Rock, (3-1; 3-0 home), 41, 28, 25, 94
400587408, 2014-11-23, Longwood, (2-3; 0-2 away), 24, 24, 0, 48, E Michigan, (5-0; 5-0 home), 38, 41, 0, 79
400587787, 2014-11-23, Providence, (5-0; 0-0 away), 39, 36, 0, 75, Notre Dame, (4-1; 3-0 home), 35, 39, 0, 74
400586319, 2014-11-23, Newman,  , 33, 24, 0, 57, Wichita State, (3-0; 2-0 home), 67, 38, 0, 105
400585695, 2014-11-23, Northwestern St, (2-2; 1-2 away), 30, 38, 0, 68, Oklahoma, (2-1; 2-0 home), 50, 40, 0, 90
400586885, 2014-11-23, Coppin State, (0-4; 0-4 away), 23, 31, 0, 54, Denver, (2-1; 2-0 home), 34, 46, 0, 80
400589268, 2014-11-23, Catawba,  , 29, 23, 0, 52, Radford, (2-2; 2-0 home), 41, 47, 0, 88
400591036, 2014-11-23, Jackson State, (1-3; 1-3 away), 21, 29, 0, 50, UAB, (2-2; 2-2 home), 27, 31, 0, 58
400587407, 2014-11-23, Yale, (4-1; 1-1 away), 24, 42, 0, 66, Kent State, (4-1; 3-1 home), 32, 27, 0, 59
400608211, 2014-11-23, USC, (2-3; 0-0 away), 30, 31, 0, 61, Penn State, (4-1; 2-0 home), 31, 32, 0, 63
400586685, 2014-11-23, USF, (3-1; 1-1 away), 29, 36, 0, 65, NC State, (4-0; 4-0 home), 33, 35, 0, 68
400588339, 2014-11-23, NC Central, (1-2; 0-2 away), 22, 23, 0, 45, Creighton, (4-0; 4-0 home), 27, 38, 0, 65
400595910, 2014-11-23, Non D-I School, NA, 27, 22, 0, 49, UC Riverside, (2-2; 2-1 home), 54, 48, 0, 102
400587054, 2014-11-23, Nichols,  , 38, 32, 0, 70, Holy Cross, (3-0; 2-0 home), 60, 41, 0, 101
400586139, 2014-11-23, Towson, (4-1; 2-1 away), 29, 37, 13, 79, Monmouth, (2-2; 2-1 home), 41, 25, 9, 75
400596041, 2014-11-23, Wagner, (1-3; 0-3 away), 30, 41, 0, 71, Hofstra, (3-1; 3-0 home), 47, 46, 0, 93
400608188, 2014-11-23, Dayton, (3-1; 0-0 away), 34, 31, 0, 65, Boston College, (2-3; 1-0 home), 27, 26, 0, 53
400586317, 2014-11-23, NC A&T, (1-3; 0-2 away), 21, 29, 0, 50, Bradley, (1-2; 1-2 home), 33, 25, 0, 58
400586687, 2014-11-23, E Illinois, (1-3; 0-2 away), 26, 23, 0, 49, Cincinnati, (3-0; 3-0 home), 26, 28, 0, 54
400589269, 2014-11-23, Presbyterian, (1-4; 0-2 away), 23, 25, 0, 48, LA Tech, (4-1; 3-0 home), 40, 36, 0, 76
400591363, 2014-11-23, FAU, (1-3; 0-3 away), 27, 34, 0, 61, Georgia, (3-1; 3-0 home), 35, 39, 0, 74
400596029, 2014-11-23, St Francis (BKN), (0-3; 0-2 away), 32, 41, 0, 73, Rutgers, (2-1; 2-1 home), 45, 31, 0, 76
400608314, 2014-11-23, Samford, (2-3; 0-2 away), 39, 25, 0, 64, UMKC, (2-3; 1-0 home), 28, 27, 0, 55
400608311, 2014-11-23, Navy, (1-4; 0-2 away), 32, 38, 0, 70, Binghamton, (1-4; 1-0 home), 31, 37, 0, 68
400585905, 2014-11-23, Montana State, (0-4; 0-4 away), 11, 17, 0, 28, Kentucky, (5-0; 4-0 home), 39, 47, 0, 86
400586141, 2014-11-23, Iona, (3-1; 2-1 away), 32, 46, 0, 78, North Texas, (3-1; 3-1 home), 32, 26, 0, 58
400586686, 2014-11-23, USC Upstate, (3-1; 1-1 away), 37, 32, 0, 69, UCF, (3-0; 3-0 home), 35, 41, 0, 76
400591103, 2014-11-23, UMass Lowell, (3-2; 3-2 away), 25, 39, 0, 64, Fordham, (1-3; 1-1 home), 24, 33, 0, 57
400608203, 2014-11-23, Gardner-Webb, (2-2; 1-1 away), 29, 38, 0, 67, Seton Hall, (3-0; 1-0 home), 39, 46, 0, 85
400608190, 2014-11-23, Akron, (3-1; 0-0 away), 30, 38, 0, 68, South Carolina, (2-3; 1-1 home), 25, 38, 0, 63
400608189, 2014-11-23, UConn, (3-1; 0-0 away), 32, 36, 0, 68, West Virginia, (5-0; 2-0 home), 47, 31, 0, 78
400595381, 2014-11-23, Sacred Heart, (1-2; 0-1 away), 27, 21, 0, 48, OSU, (3-0; 3-0 home), 52, 54, 0, 106
400590737, 2014-11-23, Delaware, (0-3; 0-3 away), 28, 24, 0, 52, CSU Bakersfield, (1-4; 1-0 home), 34, 36, 0, 70
400596324, 2014-11-23, Tennessee St, (2-2; 0-1 away), 20, 26, 0, 46, Vanderbilt, (3-0; 3-0 home), 38, 40, 0, 78
400598557, 2014-11-23, Non D-I School, NA, 17, 34, 0, 51, Howard, (2-3; 2-0 home), 46, 32, 0, 78
400585906, 2014-11-23, N Arizona, (1-3; 0-3 away), 32, 42, 0, 74, Ole Miss, (3-1; 2-1 home), 37, 43, 0, 80
400587230, 2014-11-23, Washington, (3-0; 1-0 away), 36, 40, 0, 76, Pacific, (2-2; 1-0 home), 29, 40, 0, 69
400587231, 2014-11-23, Non D-I School, NA, 20, 40, 0, 60, Loyola Mary, (2-2; 2-1 home), 34, 48, 0, 82
400589090, 2014-11-23, Mercer, (2-2; 0-2 away), 30, 32, 0, 62, Colorado State, (3-0; 3-0 home), 40, 35, 0, 75
400608312, 2014-11-23, Northeastern, (4-0; 1-0 away), 44, 21, 0, 65, Manhattan, (1-3; 0-0 home), 24, 27, 0, 51
400595911, 2014-11-23, UC Irvine, (2-2; 0-2 away), 35, 34, 0, 69, Saint Mary's, (4-0; 4-0 home), 35, 37, 0, 72
400608191, 2014-11-23, Miami (FL), (5-0; 1-0 away), 38, 39, 0, 77, Charlotte, (3-1; 0-0 home), 31, 27, 0, 58
400608206, 2014-11-23, Old Dominion, (3-1; 0-0 away), 24, 21, 0, 45, Illinois State, (2-1; 0-1 home), 33, 31, 0, 64
400593200, 2014-11-23, LBSU, (2-3; 0-3 away), 31, 32, 0, 63, UCLA, (4-0; 4-0 home), 42, 35, 0, 77
400585907, 2014-11-23, Montana, (1-2; 1-2 away), 32, 34, 0, 66, Seattle, (1-3; 1-3 home), 33, 29, 0, 62
400597768, 2014-11-24, ECU, (2-2; 0-0 away), 23, 26, 0, 49, Green Bay, (2-1; 1-0 home), 36, 30, 0, 66
400608310, 2014-11-24, Nevada, (2-3; 0-0 away), 26, 30, 0, 56, Weber State, (2-3; 1-0 home), 27, 32, 0, 59
400585696, 2014-11-24, Purdue, (3-1; 0-0 away), 24, 55, 0, 79, Kansas State, (3-1; 2-0 home), 39, 49, 0, 88
400591569, 2014-11-24, Evansville, (3-0; 1-0 away), 29, 29, 0, 58, Fresno State, (1-3; 1-0 home), 25, 27, 0, 52
400591062, 2014-11-24, Non D-I School, NA, 34, 39, 0, 73, Alcorn State, (1-4; 1-0 home), 55, 40, 0, 95
400608309, 2014-11-24, Clemson, (3-2; 0-0 away), 30, 34, 0, 64, LSU, (3-2; 2-0 home), 31, 30, 0, 61
400590738, 2014-11-24, Georgia State, (2-2; 0-2 away), 36, 33, 0, 69, Chicago State, (2-3; 2-0 home), 13, 33, 0, 46
400597750, 2014-11-24, MD-E Shore, (1-5; 1-4 away), 29, 26, 0, 55, Detroit, (3-2; 2-0 home), 27, 42, 0, 69
400593201, 2014-11-24, Missouri, (2-2; 0-0 away), 25, 28, 0, 53, Arizona, (4-0; 3-0 home), 32, 40, 0, 72
400586320, 2014-11-24, Austin Peay, (1-4; 0-4 away), 25, 32, 0, 57, Indiana State, (3-1; 2-1 home), 25, 36, 0, 61
400588656, 2014-11-24, Marist, (0-3; 0-1 away), 21, 22, 0, 43, FGCU, (4-0; 3-0 home), 21, 37, 0, 58
400600667, 2014-11-24, Milwaukee, (2-3; 0-2 away), 24, 32, 0, 56, LA-Lafayette, (1-3; 1-0 home), 14, 38, 0, 52
400608417, 2014-11-24, Gardner-Webb, (2-3; 1-1 away), 26, 20, 0, 46, Old Dominion, (4-1; 2-0 home), 28, 30, 0, 58
400587790, 2014-11-24, Savannah State, (2-3; 0-3 away), 7, 19, 0, 26, Louisville, (4-0; 3-0 home), 41, 46, 0, 87
400588341, 2014-11-24, Villanova, (4-0; 0-0 away), 32, 45, 0, 77, VCU, (3-1; 2-0 home), 30, 23, 0, 53
400595383, 2014-11-24, Santa Clara, (2-2; 0-2 away), 14, 38, 0, 52, Michigan State, (3-1; 2-0 home), 40, 39, 0, 79
400586886, 2014-11-24, Jacksonville, (1-4; 0-3 away), 29, 42, 0, 71, IPFW, (3-1; 2-0 home), 49, 40, 0, 89
400587055, 2014-11-24, Bucknell, (1-4; 0-3 away), 17, 48, 0, 65, Toledo, (2-2; 2-0 home), 44, 48, 0, 92
400587056, 2014-11-24, Colgate, (1-3; 1-3 away), 34, 37, 0, 71, JMU, (3-1; 3-1 home), 39, 38, 0, 77
400587409, 2014-11-24, Grambling St, (1-3; 0-3 away), 22, 24, 0, 46, Ball State, (2-2; 2-0 home), 41, 47, 0, 88
400587788, 2014-11-24, Nicholls State, (0-3; 0-3 away), 20, 28, 0, 48, Wake Forest, (3-2; 2-1 home), 47, 28, 0, 75
400588340, 2014-11-24, Murray State, (2-2; 1-1 away), 32, 30, 0, 62, Xavier, (4-0; 4-0 home), 52, 37, 0, 89
400589092, 2014-11-24, East Tenn St, (3-1; 1-1 away), 32, 37, 0, 69, Winthrop, (2-2; 1-1 home), 28, 36, 0, 64
400589093, 2014-11-24, W Carolina, (2-2; 1-2 away), 42, 22, 24, 88, Oakland, (0-4; 0-2 home), 30, 34, 15, 79
400591364, 2014-11-24, FIU, (3-1; 1-1 away), 30, 42, 0, 72, Ga Southern, (3-1; 3-0 home), 34, 44, 0, 78
400593202, 2014-11-24, Arizona State, (3-1; 0-0 away), 39, 34, 0, 73, Maryland, (4-0; 3-0 home), 37, 41, 0, 78
400595202, 2014-11-24, Hampton, (1-4; 0-4 away), 36, 38, 0, 74, Appalachian St, (2-2; 1-0 home), 43, 39, 0, 82
400601547, 2014-11-24, SE Louisiana, (0-4; 0-4 away), 29, 33, 0, 62, Tenn Tech, (3-1; 3-0 home), 32, 49, 0, 81
400585909, 2014-11-24, E Washington, (4-1; 1-1 away), 35, 53, 0, 88, Indiana, (4-1; 4-1 home), 41, 45, 0, 86
400585697, 2014-11-24, Rider, (2-2; 1-2 away), 22, 38, 0, 60, Kansas, (2-1; 2-0 home), 51, 36, 0, 87
400585700, 2014-11-24, SF Austin, (1-3; 0-2 away), 22, 29, 0, 51, Baylor, (4-0; 3-0 home), 33, 34, 0, 67
400585705, 2014-11-24, Miss Valley St, (0-4; 0-4 away), 20, 33, 0, 53, TCU, (4-0; 4-0 home), 60, 46, 0, 106
400586688, 2014-11-24, PV A&M, (0-5; 0-5 away), 23, 26, 0, 49, Memphis, (1-1; 1-0 home), 38, 39, 0, 77
400587233, 2014-11-24, Pepperdine, (3-1; 1-1 away), 30, 31, 0, 61, Iowa, (3-2; 3-0 home), 35, 37, 0, 72
400588654, 2014-11-24, Lipscomb, (2-3; 0-2 away), 27, 50, 0, 77, Belmont, (4-1; 2-0 home), 41, 41, 0, 82
400591215, 2014-11-24, Brown, (1-4; 0-3 away), 35, 33, 0, 68, Illinois, (4-0; 4-0 home), 31, 58, 0, 89
400595576, 2014-11-24, Non D-I School, NA, 34, 49, 0, 83, Incarnate Word, (4-0; 3-0 home), 51, 54, 0, 105
400597297, 2014-11-24, Clayton,  , 18, 28, 0, 46, Miss St, (4-0; 4-0 home), 29, 30, 0, 59
400585698, 2014-11-24, Oregon State, (3-1; 0-0 away), 24, 29, 0, 53, Oklahoma State, (5-0; 4-0 home), 30, 36, 0, 66
400595912, 2014-11-24, Hawaii, (4-2; 0-0 away), 30, 43, 0, 73, San Francisco, (3-0; 2-0 home), 34, 54, 0, 88
400587789, 2014-11-24, Pitt, (3-1; 1-1 away), 42, 39, 0, 81, Non D-I School, NA, 31, 37, 0, 68
400588342, 2014-11-24, NJIT, (1-4; 0-3 away), 30, 27, 0, 57, Marquette, (2-2; 2-1 home), 28, 34, 0, 62
400588655, 2014-11-24, Stetson, (2-3; 0-2 away), 35, 33, 0, 68, New Mexico St, (2-3; 2-0 home), 51, 37, 0, 88
400591570, 2014-11-24, Florida A&M, (0-5; 0-5 away), 15, 30, 0, 45, Wyoming, (4-0; 4-0 home), 34, 32, 0, 66
400608418, 2014-11-24, Seton Hall, (4-0; 0-0 away), 41, 43, 0, 84, Illinois State, (2-2; 0-1 home), 27, 53, 0, 80
400585699, 2014-11-24, Alabama, (3-1; 0-0 away), 37, 37, 0, 74, Iowa State, (3-0; 2-0 home), 43, 41, 0, 84
400585910, 2014-11-24, Non D-I School, NA, 32, 26, 0, 58, N Colorado, (2-2; 2-0 home), 38, 55, 0, 93
400586888, 2014-11-24, Chadron State,  , 12, 30, 0, 42, South Dakota St, (2-2; 2-0 home), 36, 51, 0, 87
400593203, 2014-11-24, Michigan, (4-0; 0-0 away), 33, 37, 0, 70, Oregon, (3-1; 3-0 home), 27, 36, 0, 63
400587234, 2014-11-24, W Michigan, (3-1; 1-1 away), 31, 39, 0, 70, San Diego, (3-1; 2-0 home), 38, 39, 0, 77
400585908, 2014-11-24, SIU-ED, (1-3; 0-2 away), 46, 36, 5, 87, Portland State, (3-0; 2-0 home), 51, 31, 8, 90
400586689, 2014-11-24, Tulsa, (3-1; 0-1 away), 28, 25, 0, 53, Auburn, (2-2; 2-0 home), 21, 14, 0, 35
400587232, 2014-11-24, BYU, (3-1; 0-0 away), 33, 34, 20, 87, San Diego State, (4-0; 3-0 home), 41, 26, 25, 92
400608450, 2014-11-25, Fresno State, (1-4; 0-2 away), 22, 30, 0, 52, ECU, (3-2; 2-1 home), 31, 27, 0, 58
400597885, 2014-11-25, Morgan State, (0-5; 0-3 away), 37, 36, 0, 73, Elon, (2-2; 1-1 home), 28, 46, 0, 74
400608448, 2014-11-25, Purdue, (4-1; 0-0 away), 45, 37, 0, 82, Missouri, (2-3; 2-1 home), 20, 41, 0, 61
400608476, 2014-11-25, Hawaii, (5-2; 0-0 away), 35, 27, 0, 62, Marist, (0-4; 0-1 home), 22, 33, 0, 55
400588657, 2014-11-25, Liberty, (2-3; 0-2 away), 35, 22, 0, 57, North Florida, (2-3; 1-0 home), 42, 35, 0, 77
400589095, 2014-11-25, W Carolina, (2-3; 1-2 away), 35, 35, 0, 70, Georgia State, (3-2; 1-0 home), 39, 46, 0, 85
400608452, 2014-11-25, MD-E Shore, (1-6; 1-4 away), 17, 38, 0, 55, Bucknell, (2-4; 1-1 home), 32, 26, 0, 58
400608516, 2014-11-25, BYU, (4-1; 0-0 away), 66, 55, 0, 121, Non D-I School, NA, 43, 42, 0, 85
400608451, 2014-11-25, Evansville, (3-1; 1-0 away), 23, 39, 0, 62, Green Bay, (3-1; 1-0 home), 26, 38, 0, 64
400595205, 2014-11-25, UT-Arlington, (3-2; 2-1 away), 12, 32, 0, 44, Kentucky, (6-0; 5-0 home), 55, 37, 0, 92
400587793, 2014-11-25, Tennessee St, (2-3; 0-2 away), 17, 19, 0, 36, UVA, (5-0; 4-0 home), 42, 37, 0, 79
400586142, 2014-11-25, Hartford, (4-1; 2-0 away), 24, 30, 0, 54, Quinnipiac, (2-2; 1-2 home), 18, 32, 0, 50
400586143, 2014-11-25, St Peter's, (1-4; 0-1 MAAC), 31, 37, 0, 68, Rutgers, (2-2; 2-2 home), 19, 31, 0, 50
400586323, 2014-11-25, Northern Iowa, (5-0; 1-0 away), 40, 33, 0, 73, VT, (2-2; 2-1 home), 31, 23, 0, 54
400586690, 2014-11-25, Houston, (2-1; 1-1 away), 34, 29, 0, 63, Harvard, (3-1; 3-0 home), 43, 41, 0, 84
400586691, 2014-11-25, Hofstra, (3-2; 0-2 away), 36, 34, 0, 70, USF, (4-1; 3-0 home), 30, 41, 0, 71
400586693, 2014-11-25, NC Central, (1-3; 0-3 away), 25, 25, 0, 50, Cincinnati, (4-0; 4-0 home), 31, 28, 0, 59
400586694, 2014-11-25, Penn, (0-4; 0-1 away), 37, 30, 0, 67, Temple, (3-2; 3-0 home), 44, 32, 0, 76
400586891, 2014-11-25, W Illinois, (1-3; 0-2 away), 15, 34, 0, 49, William & Mary, (4-1; 3-0 home), 48, 35, 0, 83
400587057, 2014-11-25, Boston U, (1-3; 1-2 away), 30, 38, 0, 68, UNH, (2-2; 2-0 home), 34, 41, 0, 75
400587059, 2014-11-25, Loyola (MD), (2-3; 0-3 away), 16, 21, 0, 37, Syracuse, (4-1; 3-0 home), 28, 42, 0, 70
400587412, 2014-11-25, SE Missouri St, (2-3; 1-2 away), 23, 31, 0, 54, Bowling Green, (3-0; 2-0 home), 26, 36, 0, 62
400587413, 2014-11-25, AR-Pine Bluff, (1-5; 0-3 away), 28, 32, 0, 60, Ohio, (2-1; 2-0 home), 30, 39, 0, 69
400587791, 2014-11-25, The Citadel, (2-3; 0-1 away), 19, 36, 0, 55, FSU, (2-3; 2-1 home), 22, 44, 0, 66
400589094, 2014-11-25, Non D-I School, NA, 32, 22, 0, 54, Wofford, (5-1; 2-0 home), 43, 39, 0, 82
400589270, 2014-11-25, Non D-I School, NA, 32, 39, 0, 71, High Point, (4-1; 1-0 home), 49, 39, 0, 88
400589271, 2014-11-25, Non D-I School, NA, 15, 25, 0, 40, Presbyterian, (2-4; 2-0 home), 38, 25, 0, 63
400590739, 2014-11-25, Chicago State, (2-4; 0-3 away), 28, 29, 0, 57, Oakland, (1-4; 1-2 home), 37, 33, 0, 70
400591037, 2014-11-25, Jackson State, (1-4; 1-4 away), 34, 37, 0, 71, St Bonaventure, (3-1; 3-1 home), 41, 38, 0, 79
400591105, 2014-11-25, LIU Brooklyn, (0-2; 0-2 away), 29, 38, 3, 70, Saint Joe's, (3-2; 2-1 home), 35, 32, 7, 74
400591106, 2014-11-25, St Francis (BKN), (0-4; 0-3 away), 23, 37, 0, 60, La Salle, (4-0; 3-0 home), 34, 39, 0, 73
400591240, 2014-11-25, Fair Dickinson, (2-2; 1-2 away), 25, 22, 0, 47, Columbia, (3-1; 2-0 home), 29, 28, 0, 57
400591366, 2014-11-25, W Kentucky, (1-3; 0-2 away), 29, 32, 0, 61, Stony Brook, (3-2; 3-0 home), 39, 32, 0, 71
400596325, 2014-11-25, UT Martin, (3-1; 2-1 away), 38, 36, 0, 74, Bethune-Cookman, (2-4; 1-1 home), 27, 29, 0, 56
400596534, 2014-11-25, Non D-I School, NA, 24, 33, 0, 57, UMass Lowell, (4-2; 1-0 home), 49, 53, 0, 102
400608453, 2014-11-25, Detroit, (4-2; 1-2 away), 36, 46, 0, 82, Toledo, (2-3; 2-1 home), 37, 42, 0, 79
400608479, 2014-11-25, Alabama, (4-1; 0-0 away), 27, 49, 0, 76, Arizona State, (3-2; 3-0 home), 30, 41, 0, 71
400608449, 2014-11-25, Kansas State, (3-2; 0-1 away), 30, 38, 0, 68, Arizona, (5-0; 3-0 home), 31, 41, 0, 72
400608481, 2014-11-25, VCU, (4-1; 0-0 away), 35, 42, 0, 77, Oregon, (3-2; 3-0 home), 27, 36, 0, 63
400586692, 2014-11-25, Arkansas, (4-0; 1-0 away), 33, 45, 0, 78, SMU, (2-3; 2-1 home), 22, 50, 0, 72
400587058, 2014-11-25, Binghamton, (1-5; 0-3 away), 23, 31, 0, 54, Army, (5-0; 3-0 home), 38, 42, 0, 80
400587411, 2014-11-25, Akron, (3-2; 0-1 away), 45, 27, 0, 72, Penn State, (5-1; 3-0 home), 32, 46, 0, 78
400589272, 2014-11-25, Cent Arkansas, (0-5; 0-4 away), 24, 43, 0, 67, Charleston So, (3-1; 2-1 home), 41, 39, 0, 80
400597721, 2014-11-25, Howard, (3-3; 1-3 away), 31, 37, 0, 68, UMBC, (0-4; 0-1 home), 26, 28, 0, 54
400585703, 2014-11-25, St Francis (PA), (2-3; 0-3 away), 23, 23, 0, 46, Texas, (5-0; 3-0 home), 36, 42, 0, 78
400588343, 2014-11-25, E Illinois, (1-4; 0-3 away), 20, 33, 0, 53, Creighton, (5-0; 5-0 home), 39, 36, 0, 75
400585702, 2014-11-25, Northwestern St, (2-3; 1-3 away), 28, 36, 0, 64, Texas Tech, (3-1; 3-0 home), 37, 38, 0, 75
400585913, 2014-11-25, N Arizona, (1-4; 0-4 away), 26, 27, 0, 53, Mid Tennessee, (3-1; 3-1 home), 26, 39, 0, 65
400586321, 2014-11-25, Texas A&M-CC, (2-2; 1-2 away), 15, 23, 0, 38, Bradley, (2-2; 2-2 home), 22, 30, 0, 52
400586322, 2014-11-25, Loyola (CHI), (3-1; 1-1 away), 27, 44, 0, 71, UTSA, (2-2; 2-2 home), 33, 24, 0, 57
400586889, 2014-11-25, Omaha, (2-2; 1-2 away), 34, 33, 0, 67, Nebraska, (3-1; 3-0 home), 42, 38, 0, 80
400586890, 2014-11-25, Minn Crookston,  , 34, 29, 0, 63, North Dakota St, (3-2; 3-0 home), 39, 25, 0, 64
400591011, 2014-11-25, Southern, (1-4; 0-3 away), 26, 33, 0, 59, Tulane, (3-1; 3-1 home), 37, 37, 0, 74
400591104, 2014-11-25, NC A&T, (1-4; 0-3 away), 21, 33, 0, 54, Saint Louis, (3-1; 2-1 home), 20, 37, 0, 57
400591365, 2014-11-25, Troy, (1-3; 0-2 away), 42, 28, 0, 70, Southern Miss, (3-1; 3-0 home), 35, 37, 0, 72
400595578, 2014-11-25, Non D-I School, NA, 27, 38, 0, 65, Abil Christian, (2-2; 2-1 home), 37, 54, 0, 91
400596326, 2014-11-25, Jacksonville St, (2-3; 1-3 away), 33, 34, 0, 67, Alabama A&M, (1-3; 1-1 home), 27, 34, 0, 61
400597782, 2014-11-25, Non D-I School, NA, 34, 42, 0, 76, UIC, (2-4; 2-0 home), 48, 39, 0, 87
400598558, 2014-11-25, Norfolk State, (2-3; 0-2 away), 23, 30, 0, 53, Vanderbilt, (4-0; 4-0 home), 38, 25, 0, 63
400598559, 2014-11-25, Non D-I School, NA, 33, 22, 0, 55, S Carolina St, (1-3; 1-0 home), 61, 31, 0, 92
400586324, 2014-11-25, IUPUI, (2-3; 1-2 away), 25, 35, 0, 60, Drake, (1-3; 1-1 home), 34, 39, 0, 73
400595203, 2014-11-25, Lamar, (2-3; 1-3 away), 35, 28, 0, 63, Arkansas State, (0-2; 0-2 home), 35, 23, 0, 58
400608477, 2014-11-25, San Francisco, (3-1; 0-0 away), 18, 29, 0, 47, FGCU, (5-0; 3-0 home), 26, 36, 0, 62
400587792, 2014-11-25, Miami (FL), (6-0; 2-0 away), 38, 39, 0, 77, Charlotte, (3-2; 0-1 home), 37, 37, 0, 74
400585911, 2014-11-25, Boise State, (4-1; 1-1 away), 38, 48, 0, 86, Idaho, (2-2; 2-0 home), 28, 47, 0, 75
400587410, 2014-11-25, Buffalo, (3-1; 2-1 away), 45, 35, 0, 80, Grand Canyon, (2-3; 2-2 home), 32, 32, 0, 64
400591571, 2014-11-25, Air Force, (3-2; 0-2 away), 15, 38, 0, 53, Colorado, (3-1; 3-0 home), 37, 31, 0, 68
400595204, 2014-11-25, LA-Lafayette, (2-3; 0-2 away), 36, 40, 0, 76, Oral Roberts, (1-3; 1-0 home), 25, 27, 0, 52
400608478, 2014-11-25, Maryland, (5-0; 0-0 away), 37, 35, 0, 72, Iowa State, (3-1; 2-0 home), 34, 29, 0, 63
400587414, 2014-11-25, Northwestern, (5-0; 1-0 away), 31, 24, 0, 55, Miami (OH), (2-2; 2-1 home), 25, 21, 0, 46
400608480, 2014-11-25, Villanova, (5-0; 0-0 away), 27, 33, 0, 60, Michigan, (4-1; 3-0 home), 20, 35, 0, 55
400585912, 2014-11-25, Non D-I School, NA, 27, 36, 0, 63, Sacramento St, (3-1; 2-0 home), 42, 55, 0, 97
400608515, 2014-11-25, Pitt, (3-2; 1-1 away), 25, 32, 0, 57, San Diego State, (5-0; 3-0 home), 39, 35, 0, 74
400593204, 2014-11-25, Delaware, (0-4; 0-4 away), 21, 26, 0, 47, Stanford, (4-1; 3-0 home), 44, 40, 0, 84
400593205, 2014-11-25, CS Fullerton, (1-3; 0-3 away), 19, 30, 0, 49, USC, (3-3; 2-1 home), 24, 29, 0, 53
400587794, 2014-11-26, UNC, (3-1; 0-0 away), 35, 31, 0, 66, Butler, (4-0; 3-0 home), 32, 42, 0, 74
400587415, 2014-11-26, Non D-I School, NA, 15, 20, 0, 35, E Michigan, (6-0; 6-0 home), 42, 26, 0, 68
400589096, 2014-11-26, Robert Morris, (1-4; 1-3 away), 25, 21, 0, 46, Chattanooga, (2-3; 2-0 home), 32, 29, 0, 61
400608583, 2014-11-26, Marist, (1-4; 0-1 away), 33, 35, 0, 68, Fresno State, (1-5; 1-0 home), 22, 42, 0, 64
400608585, 2014-11-26, Liberty, (2-4; 0-2 away), 23, 27, 0, 50, Morgan State, (1-5; 0-1 home), 25, 26, 0, 51
400586892, 2014-11-26, Denver, (2-2; 0-2 away), 16, 41, 0, 57, Belmont, (5-1; 3-0 home), 34, 44, 0, 78
400587060, 2014-11-26, American U, (4-2; 1-2 away), 37, 27, 0, 64, Hampton, (1-5; 0-1 home), 34, 26, 0, 60
400588660, 2014-11-26, Samford, (2-4; 0-3 away), 30, 41, 0, 71, Kennesaw St, (2-4; 1-0 home), 35, 49, 0, 84
400591107, 2014-11-26, Northeastern, (4-1; 1-1 away), 24, 30, 0, 54, UMass, (5-1; 3-0 home), 36, 43, 0, 79
400596018, 2014-11-26, Sacred Heart, (1-3; 0-2 away), 27, 45, 0, 72, JMU, (4-1; 4-1 home), 41, 38, 0, 79
400589275, 2014-11-26, UL Monroe, (2-2; 1-1 away), 23, 25, 0, 48, Coast Carolina, (4-1; 3-0 home), 33, 28, 0, 61
400608581, 2014-11-26, Missouri, (3-3; 0-0 away), 38, 36, 0, 74, Non D-I School, NA, 28, 32, 0, 60
400608584, 2014-11-26, Hawaii, (6-2; 0-0 away), 38, 37, 0, 75, ECU, (3-3; 2-1 home), 29, 44, 0, 73
400585704, 2014-11-26, Oklahoma, (3-1; 0-1 away), 32, 43, 0, 75, UCLA, (4-1; 4-0 home), 27, 38, 0, 65
400605507, 2014-11-26, Oral Roberts, (2-3; 0-2 away), 33, 36, 0, 69, Milwaukee, (2-4; 1-1 home), 25, 41, 0, 66
400608586, 2014-11-26, North Florida, (3-3; 0-3 away), 33, 39, 0, 72, Elon, (2-3; 1-1 home), 30, 35, 0, 65
400589097, 2014-11-26, Chicago State, (2-5; 0-3 away), 22, 39, 0, 61, W Carolina, (3-3; 1-0 home), 34, 32, 0, 66
400587795, 2014-11-26, Furman, (1-3; 0-1 away), 22, 32, 0, 54, Duke, (6-0; 3-0 home), 50, 43, 0, 93
400608582, 2014-11-26, Purdue, (5-1; 0-0 away), 40, 41, 6, 87, BYU, (4-2; 3-0 home), 35, 46, 4, 85
400608587, 2014-11-26, San Francisco, (3-2; 0-0 away), 34, 38, 0, 72, Evansville, (4-1; 1-0 home), 39, 40, 0, 79
400591368, 2014-11-26, UAB, (2-3; 0-0 away), 17, 26, 0, 43, Wisconsin, (5-0; 4-0 home), 37, 35, 0, 72
400587798, 2014-11-26, Cleveland State, (2-3; 0-3 away), 22, 11, 0, 33, Louisville, (5-0; 4-0 home), 26, 19, 0, 45
400589276, 2014-11-26, Campbell, (1-3; 0-2 away), 22, 42, 0, 64, OSU, (4-0; 4-0 home), 45, 46, 0, 91
400586144, 2014-11-26, Delaware State, (2-3; 1-3 away), 34, 42, 0, 76, Iona, (4-1; 2-0 home), 56, 70, 0, 126
400586696, 2014-11-26, Davidson, (3-1; 1-0 away), 45, 50, 0, 95, UCF, (3-1; 3-1 home), 38, 31, 0, 69
400587061, 2014-11-26, Albany, (2-2; 1-1 away), 29, 46, 0, 75, Colgate, (1-4; 0-1 home), 29, 42, 0, 71
400587062, 2014-11-26, Lafayette, (3-2; 2-2 away), 28, 32, 0, 60, Yale, (5-1; 2-0 home), 51, 31, 0, 82
400587796, 2014-11-26, Grambling St, (1-4; 0-4 away), 30, 24, 0, 54, Notre Dame, (5-1; 4-0 home), 44, 37, 0, 81
400587797, 2014-11-26, Mt St Mary's, (1-3; 1-2 away), 20, 29, 0, 49, Wake Forest, (4-2; 3-1 home), 44, 39, 0, 83
400587799, 2014-11-26, Richmond, (2-2; 0-2 away), 44, 28, 0, 72, NC State, (5-0; 5-0 home), 45, 39, 0, 84
400588344, 2014-11-26, St John's, (4-0; 0-0 away), 31, 39, 0, 70, Minnesota, (3-2; 3-0 home), 40, 21, 0, 61
400588658, 2014-11-26, Non D-I School, NA, 30, 27, 0, 57, Jacksonville, (2-4; 2-1 home), 39, 30, 0, 69
400589273, 2014-11-26, Longwood, (2-4; 0-3 away), 25, 41, 0, 66, G Washington, (3-1; 2-0 home), 36, 55, 0, 91
400590742, 2014-11-26, UMKC, (2-4; 1-3 away), 29, 34, 0, 63, Youngstown St, (4-3; 2-1 home), 36, 30, 0, 66
400591713, 2014-11-26, Bryant, (1-2; 0-2 away), 14, 33, 0, 47, UVM, (3-2; 2-0 home), 34, 39, 0, 73
400595206, 2014-11-26, Georgia State, (4-2; 1-2 away), 47, 36, 0, 83, Oakland, (1-5; 1-3 home), 38, 40, 0, 78
400597938, 2014-11-26, Non D-I School, NA, 25, 18, 0, 43, Towson, (5-1; 1-0 home), 45, 52, 0, 97
400600753, 2014-11-26, Non D-I School, NA, 16, 26, 0, 42, Navy, (2-4; 1-1 home), 21, 46, 0, 67
400608589, 2014-11-26, Miami (OH), (2-3; 0-0 away), 17, 46, 0, 63, VT, (3-2; 2-1 home), 39, 39, 0, 78
400585706, 2014-11-26, VMI, (2-3; 0-1 away), 35, 37, 0, 72, West Virginia, (6-0; 2-0 home), 53, 50, 0, 103
400586145, 2014-11-26, Canisius, (2-2; 1-2 away), 32, 28, 0, 60, Cornell, (3-4; 2-0 home), 32, 35, 0, 67
400585701, 2014-11-26, Radford, (2-3; 0-3 away), 20, 30, 0, 50, TCU, (5-0; 5-0 home), 31, 43, 0, 74
400586695, 2014-11-26, Texas Southern, (0-5; 0-5 away), 25, 34, 0, 59, SMU, (3-3; 3-1 home), 32, 40, 0, 72
400586893, 2014-11-26, Non D-I School, NA, 40, 29, 0, 69, South Dakota, (1-5; 1-0 home), 47, 39, 0, 86
400587064, 2014-11-26, Lehigh, (1-4; 1-1 away), 41, 45, 0, 86, DePaul, (2-1; 2-1 home), 30, 44, 0, 74
400587237, 2014-11-26, UC Riverside, (2-3; 0-2 away), 31, 31, 0, 62, Loyola Mary, (3-2; 3-1 home), 30, 36, 0, 66
400589274, 2014-11-26, UNC Asheville, (2-3; 1-3 away), 29, 46, 0, 75, South Carolina, (3-3; 2-1 home), 37, 52, 0, 89
400590740, 2014-11-26, UT Pan American, (3-1; 1-1 away), 26, 22, 0, 48, Utah, (3-1; 3-0 home), 50, 35, 0, 85
400591367, 2014-11-26, Morehead State, (3-4; 1-3 away), 50, 27, 0, 77, Marshall, (3-2; 3-1 home), 37, 31, 0, 68
400595579, 2014-11-26, Tenn Tech, (3-2; 0-2 away), 48, 17, 0, 65, SE Louisiana, (1-4; 1-0 home), 34, 52, 0, 86
400600069, 2014-11-26, Miss Valley St, (0-5; 0-5 away), 27, 25, 0, 52, North Texas, (4-1; 4-1 home), 41, 26, 0, 67
400608747, 2014-11-26, Kansas State, (3-3; 0-1 away), 27, 20, 0, 47, Pitt, (4-2; 2-0 home), 30, 40, 0, 70
400587416, 2014-11-26, N Illinois, (2-1; 0-1 away), 20, 29, 0, 49, Iowa, (4-2; 4-0 home), 34, 36, 0, 70
400608588, 2014-11-26, FGCU, (5-1; 0-0 away), 20, 25, 0, 45, Green Bay, (4-1; 1-0 home), 26, 33, 0, 59
400585916, 2014-11-26, E Kentucky, (4-0; 1-0 away), 31, 42, 0, 73, Southern Utah, (0-4; 0-2 home), 34, 30, 0, 64
400585919, 2014-11-26, Non D-I School, NA, 23, 29, 0, 52, Montana, (2-2; 1-0 home), 36, 39, 0, 75
400588659, 2014-11-26, Stetson, (2-4; 0-3 away), 16, 25, 0, 41, Wyoming, (5-0; 5-0 home), 33, 32, 0, 65
400590741, 2014-11-26, Florida A&M, (0-6; 0-6 away), 15, 18, 0, 33, New Mexico St, (3-3; 3-0 home), 40, 38, 0, 78
400608514, 2014-11-26, Auburn, (3-2; 0-1 away), 41, 30, 0, 71, Oregon State, (3-2; 3-0 home), 35, 34, 0, 69
400585917, 2014-11-26, N Kentucky, (2-3; 0-3 away), 20, 40, 0, 60, E Washington, (5-1; 4-0 home), 37, 44, 0, 81
400585918, 2014-11-26, Utah Valley, (3-1; 2-1 away), 28, 32, 0, 60, Idaho State, (0-4; 0-1 home), 25, 32, 0, 57
400588345, 2014-11-26, Georgetown, (4-0; 0-0 away), 31, 22, 13, 66, Florida, (2-2; 2-1 home), 27, 26, 12, 65
400608590, 2014-11-26, Northwestern, (5-1; 1-0 away), 20, 22, 0, 42, Northern Iowa, (6-0; 3-0 home), 31, 30, 0, 61
400587235, 2014-11-26, Georgia, (3-2; 0-1 away), 33, 43, 0, 76, Gonzaga, (5-0; 4-0 home), 46, 42, 0, 88
400591572, 2014-11-26, Utah State, (3-2; 1-2 away), 29, 35, 6, 70, UC Davis, (4-0; 2-0 home), 27, 37, 13, 77
400593206, 2014-11-26, Cal Poly, (2-2; 0-2 away), 24, 28, 0, 52, Cal, (4-1; 3-0 home), 31, 41, 0, 72
400608748, 2014-11-26, Arizona, (6-0; 0-0 away), 32, 29, 0, 61, San Diego State, (5-1; 3-0 home), 31, 28, 0, 59
400585914, 2014-11-26, Alabama State, (1-2; 0-1 away), 21, 47, 0, 68, North Dakota, (2-2; 1-0 home), 42, 33, 0, 75
400585915, 2014-11-26, Portland State, (4-0; 2-0 away), 33, 30, 0, 63, CS Northridge, (2-4; 1-1 home), 22, 33, 0, 55
400587236, 2014-11-26, Pacific, (3-2; 2-1 away), 28, 43, 0, 71, Non D-I School, NA, 27, 35, 0, 62
400608513, 2014-11-26, Tulsa, (3-2; 0-1 away), 30, 28, 0, 58, Oklahoma State, (6-0; 4-0 home), 45, 28, 0, 73
400586326, 2014-11-26, Missouri State, (2-2; 0-1 away), 19, 42, 0, 61, Colorado State, (4-0; 3-0 home), 29, 47, 0, 76
400587238, 2014-11-27, Santa Clara, (2-3; 0-2 away), 30, 27, 0, 57, Tennessee, (2-1; 1-0 home), 27, 37, 0, 64
400608877, 2014-11-27, Robert Morris, (2-4; 1-3 away), 37, 34, 0, 71, UL Monroe, (2-3; 1-0 home), 26, 28, 0, 54
400608757, 2014-11-27, Butler, (4-1; 0-0 away), 24, 22, 0, 46, Oklahoma, (4-1; 2-0 home), 36, 23, 0, 59
400591216, 2014-11-27, Brown, (1-5; 0-3 away), 38, 20, 0, 58, Austin Peay, (2-4; 1-0 home), 33, 46, 0, 79
400591313, 2014-11-27, Princeton, (1-4; 0-2 away), 20, 36, 0, 56, UTEP, (3-0; 2-0 home), 23, 39, 0, 62
400608876, 2014-11-27, Coast Carolina, (4-2; 0-2 away), 40, 27, 0, 67, Chattanooga, (3-3; 3-0 home), 35, 43, 0, 78
400585707, 2014-11-27, Kansas, (3-1; 0-0 away), 43, 33, 0, 76, URI, (3-1; 3-0 home), 25, 35, 0, 60
400608870, 2014-11-27, Georgetown, (4-1; 0-0 away), 34, 31, 0, 65, Wisconsin, (6-0; 4-0 home), 35, 33, 0, 68
400588661, 2014-11-27, FIU, (3-2; 1-2 away), 26, 27, 0, 53, USC Upstate, (4-1; 3-0 home), 32, 36, 0, 68
400591772, 2014-11-27, LIU Brooklyn, (0-3; 0-2 away), 31, 23, 0, 54, Stony Brook, (4-2; 3-0 home), 36, 37, 0, 73
400587239, 2014-11-27, San Diego, (3-2; 0-0 away), 31, 40, 0, 71, Xavier, (5-0; 4-0 home), 39, 43, 0, 82
400586325, 2014-11-27, Indiana State, (3-2; 1-0 away), 20, 42, 0, 62, Illinois, (5-0; 4-0 home), 41, 47, 0, 88
400595913, 2014-11-27, CS Fullerton, (2-3; 0-3 away), 28, 39, 0, 67, Wright State, (3-2; 2-0 home), 33, 29, 0, 62
400591369, 2014-11-27, W Kentucky, (2-3; 0-2 away), 31, 31, 0, 62, Saint Joe's, (3-3; 2-1 home), 24, 35, 0, 59
400586146, 2014-11-27, Michigan State, (4-1; 1-0 away), 32, 45, 0, 77, Rider, (2-3; 1-0 home), 11, 34, 0, 45
400608758, 2014-11-27, UNC, (4-1; 0-0 away), 43, 35, 0, 78, UCLA, (4-2; 4-0 home), 29, 27, 0, 56
400595914, 2014-11-27, LBSU, (3-3; 0-3 away), 31, 42, 0, 73, W Michigan, (3-2; 2-0 home), 30, 25, 0, 55
400587800, 2014-11-27, Marquette, (3-2; 0-1 away), 29, 43, 0, 72, Georgia Tech, (3-1; 3-0 home), 31, 39, 0, 70
400595580, 2014-11-27, PV A&M, (0-6; 0-5 away), 28, 33, 0, 61, SF Austin, (2-3; 1-1 home), 33, 40, 0, 73
400608871, 2014-11-27, Florida, (3-2; 0-0 away), 27, 29, 0, 56, UAB, (2-4; 2-2 home), 22, 25, 0, 47
400589098, 2014-11-27, Rice, (1-3; 0-1 away), 28, 33, 10, 71, Mercer, (3-2; 2-0 home), 33, 28, 16, 77
400591573, 2014-11-27, San Jose State, (1-4; 0-1 away), 23, 33, 0, 56, Washington, (4-0; 1-0 home), 40, 38, 0, 78
400585708, 2014-11-27, Memphis, (1-2; 0-0 away), 32, 15, 0, 47, Baylor, (5-0; 3-0 home), 29, 42, 0, 71
400593207, 2014-11-27, Washington St, (1-3; 0-2 away), 12, 31, 0, 43, UCSB, (2-2; 1-0 home), 34, 37, 0, 71
400608901, 2014-11-28, Tennessee, (2-2; 0-0 away), 33, 34, 0, 67, Kansas, (4-1; 2-0 home), 40, 42, 0, 82
400596328, 2014-11-28, E Illinois, (1-5; 0-3 away), 20, 20, 0, 40, NC Central, (2-3; 1-0 home), 40, 25, 0, 65
400595581, 2014-11-28, New Orleans, (1-2; 0-2 away), 28, 37, 0, 65, Texas A&M, (4-1; 2-0 home), 40, 47, 0, 87
400589277, 2014-11-28, Radford, (3-3; 0-3 away), 34, 31, 0, 65, NC A&T, (1-5; 1-1 home), 34, 23, 0, 57
400608897, 2014-11-28, Butler, (5-1; 0-0 away), 31, 33, 0, 64, Georgetown, (4-2; 3-0 home), 27, 31, 0, 58
400585922, 2014-11-28, Southern, (1-5; 0-3 away), 28, 31, 4, 63, N Arizona, (2-4; 1-0 home), 30, 29, 11, 70
400608902, 2014-11-28, Santa Clara, (2-4; 0-2 away), 27, 17, 0, 44, URI, (4-1; 3-0 home), 35, 31, 0, 66
400608909, 2014-11-28, PV A&M, (0-7; 0-5 away), 37, 34, 0, 71, Brown, (2-5; 1-1 home), 38, 43, 0, 81
400586894, 2014-11-28, IPFW, (3-2; 1-2 away), 31, 36, 0, 67, Dartmouth, (1-2; 1-0 home), 28, 40, 0, 68
400591370, 2014-11-28, Wright State, (3-3; 1-1 away), 22, 30, 7, 59, FIU, (4-2; 2-0 home), 31, 21, 9, 61
400608899, 2014-11-28, UTEP, (4-0; 0-0 away), 33, 44, 0, 77, Xavier, (5-1; 4-0 home), 38, 35, 0, 73
400597912, 2014-11-28, JMU, (4-2; 0-1 away), 27, 29, 0, 56, OSU, (5-0; 5-0 home), 37, 36, 0, 73
400587066, 2014-11-28, Penn State, (6-1; 1-0 away), 39, 49, 0, 88, Bucknell, (2-5; 1-2 home), 33, 47, 0, 80
400588346, 2014-11-28, Yale, (5-2; 1-2 away), 27, 39, 0, 66, Providence, (6-0; 4-0 home), 34, 38, 0, 72
400595582, 2014-11-28, Miss Valley St, (0-6; 0-6 away), 32, 34, 0, 66, Texas A&M-CC, (3-2; 2-0 home), 37, 38, 0, 75
400595584, 2014-11-28, Lamar, (2-4; 1-4 away), 27, 32, 0, 59, Texas Southern, (1-5; 1-0 home), 33, 38, 0, 71
400608874, 2014-11-28, Missouri State, (3-2; 1-1 away), 25, 30, 0, 55, Non D-I School, NA, 22, 29, 0, 51
400608898, 2014-11-28, Oklahoma, (4-2; 0-1 away), 33, 23, 0, 56, Wisconsin, (7-0; 4-0 home), 34, 35, 0, 69
400608872, 2014-11-28, Minnesota, (4-2; 0-0 away), 37, 29, 0, 66, Georgia, (3-3; 3-0 home), 25, 37, 0, 62
400596030, 2014-11-28, Norfolk State, (3-3; 0-2 away), 24, 37, 11, 72, St Francis (BKN), (0-5; 0-1 home), 33, 28, 9, 70
400608910, 2014-11-28, SF Austin, (3-3; 0-2 away), 44, 39, 0, 83, Austin Peay, (2-5; 1-0 home), 28, 34, 0, 62
400586327, 2014-11-28, Valparaiso, (5-1; 0-1 away), 29, 37, 0, 66, Drake, (1-4; 1-1 home), 21, 25, 0, 46
400586697, 2014-11-28, Mid Tennessee, (3-2; 0-0 away), 17, 34, 0, 51, Cincinnati, (5-0; 4-0 home), 39, 30, 0, 69
400587803, 2014-11-28, Charleston So, (3-2; 1-1 away), 17, 30, 0, 47, FSU, (3-3; 3-1 home), 29, 29, 0, 58
400608900, 2014-11-28, Princeton, (1-5; 0-2 away), 28, 37, 0, 65, San Diego, (4-2; 2-0 home), 40, 35, 0, 75
400588662, 2014-11-28, CS Fullerton, (2-4; 0-4 away), 36, 28, 0, 64, USC Upstate, (5-1; 4-0 home), 33, 46, 0, 79
400608986, 2014-11-28, Rice, (1-4; 0-1 away), 33, 41, 0, 74, Washington St, (2-3; 1-0 home), 39, 37, 0, 76
400608905, 2014-11-28, Rider, (2-4; 1-2 away), 30, 24, 0, 54, Georgia Tech, (4-1; 3-0 home), 30, 31, 0, 61
400608873, 2014-11-28, St John's, (4-1; 0-0 away), 28, 38, 0, 66, Gonzaga, (6-0; 4-0 home), 33, 40, 0, 73
400587804, 2014-11-28, South Alabama, (1-3; 0-3 away), 21, 54, 0, 75, Miami (FL), (7-0; 2-0 home), 43, 44, 0, 87
400586147, 2014-11-28, Monmouth, (2-3; 0-2 away), 22, 34, 0, 56, Maryland, (6-0; 4-0 home), 32, 29, 0, 61
400587065, 2014-11-28, Holy Cross, (3-1; 0-1 away), 17, 31, 0, 48, Syracuse, (5-1; 4-0 home), 39, 33, 0, 72
400587801, 2014-11-28, High Point, (4-2; 1-2 away), 16, 43, 0, 59, Clemson, (4-2; 2-1 home), 26, 36, 0, 62
400587805, 2014-11-28, Boise State, (4-2; 1-2 away), 23, 31, 0, 54, NC State, (6-0; 6-0 home), 33, 27, 0, 60
400587806, 2014-11-28, Delaware State, (3-3; 2-3 away), 36, 36, 0, 72, Wake Forest, (4-3; 3-2 home), 38, 27, 0, 65
400595388, 2014-11-28, Vanderbilt, (4-1; 0-0 away), 31, 34, 0, 65, Rutgers, (3-2; 2-2 home), 31, 37, 0, 68
400596327, 2014-11-28, Savannah State, (2-4; 0-4 away), 31, 40, 0, 71, Jacksonville St, (3-3; 2-0 home), 31, 43, 0, 74
400596486, 2014-11-28, Non D-I School, NA, 26, 24, 0, 50, Hartford, (5-1; 3-0 home), 32, 51, 0, 83
400598789, 2014-11-28, Alabama State, (2-2; 0-1 away), 55, 36, 0, 91, UT Pan American, (3-2; 2-0 home), 38, 41, 0, 79
400600630, 2014-11-28, Bradley, (2-3; 0-0 away), 24, 25, 0, 49, TCU, (6-0; 5-0 home), 31, 26, 0, 57
400586148, 2014-11-28, Tennessee St, (2-4; 0-3 away), 33, 25, 0, 58, St Peter's, (2-4; 0-1 MAAC), 42, 24, 0, 66
400608907, 2014-11-28, UNC, (5-1; 0-0 away), 39, 36, 0, 75, Florida, (3-3; 2-1 home), 23, 41, 0, 64
400589100, 2014-11-28, Samford, (2-5; 0-4 away), 27, 37, 0, 64, LA Tech, (5-1; 4-0 home), 34, 43, 0, 77
400591038, 2014-11-28, Hofstra, (4-2; 1-2 away), 37, 49, 0, 86, Jackson State, (1-5; 0-1 home), 25, 31, 0, 56
400591371, 2014-11-28, Cleveland State, (3-3; 1-3 away), 33, 35, 0, 68, Marshall, (3-3; 3-2 home), 22, 37, 0, 59
400595389, 2014-11-28, UT Martin, (3-2; 2-2 away), 27, 37, 0, 64, Nebraska, (4-1; 4-0 home), 40, 35, 0, 75
400595583, 2014-11-28, SE Louisiana, (1-5; 0-5 away), 37, 24, 0, 61, Tulane, (4-1; 4-1 home), 43, 28, 0, 71
400608983, 2014-11-28, Memphis, (2-2; 0-0 away), 40, 32, 0, 72, Indiana State, (3-3; 2-1 home), 22, 40, 0, 62
400588347, 2014-11-28, Ole Miss, (4-1; 1-0 away), 31, 44, 0, 75, Creighton, (5-1; 5-0 home), 37, 31, 0, 68
400587240, 2014-11-28, Portland, (4-0; 1-0 away), 30, 34, 0, 64, Murray State, (2-3; 1-1 home), 29, 32, 0, 61
400608906, 2014-11-28, Michigan State, (5-1; 1-0 away), 35, 44, 0, 79, Marquette, (3-3; 2-1 home), 34, 34, 0, 68
400591372, 2014-11-28, North Texas, (4-2; 0-1 away), 36, 37, 0, 73, Arkansas, (5-0; 4-0 home), 38, 51, 0, 89
400585923, 2014-11-28, Stetson, (2-5; 0-4 away), 30, 32, 0, 62, N Colorado, (3-2; 3-0 home), 47, 35, 0, 82
400589099, 2014-11-28, UNC Greensboro, (1-5; 0-2 away), 34, 45, 0, 79, Indiana, (5-1; 5-1 home), 50, 37, 0, 87
400608982, 2014-11-28, W Michigan, (4-2; 1-1 away), 36, 43, 0, 79, San Jose State, (1-5; 1-2 home), 21, 39, 0, 60
400585921, 2014-11-28, UT-Arlington, (3-3; 2-2 away), 36, 45, 0, 81, Montana State, (1-4; 1-0 home), 55, 49, 0, 104
400587802, 2014-11-28, La Salle, (4-1; 1-0 away), 19, 37, 0, 56, UVA, (6-0; 4-0 home), 37, 27, 0, 64
400591109, 2014-11-28, Miss St, (5-0; 0-0 away), 37, 38, 0, 75, Saint Louis, (3-2; 2-1 home), 27, 23, 0, 50
400608875, 2014-11-28, Pacific, (3-3; 2-1 away), 26, 38, 0, 64, Colorado State, (5-0; 3-0 home), 43, 32, 0, 75
400585920, 2014-11-28, North Dakota, (2-3; 0-3 away), 26, 27, 0, 53, Utah, (4-1; 4-0 home), 37, 53, 0, 90
400608908, 2014-11-28, UCLA, (5-2; 0-0 away), 49, 39, 0, 88, UAB, (2-5; 2-2 home), 33, 43, 0, 76
400608984, 2014-11-28, Baylor, (5-1; 1-0 away), 25, 29, 0, 54, Illinois, (6-0; 4-0 home), 21, 41, 0, 62
400608981, 2014-11-28, LBSU, (3-4; 0-3 away), 39, 31, 0, 70, Washington, (5-0; 1-0 home), 38, 42, 0, 80
400608985, 2014-11-28, Mercer, (3-3; 0-2 away), 20, 33, 7, 60, UCSB, (3-2; 1-0 home), 25, 28, 12, 65
400609059, 2014-11-29, Miss Valley St, (1-6; 0-6 away), 38, 28, 0, 66, NC A&T, (1-6; 1-1 home), 29, 34, 0, 63
400588665, 2014-11-29, Chattanooga, (3-4; 0-4 away), 26, 43, 0, 69, Kennesaw St, (3-4; 2-0 home), 26, 51, 0, 77
400609018, 2014-11-29, E Illinois, (2-5; 0-3 away), 32, 22, 0, 54, Southern, (1-6; 1-1 home), 14, 29, 0, 43
400586895, 2014-11-29, Georgia State, (5-2; 2-2 away), 27, 39, 0, 66, IUPUI, (2-4; 1-2 home), 26, 37, 0, 63
400587067, 2014-11-29, St Francis (PA), (3-3; 1-3 away), 46, 39, 0, 85, Navy, (2-5; 1-2 home), 28, 40, 0, 68
400587807, 2014-11-29, Chicago State, (2-6; 0-4 away), 22, 20, 0, 42, Notre Dame, (6-1; 5-0 home), 44, 46, 0, 90
400589101, 2014-11-29, Non D-I School, NA, 10, 35, 0, 45, The Citadel, (3-3; 3-0 home), 43, 41, 0, 84
400597722, 2014-11-29, Towson, (6-1; 3-1 away), 33, 44, 0, 77, UMBC, (0-5; 0-2 home), 36, 30, 0, 66
400591110, 2014-11-29, VCU, (4-2; 0-1 away), 18, 49, 0, 67, Old Dominion, (5-1; 3-0 home), 32, 41, 0, 73
400586152, 2014-11-29, St Bonaventure, (4-1; 0-0 away), 35, 39, 0, 74, Niagara, (1-3; 1-0 MAAC), 25, 34, 0, 59
400586699, 2014-11-29, Jacksonville, (2-5; 0-4 away), 37, 28, 0, 65, USF, (5-1; 4-0 home), 36, 43, 0, 79
400586896, 2014-11-29, Nevada, (2-4; 0-1 away), 32, 22, 0, 54, Omaha, (3-2; 2-0 home), 31, 47, 0, 78
400589278, 2014-11-29, Non D-I School, NA, 31, 32, 0, 63, Gardner-Webb, (3-3; 1-0 home), 42, 36, 0, 78
400591111, 2014-11-29, UIC, (2-5; 0-3 away), 16, 25, 0, 41, Dayton, (4-1; 2-0 home), 27, 48, 0, 75
400591112, 2014-11-29, NJIT, (2-4; 1-3 away), 41, 43, 0, 84, Duquesne, (2-1; 1-1 home), 44, 37, 0, 81
400591113, 2014-11-29, UNC-Wilmington, (2-2; 2-2 away), 24, 25, 0, 49, Davidson, (4-1; 3-0 home), 41, 31, 0, 72
400591114, 2014-11-29, UMass, (5-2; 0-1 away), 38, 35, 0, 73, Harvard, (4-1; 4-0 home), 32, 43, 0, 75
400591259, 2014-11-29, Cornell, (4-4; 2-1 away), 35, 33, 0, 68, Binghamton, (1-6; 1-1 home), 27, 27, 0, 54
400596331, 2014-11-29, KY Christian,  , 19, 30, 0, 49, Morehead State, (4-4; 2-0 home), 50, 71, 0, 121
400597689, 2014-11-29, Non D-I School, NA, 16, 33, 0, 49, Stony Brook, (5-2; 4-0 home), 37, 33, 0, 70
400609060, 2014-11-29, Texas A&M-CC, (3-3; 1-2 away), 17, 29, 0, 46, Radford, (4-3; 2-0 home), 32, 25, 0, 57
400589279, 2014-11-29, Longwood, (2-5; 0-4 away), 22, 22, 0, 44, Iowa, (5-2; 5-0 home), 37, 40, 0, 77
400595207, 2014-11-29, S Carolina St, (1-4; 0-4 away), 35, 23, 0, 58, Ga Southern, (4-1; 4-0 home), 31, 40, 0, 71
400609019, 2014-11-29, NC Central, (3-3; 0-3 away), 19, 21, 0, 40, N Arizona, (2-5; 1-0 home), 19, 17, 0, 36
400586331, 2014-11-29, Tulsa, (3-3; 0-2 away), 22, 33, 0, 55, Wichita State, (4-0; 3-0 home), 40, 35, 0, 75
400586150, 2014-11-29, Fairfield, (2-4; 0-2 away), 16, 32, 0, 48, Northeastern, (5-1; 1-0 home), 33, 24, 0, 57
400586328, 2014-11-29, Youngstown St, (4-4; 0-3 away), 24, 41, 8, 73, Illinois State, (3-2; 1-1 home), 32, 33, 20, 85
400587417, 2014-11-29, Toledo, (2-4; 0-3 away), 36, 43, 0, 79, Oakland, (2-5; 2-3 home), 37, 44, 0, 81
400591373, 2014-11-29, FIU, (4-3; 1-2 away), 27, 34, 0, 61, CS Fullerton, (3-4; 1-0 home), 36, 28, 0, 64
400595587, 2014-11-29, Nicholls State, (0-4; 0-4 away), 20, 42, 0, 62, Michigan, (5-1; 4-0 home), 53, 38, 0, 91
400586149, 2014-11-29, Manhattan, (1-4; 0-3 away), 28, 35, 0, 63, George Mason, (2-4; 2-1 home), 28, 36, 0, 64
400587068, 2014-11-29, American U, (4-3; 1-3 away), 21, 22, 0, 43, Columbia, (4-1; 3-0 home), 24, 28, 0, 52
400588348, 2014-11-29, G Washington, (3-2; 1-2 away), 23, 31, 0, 54, Seton Hall, (5-0; 2-0 home), 25, 33, 0, 58
400591115, 2014-11-29, MD-E Shore, (2-6; 2-4 away), 32, 40, 0, 72, Fordham, (1-4; 1-2 home), 26, 40, 0, 66
400591304, 2014-11-29, Penn, (0-5; 0-2 away), 31, 30, 0, 61, Wagner, (2-3; 2-0 home), 26, 38, 0, 64
400595208, 2014-11-29, Cent Arkansas, (0-6; 0-5 away), 37, 34, 0, 71, AR-Little Rock, (4-1; 4-0 home), 47, 38, 0, 85
400595586, 2014-11-29, Missouri Valley,  , 32, 44, 0, 76, Northwestern St, (3-3; 2-0 home), 51, 36, 0, 87
400595589, 2014-11-29, Abil Christian, (2-3; 0-2 away), 22, 34, 0, 56, UC Riverside, (3-3; 3-1 home), 41, 35, 0, 76
400597797, 2014-11-29, Concordia-St. P,  , 26, 33, 0, 59, Milwaukee, (3-4; 2-1 home), 24, 40, 0, 64
400598560, 2014-11-29, Non D-I School, NA, 30, 39, 14, 83, Howard, (4-3; 3-0 home), 31, 38, 27, 96
400609016, 2014-11-29, Rice, (1-5; 0-2 away), 32, 22, 0, 54, Non D-I School, NA, 35, 30, 0, 65
400586330, 2014-11-29, Non D-I School, NA, 28, 32, 0, 60, S Illinois, (3-3; 1-0 home), 40, 36, 0, 76
400589102, 2014-11-29, Wofford, (5-2; 1-2 away), 28, 34, 0, 62, William & Mary, (5-1; 4-0 home), 38, 28, 0, 66
400589280, 2014-11-29, Non D-I School, NA, 19, 20, 0, 39, Presbyterian, (3-4; 3-0 home), 45, 43, 0, 88
400609061, 2014-11-29, Saint Louis, (4-2; 1-0 away), 27, 33, 0, 60, Bradley, (2-4; 2-2 home), 34, 23, 0, 57
400586153, 2014-11-29, Buffalo, (4-1; 3-1 away), 34, 38, 0, 72, Canisius, (2-3; 1-1 home), 19, 38, 0, 57
400588664, 2014-11-29, Florida A&M, (0-7; 0-7 away), 24, 26, 0, 50, Stetson, (3-5; 3-1 home), 32, 30, 0, 62
400609020, 2014-11-29, Tennessee St, (2-5; 0-3 away), 22, 35, 0, 57, St Francis (BKN), (1-5; 0-1 home), 24, 35, 0, 59
400609028, 2014-11-29, Mid Tennessee, (3-3; 0-0 away), 15, 32, 0, 47, Creighton, (6-1; 5-0 home), 36, 21, 0, 57
400585924, 2014-11-29, UT Pan American, (4-2; 1-1 away), 29, 49, 0, 78, North Dakota, (2-4; 1-0 home), 31, 29, 0, 60
400586332, 2014-11-29, Drake, (1-5; 0-2 away), 22, 37, 0, 59, Portland, (5-0; 2-0 home), 38, 33, 0, 71
400587419, 2014-11-29, Grand Canyon, (2-4; 0-2 away), 37, 40, 0, 77, Cent Michigan, (5-0; 5-0 home), 41, 38, 0, 79
400588663, 2014-11-29, Wright State, (4-3; 2-1 away), 26, 30, 0, 56, USC Upstate, (5-2; 4-1 home), 28, 23, 0, 51
400590745, 2014-11-29, New Mexico St, (3-4; 0-4 away), 33, 42, 0, 75, Wyoming, (6-0; 6-0 home), 37, 41, 0, 78
400591575, 2014-11-29, Albany, (2-3; 1-2 away), 25, 34, 0, 59, UNLV, (4-1; 3-0 home), 37, 38, 0, 75
400609017, 2014-11-29, Missouri State, (3-3; 1-1 away), 45, 29, 10, 84, Washington St, (3-3; 1-0 home), 33, 41, 15, 89
400586151, 2014-11-29, Siena, (2-2; 2-1 away), 30, 51, 0, 81, Loyola (MD), (2-4; 2-1 home), 35, 36, 0, 71
400586329, 2014-11-29, Loyola (CHI), (4-1; 2-1 away), 40, 29, 0, 69, Kent State, (4-2; 3-2 home), 22, 39, 0, 61
400587418, 2014-11-29, Belmont, (6-1; 3-1 away), 44, 39, 0, 83, Ohio, (2-2; 2-1 home), 41, 40, 0, 81
400595588, 2014-11-29, Southwest,  , 20, 31, 0, 51, Sam Houston, (4-2; 2-0 home), 55, 56, 0, 111
400596329, 2014-11-29, Alabama A&M, (1-4; 0-3 away), 20, 31, 0, 51, SE Missouri St, (3-3; 2-0 home), 39, 46, 0, 85
400609057, 2014-11-29, La Salle, (4-2; 1-0 away), 20, 35, 0, 55, Vanderbilt, (5-1; 4-0 home), 30, 38, 0, 68
400609062, 2014-11-29, Miss St, (5-1; 0-0 away), 21, 31, 0, 52, TCU, (7-0; 5-0 home), 30, 31, 0, 61
400585710, 2014-11-29, Charleston, (2-4; 1-1 away), 29, 28, 0, 57, West Virginia, (7-0; 3-0 home), 38, 48, 0, 86
400609021, 2014-11-29, Norfolk State, (4-3; 0-2 away), 20, 40, 0, 60, St Peter's, (2-5; 0-1 MAAC), 27, 31, 0, 58
400595590, 2014-11-29, McNeese State, (2-2; 0-2 away), 39, 33, 0, 72, LSU, (4-2; 3-0 home), 39, 44, 0, 83
400595591, 2014-11-29, Non D-I School, NA, 22, 22, 0, 44, Houston Baptist, (2-2; 2-0 home), 49, 39, 0, 88
400586897, 2014-11-29, Non D-I School, NA, 33, 23, 0, 56, W Illinois, (2-3; 2-1 home), 46, 45, 0, 91
400590743, 2014-11-29, Non D-I School, NA, 25, 19, 0, 44, UMKC, (3-4; 2-0 home), 51, 33, 0, 84
400596330, 2014-11-29, Murray State, (2-4; 1-1 away), 37, 21, 0, 58, Valparaiso, (6-1; 2-0 home), 43, 50, 0, 93
400587069, 2014-11-29, Colgate, (1-5; 1-4 away), 30, 41, 0, 71, Arizona State, (4-2; 4-0 home), 43, 35, 0, 78
400593208, 2014-11-29, Alabama State, (2-3; 0-2 away), 33, 29, 0, 62, Utah, (5-1; 5-0 home), 49, 44, 0, 93
400609029, 2014-11-29, Cincinnati, (5-1; 0-0 away), 25, 29, 0, 54, Ole Miss, (5-1; 2-1 home), 30, 36, 0, 66
400609074, 2014-11-29, Pacific, (4-3; 2-1 away), 26, 29, 0, 55, Mercer, (3-4; 2-0 home), 19, 29, 0, 48
400609058, 2014-11-29, UVA, (7-0; 1-0 away), 17, 28, 0, 45, Rutgers, (3-3; 2-2 home), 18, 8, 0, 26
400587241, 2014-11-29, E Kentucky, (4-1; 1-1 away), 30, 46, 0, 76, BYU, (5-2; 4-0 home), 32, 58, 0, 90
400585925, 2014-11-29, N Kentucky, (3-3; 1-3 away), 39, 40, 0, 79, Idaho, (2-3; 2-1 home), 28, 46, 0, 74
400590744, 2014-11-29, CS Northridge, (2-5; 0-4 away), 29, 29, 0, 58, Seattle, (2-3; 2-3 home), 35, 35, 0, 70
400595915, 2014-11-29, Cal Poly, (2-3; 0-3 away), 32, 24, 0, 56, Saint Mary's, (5-0; 5-0 home), 44, 38, 0, 82
400595916, 2014-11-29, Utah Valley, (3-2; 2-2 away), 19, 24, 0, 43, UC Davis, (5-0; 3-0 home), 33, 31, 0, 64
400587242, 2014-11-29, UC Irvine, (3-2; 1-2 away), 44, 36, 0, 80, Loyola Mary, (3-3; 3-2 home), 39, 33, 0, 72
400609075, 2014-11-29, Colorado State, (6-0; 0-0 away), 32, 33, 0, 65, UCSB, (3-3; 1-0 home), 33, 30, 0, 63
400609014, 2014-11-30, Santa Clara, (3-4; 0-2 away), 26, 42, 0, 68, Rider, (2-5; 1-0 home), 24, 36, 0, 60
400587070, 2014-11-30, Army, (5-1; 2-1 away), 28, 45, 0, 73, Duke, (7-0; 4-0 home), 41, 52, 0, 93
400585711, 2014-11-30, Texas, (6-0; 1-0 away), 31, 24, 0, 55, UConn, (3-2; 1-1 home), 25, 29, 0, 54
400595585, 2014-11-30, Langston,  , 40, 40, 0, 80, SE Louisiana, (2-5; 1-0 home), 50, 42, 0, 92
400609032, 2014-11-30, Kansas, (5-1; 0-0 away), 35, 26, 0, 61, Michigan State, (5-2; 2-0 home), 36, 20, 0, 56
400585928, 2014-11-30, Southern Utah, (1-4; 1-2 away), 48, 45, 0, 93, UTSA, (2-3; 2-3 home), 55, 37, 0, 92
400586156, 2014-11-30, UVM, (3-3; 1-3 away), 24, 49, 0, 73, Quinnipiac, (3-2; 2-2 home), 43, 46, 0, 89
400587072, 2014-11-30, UMass Lowell, (5-2; 4-2 away), 29, 40, 0, 69, Boston U, (1-4; 0-1 home), 22, 37, 0, 59
400587420, 2014-11-30, Elon, (3-3; 1-1 away), 30, 40, 0, 70, Miami (OH), (2-4; 2-2 home), 26, 42, 0, 68
400588349, 2014-11-30, Providence, (6-1; 0-1 away), 22, 16, 0, 38, Kentucky, (7-0; 6-0 home), 26, 32, 0, 58
400585712, 2014-11-30, Air Force, (3-3; 0-3 away), 32, 30, 0, 62, Texas Tech, (4-1; 4-0 home), 16, 47, 0, 63
400586700, 2014-11-30, Cent Conn St, (0-6; 0-3 away), 32, 27, 0, 59, ECU, (4-3; 3-1 home), 44, 30, 0, 74
400587071, 2014-11-30, Lafayette, (4-2; 3-2 away), 46, 36, 0, 82, Fair Dickinson, (2-3; 1-1 home), 37, 24, 0, 61
400587243, 2014-11-30, Valparaiso, (7-1; 0-1 away), 42, 28, 0, 70, Portland, (5-1; 2-0 home), 20, 35, 0, 55
400587422, 2014-11-30, Maine, (0-5; 0-4 away), 31, 25, 0, 56, N Illinois, (3-1; 3-0 home), 21, 40, 0, 61
400588666, 2014-11-30, Lipscomb, (2-4; 0-3 away), 35, 40, 0, 75, Colorado, (4-1; 4-0 home), 49, 35, 0, 84
400591323, 2014-11-30, Hartford, (5-2; 2-1 away), 25, 32, 0, 57, Yale, (6-2; 3-0 home), 27, 42, 0, 69
400591374, 2014-11-30, Non D-I School, NA, 13, 30, 0, 43, FAU, (2-3; 2-0 home), 20, 34, 0, 54
400609034, 2014-11-30, San Diego, (4-3; 0-0 away), 40, 26, 0, 66, W Michigan, (5-2; 2-0 home), 39, 29, 0, 68
400609157, 2014-11-30, Non D-I School, NA, 29, 45, 0, 74, Lehigh, (2-4; 1-2 home), 53, 47, 0, 100
400588350, 2014-11-30, Stanford, (4-2; 0-1 away), 30, 42, 0, 72, DePaul, (3-1; 3-1 home), 41, 46, 0, 87
400606369, 2014-11-30, Tenn Tech, (3-3; 0-3 away), 33, 35, 0, 68, Tulane, (5-1; 5-1 home), 40, 33, 0, 73
400586333, 2014-11-30, Richmond, (2-3; 0-3 away), 15, 35, 0, 50, Northern Iowa, (7-0; 4-0 home), 30, 25, 0, 55
400586899, 2014-11-30, New Orleans, (1-3; 0-3 away), 31, 29, 0, 60, Denver, (3-2; 3-0 home), 42, 37, 0, 79
400587423, 2014-11-30, Bowling Green, (4-0; 2-0 away), 36, 28, 0, 64, Detroit, (4-3; 2-1 home), 28, 35, 0, 63
400587808, 2014-11-30, Morgan State, (1-6; 0-4 away), 27, 36, 0, 63, VT, (4-2; 3-1 home), 42, 41, 0, 83
400589281, 2014-11-30, Charlotte, (4-2; 2-0 away), 28, 27, 11, 66, UNC Asheville, (2-4; 1-1 home), 31, 24, 8, 63
400591274, 2014-11-30, UNH, (3-2; 1-2 away), 25, 40, 0, 65, Dartmouth, (1-3; 1-1 home), 26, 37, 0, 63
400596332, 2014-11-30, Non D-I School, NA, 20, 29, 0, 49, Jacksonville St, (4-3; 3-0 home), 38, 43, 0, 81
400586154, 2014-11-30, Iona, (4-2; 2-2 away), 40, 37, 0, 77, Arkansas, (6-0; 5-0 home), 44, 50, 0, 94
400589282, 2014-11-30, Campbell, (1-4; 0-3 away), 29, 33, 0, 62, Sacred Heart, (2-3; 1-1 home), 37, 34, 0, 71
400585930, 2014-11-30, Florida A&M, (0-8; 0-8 away), 26, 30, 0, 56, N Colorado, (4-2; 4-0 home), 48, 47, 0, 95
400586701, 2014-11-30, LIU Brooklyn, (0-4; 0-3 away), 34, 22, 0, 56, Temple, (4-2; 4-0 home), 27, 43, 0, 70
400591217, 2014-11-30, Johnson & Wales,  , 31, 34, 0, 65, Brown, (3-5; 2-1 home), 39, 36, 0, 75
400591576, 2014-11-30, USC, (4-3; 1-0 away), 34, 32, 0, 66, New Mexico, (3-3; 2-1 home), 32, 22, 0, 54
400609033, 2014-11-30, Tennessee, (2-3; 0-0 away), 30, 29, 0, 59, Marquette, (4-3; 2-1 home), 35, 32, 0, 67
400588351, 2014-11-30, Delaware, (0-5; 0-5 away), 16, 31, 0, 47, Villanova, (6-0; 3-0 home), 34, 44, 0, 78
400586334, 2014-11-30, Drake, (1-6; 0-2 away), 36, 23, 0, 59, Murray State, (3-4; 1-1 home), 35, 33, 0, 68
400609072, 2014-11-30, Xavier, (5-2; 0-0 away), 28, 42, 0, 70, LBSU, (4-4; 2-0 home), 25, 48, 0, 73
400586900, 2014-11-30, FGCU, (6-1; 0-0 away), 31, 40, 0, 71, South Dakota St, (2-3; 2-0 home), 31, 27, 0, 58
400587421, 2014-11-30, Bryant, (1-3; 0-3 away), 29, 37, 0, 66, Akron, (4-2; 2-0 home), 32, 40, 0, 72
400591375, 2014-11-30, Southern Miss, (3-2; 0-2 away), 21, 15, 0, 36, Drexel, (2-4; 1-1 home), 35, 24, 0, 59
400595209, 2014-11-30, Non D-I School, NA, 18, 21, 0, 39, Texas State, (3-1; 2-0 home), 32, 36, 0, 68
400585929, 2014-11-30, Non D-I School, NA, 45, 42, 0, 87, E Washington, (6-1; 5-0 home), 53, 51, 0, 104
400585931, 2014-11-30, Montana, (2-3; 1-3 away), 16, 41, 0, 57, San Francisco, (4-2; 3-0 home), 34, 42, 0, 76
400586702, 2014-11-30, Bethune-Cookman, (2-5; 0-3 away), 30, 37, 0, 67, UCF, (4-1; 4-1 home), 39, 36, 0, 75
400589103, 2014-11-30, VMI, (2-4; 0-2 away), 45, 32, 0, 77, Maryland, (7-0; 5-0 home), 49, 46, 0, 95
400591577, 2014-11-30, Cal, (5-1; 1-0 away), 35, 29, 0, 64, Fresno State, (1-6; 1-1 home), 27, 30, 0, 57
400609015, 2014-11-30, URI, (4-2; 0-0 away), 18, 43, 0, 61, Georgia Tech, (5-1; 3-0 home), 29, 35, 0, 64
400586155, 2014-11-30, Monmouth, (2-4; 0-3 away), 21, 30, 0, 51, SMU, (4-3; 4-1 home), 32, 31, 0, 63
400586898, 2014-11-30, South Dakota, (2-5; 1-3 away), 29, 39, 0, 68, CSU Bakersfield, (1-5; 1-1 home), 40, 26, 0, 66
400585926, 2014-11-30, North Dakota St, (4-2; 1-2 away), 37, 35, 0, 72, Montana State, (1-5; 1-1 home), 27, 24, 0, 51
400609035, 2014-11-30, Princeton, (2-5; 0-2 away), 30, 39, 0, 69, San Jose State, (1-6; 1-2 home), 19, 35, 0, 54
400585927, 2014-11-30, Portland State, (4-1; 2-1 away), 30, 29, 0, 59, Oregon, (4-2; 4-0 home), 50, 31, 0, 81
400609073, 2014-11-30, UTEP, (4-1; 0-0 away), 26, 39, 0, 65, Washington, (6-0; 1-0 home), 33, 35, 0, 68
400586157, 2014-12-01, Marist, (1-5; 0-2 away), 36, 25, 0, 61, Boston College, (3-3; 2-0 home), 41, 38, 0, 79
400586158, 2014-12-01, Siena, (2-3; 2-2 away), 23, 44, 0, 67, Fordham, (2-4; 2-2 home), 30, 39, 0, 69
400586159, 2014-12-01, Bucknell, (3-5; 1-4 away), 18, 29, 25, 72, Fairfield, (2-5; 1-3 home), 24, 23, 19, 66
400587424, 2014-12-01, Non D-I School, NA, 18, 34, 0, 52, E Michigan, (7-0; 7-0 home), 47, 36, 0, 83
400587809, 2014-12-01, Rutgers, (4-3; 1-0 away), 33, 36, 0, 69, Clemson, (4-3; 2-2 home), 33, 31, 0, 64
400587810, 2014-12-01, Nebraska, (5-1; 1-1 away), 37, 33, 0, 70, FSU, (3-4; 3-2 home), 21, 44, 0, 65
400588668, 2014-12-01, Non D-I School, NA, 33, 32, 0, 65, North Florida, (4-3; 2-0 home), 47, 50, 0, 97
400588669, 2014-12-01, Non D-I School, NA, 23, 20, 0, 43, USC Upstate, (6-2; 5-1 home), 59, 46, 0, 105
400589104, 2014-12-01, High Point, (5-2; 2-2 away), 35, 41, 0, 76, UNC Greensboro, (1-6; 1-2 home), 27, 41, 0, 68
400589105, 2014-12-01, East Tenn St, (4-1; 2-1 away), 22, 41, 0, 63, Morehead State, (4-5; 2-1 home), 21, 38, 0, 59
400589106, 2014-12-01, Furman, (1-4; 0-2 away), 27, 25, 0, 52, Liberty, (3-4; 3-0 home), 26, 40, 0, 66
400589283, 2014-12-01, Savannah State, (2-5; 0-5 away), 23, 24, 0, 47, Winthrop, (3-2; 2-1 home), 33, 35, 0, 68
400597751, 2014-12-01, Aquinas College,  , 34, 25, 0, 59, Detroit, (5-3; 3-1 home), 60, 49, 0, 109
400589107, 2014-12-01, W Carolina, (3-4; 1-3 away), 22, 44, 0, 66, Charleston So, (4-2; 3-1 home), 45, 27, 0, 72
400591376, 2014-12-01, South Carolina, (4-3; 1-0 away), 39, 38, 0, 77, Marshall, (3-4; 3-3 home), 20, 39, 0, 59
400598562, 2014-12-01, Non D-I School, NA, 30, 20, 0, 50, Coppin State, (1-4; 1-0 home), 45, 58, 0, 103
400588667, 2014-12-01, Jacksonville, (2-6; 0-5 away), 39, 23, 8, 70, Samford, (3-5; 2-0 home), 37, 25, 14, 76
400595210, 2014-12-01, Arkansas State, (1-2; 1-0 away), 29, 38, 0, 67, Cent Arkansas, (0-7; 0-2 home), 28, 21, 0, 49
400597769, 2014-12-01, Non D-I School, NA, 29, 23, 0, 52, Green Bay, (5-1; 2-0 home), 45, 33, 0, 78
400585713, 2014-12-01, Texas Southern, (1-6; 0-6 away), 22, 27, 0, 49, Baylor, (6-1; 4-0 home), 41, 34, 0, 75
400585932, 2014-12-01, Oral Roberts, (2-4; 0-3 away), 24, 37, 0, 61, Weber State, (3-3; 2-0 home), 24, 38, 0, 62
400590746, 2014-12-01, Non D-I School, NA, 21, 12, 0, 33, Seattle, (3-3; 2-3 home), 43, 29, 0, 72
400585933, 2014-12-01, Utah Valley, (3-3; 2-3 away), 25, 31, 0, 56, Sacramento St, (4-1; 3-0 home), 39, 26, 0, 65
400586160, 2014-12-02, Niagara, (1-4; 1-0 MAAC), 24, 33, 0, 57, St John's, (5-1; 4-0 home), 35, 35, 0, 70
400586703, 2014-12-02, SF Austin, (4-3; 1-2 away), 27, 37, 0, 64, Memphis, (2-3; 1-1 home), 27, 25, 0, 52
400586705, 2014-12-02, Stony Brook, (5-3; 0-3 away), 23, 29, 0, 52, Cincinnati, (6-1; 5-0 home), 38, 40, 0, 78
400587073, 2014-12-02, Loyola (MD), (3-4; 1-3 away), 35, 29, 0, 64, Columbia, (4-2; 3-1 home), 32, 30, 0, 62
400587426, 2014-12-02, AR-Pine Bluff, (1-6; 0-4 away), 32, 28, 0, 60, Akron, (5-2; 3-0 home), 31, 50, 0, 81
400587811, 2014-12-02, Pitt, (4-3; 1-2 away), 37, 32, 0, 69, Indiana, (6-1; 6-1 home), 45, 36, 0, 81
400587812, 2014-12-02, Minnesota, (5-2; 1-0 away), 32, 52, 0, 84, Wake Forest, (4-4; 3-3 home), 31, 38, 0, 69
400588352, 2014-12-02, Mt St Mary's, (1-4; 1-3 away), 29, 26, 0, 55, Seton Hall, (6-0; 3-0 home), 45, 33, 0, 78
400589108, 2014-12-02, Georgia, (4-3; 1-1 away), 39, 47, 0, 86, Chattanooga, (3-5; 3-1 home), 32, 23, 0, 55
400589110, 2014-12-02, Non D-I School, NA, 19, 14, 0, 33, Mercer, (4-4; 3-0 home), 32, 30, 0, 62
400589111, 2014-12-02, Non D-I School, NA, 34, 28, 0, 62, VMI, (3-4; 2-1 home), 76, 57, 0, 133
400589284, 2014-12-02, Campbell, (1-5; 0-4 away), 22, 39, 0, 61, JMU, (5-2; 5-1 home), 30, 33, 0, 63
400589286, 2014-12-02, S Carolina St, (1-5; 0-5 away), 26, 26, 0, 52, Coast Carolina, (5-2; 4-0 home), 33, 33, 0, 66
400591117, 2014-12-02, UMass, (5-3; 0-2 away), 32, 28, 0, 60, LSU, (5-2; 4-0 home), 44, 38, 0, 82
400591118, 2014-12-02, Howard, (4-4; 1-4 away), 30, 33, 0, 63, Duquesne, (3-1; 2-1 home), 41, 40, 0, 81
400591811, 2014-12-02, Youngstown St, (5-4; 1-3 away), 46, 43, 0, 89, Robert Morris, (2-5; 0-2 home), 48, 33, 0, 81
400596042, 2014-12-02, Wagner, (2-4; 0-4 away), 39, 35, 7, 81, Maine, (1-5; 1-0 home), 40, 34, 8, 82
400597900, 2014-12-02, Norfolk State, (4-4; 0-3 away), 40, 34, 0, 74, Hofstra, (5-2; 4-0 home), 43, 45, 0, 88
400601527, 2014-12-02, Non D-I School, NA, 19, 19, 0, 38, NC Central, (4-3; 2-0 home), 42, 59, 0, 101
400609279, 2014-12-02, Non D-I School, NA, 31, 24, 0, 55, Elon, (4-3; 2-1 home), 52, 59, 0, 111
400587813, 2014-12-02, Syracuse, (5-2; 0-1 away), 31, 34, 0, 65, Michigan, (6-1; 5-0 home), 29, 39, 0, 68
400586706, 2014-12-02, Ga Southern, (4-2; 0-2 away), 30, 29, 0, 59, UCF, (5-1; 5-1 home), 30, 31, 0, 61
400588670, 2014-12-02, Kennesaw St, (3-5; 0-5 away), 15, 23, 0, 38, FIU, (5-3; 3-0 home), 28, 31, 0, 59
400589109, 2014-12-02, The Citadel, (3-4; 0-2 away), 33, 22, 0, 55, Charleston, (3-4; 1-1 home), 28, 31, 0, 59
400591377, 2014-12-02, LA Tech, (6-1; 2-1 away), 49, 50, 0, 99, Northwestern St, (3-4; 2-1 home), 42, 46, 0, 88
400597723, 2014-12-02, UMBC, (0-6; 0-4 away), 16, 36, 0, 52, MD-E Shore, (3-6; 1-0 home), 39, 26, 0, 65
400585716, 2014-12-02, UT-Arlington, (3-4; 2-3 away), 28, 25, 0, 53, Texas, (7-0; 4-0 home), 39, 24, 0, 63
400585714, 2014-12-02, Lamar, (2-5; 1-5 away), 22, 37, 0, 59, Iowa State, (4-1; 3-0 home), 38, 58, 0, 96
400585715, 2014-12-02, Omaha, (3-3; 1-3 away), 31, 35, 0, 66, Kansas State, (4-3; 3-0 home), 37, 47, 0, 84
400586335, 2014-12-02, Cent Michigan, (5-1; 0-1 away), 29, 44, 0, 73, Bradley, (3-4; 3-2 home), 37, 47, 0, 84
400586337, 2014-12-02, VCU, (5-2; 1-1 away), 33, 33, 0, 66, Illinois State, (3-3; 1-2 home), 35, 27, 0, 62
400590748, 2014-12-02, Grand Canyon, (3-4; 1-2 away), 26, 40, 0, 66, UIC, (2-6; 2-1 home), 21, 40, 0, 61
400591063, 2014-12-02, Alcorn State, (1-5; 0-3 away), 21, 30, 0, 51, Troy, (2-3; 2-1 home), 39, 33, 0, 72
400591116, 2014-12-02, Non D-I School, NA, 21, 27, 0, 48, Saint Louis, (5-2; 3-1 home), 33, 47, 0, 80
400591378, 2014-12-02, Mid Tennessee, (3-4; 0-1 away), 26, 33, 0, 59, Belmont, (7-1; 4-0 home), 36, 27, 0, 63
400596333, 2014-12-02, Hampton, (2-5; 1-4 away), 24, 38, 0, 62, Tennessee St, (2-6; 2-2 home), 24, 30, 0, 54
400596334, 2014-12-02, SE Missouri St, (3-4; 1-3 away), 30, 31, 0, 61, Missouri, (4-3; 3-1 home), 24, 41, 0, 65
400586336, 2014-12-02, Wright State, (4-4; 2-2 away), 36, 42, 0, 78, Evansville, (5-1; 2-0 home), 39, 47, 0, 86
400595211, 2014-12-02, Non D-I School, NA, 24, 30, 0, 54, South Alabama, (2-3; 2-0 home), 28, 43, 0, 71
400589285, 2014-12-02, Gardner-Webb, (3-4; 1-2 away), 28, 37, 0, 65, Arizona, (7-0; 4-0 home), 40, 51, 0, 91
400595592, 2014-12-02, SE Louisiana, (2-6; 0-6 away), 33, 24, 0, 57, Gonzaga, (7-0; 5-0 home), 32, 44, 0, 76
400587814, 2014-12-02, Illinois, (6-1; 0-1 away), 24, 37, 0, 61, Miami (FL), (8-0; 3-0 home), 37, 33, 0, 70
400586704, 2014-12-02, USF, (5-2; 1-2 away), 32, 39, 0, 71, Alabama, (5-1; 4-0 home), 43, 39, 0, 82
400586902, 2014-12-02, Denver, (3-3; 0-3 away), 20, 22, 0, 42, Wyoming, (7-0; 7-0 home), 27, 41, 0, 68
400587244, 2014-12-02, BYU, (6-2; 1-0 away), 31, 60, 0, 91, Utah State, (3-3; 2-1 home), 32, 49, 0, 81
400587425, 2014-12-02, N Illinois, (3-2; 0-2 away), 29, 38, 0, 67, DePaul, (4-1; 4-1 home), 38, 40, 0, 78
400587815, 2014-12-02, NC State, (6-1; 0-1 away), 34, 27, 0, 61, Purdue, (6-1; 4-0 home), 36, 30, 0, 66
400585934, 2014-12-02, Non D-I School, NA, 38, 28, 0, 66, Idaho State, (1-4; 1-1 home), 52, 34, 0, 86
400587816, 2014-12-02, OSU, (5-1; 0-1 away), 18, 37, 0, 55, Louisville, (6-0; 5-0 home), 35, 29, 0, 64
400586901, 2014-12-02, South Dakota, (3-5; 2-3 away), 38, 30, 0, 68, CS Northridge, (2-6; 1-2 home), 34, 31, 0, 65
400590747, 2014-12-02, UC Riverside, (4-3; 1-2 away), 23, 36, 0, 59, CSU Bakersfield, (1-6; 1-2 home), 29, 29, 0, 58
400598563, 2014-12-02, Delaware State, (3-4; 2-4 away), 23, 37, 0, 60, Hawaii, (7-2; 5-1 home), 35, 40, 0, 75
400586707, 2014-12-03, Temple, (4-3; 0-1 away), 22, 34, 0, 56, Saint Joe's, (4-3; 3-1 home), 34, 24, 0, 58
400586161, 2014-12-03, Canisius, (3-3; 1-0 MAAC), 24, 36, 0, 60, St Peter's, (2-6; 0-2 MAAC), 28, 29, 0, 57
400586162, 2014-12-03, Cent Conn St, (0-7; 0-4 away), 24, 32, 0, 56, Rider, (3-5; 2-0 home), 19, 50, 0, 69
400586709, 2014-12-03, ECU, (4-4; 0-1 away), 23, 40, 0, 63, FAU, (3-3; 3-0 home), 35, 37, 0, 72
400586905, 2014-12-03, IPFW, (4-2; 2-2 away), 37, 50, 0, 87, Stetson, (3-6; 3-2 home), 23, 53, 0, 76
400587074, 2014-12-03, American U, (5-3; 2-3 away), 29, 37, 0, 66, Brown, (3-6; 2-2 home), 28, 21, 0, 49
400587075, 2014-12-03, Penn, (1-5; 1-2 away), 38, 19, 0, 57, Navy, (2-6; 1-3 home), 21, 25, 0, 46
400587076, 2014-12-03, Sacred Heart, (3-3; 1-2 away), 35, 36, 0, 71, Colgate, (1-6; 0-2 home), 37, 33, 0, 70
400587077, 2014-12-03, St Francis (PA), (3-4; 1-4 away), 28, 31, 0, 59, Lehigh, (3-4; 2-2 home), 38, 23, 0, 61
400587078, 2014-12-03, Army, (6-1; 3-1 away), 35, 38, 0, 73, Delaware, (0-6; 0-1 home), 28, 41, 0, 69
400587080, 2014-12-03, Holy Cross, (4-1; 1-1 away), 41, 33, 0, 74, Albany, (2-4; 1-2 home), 28, 29, 0, 57
400587427, 2014-12-03, Buffalo, (4-2; 3-2 away), 18, 45, 0, 63, St Bonaventure, (5-1; 4-1 home), 34, 38, 0, 72
400587428, 2014-12-03, Dayton, (5-1; 1-0 away), 31, 35, 0, 66, Miami (OH), (2-5; 2-3 home), 23, 39, 0, 62
400587430, 2014-12-03, Toledo, (3-4; 1-3 away), 28, 31, 0, 59, Cleveland State, (3-4; 2-1 home), 15, 39, 0, 54
400588673, 2014-12-03, UT Martin, (4-2; 3-2 away), 32, 39, 0, 71, N Kentucky, (3-4; 2-1 home), 22, 34, 0, 56
400589113, 2014-12-03, Presbyterian, (3-5; 0-3 away), 24, 21, 0, 45, Wofford, (6-2; 3-0 home), 32, 34, 0, 66
400589288, 2014-12-03, Dartmouth, (1-4; 0-3 away), 42, 31, 0, 73, Longwood, (3-5; 2-0 home), 31, 43, 0, 74
400591120, 2014-12-03, William & Mary, (5-2; 1-2 away), 33, 34, 0, 67, Richmond, (3-3; 3-0 home), 38, 30, 0, 68
400591121, 2014-12-03, Charlotte, (4-3; 2-1 away), 38, 48, 0, 86, Davidson, (5-1; 4-0 home), 45, 47, 0, 92
400591292, 2014-12-03, Northeastern, (5-2; 1-2 away), 22, 24, 0, 46, Harvard, (5-1; 5-0 home), 27, 33, 0, 60
400591773, 2014-12-03, UNH, (4-2; 2-2 away), 40, 32, 0, 72, LIU Brooklyn, (0-5; 0-1 home), 28, 28, 0, 56
400596335, 2014-12-03, Valparaiso, (8-1; 1-1 away), 32, 40, 0, 72, E Kentucky, (4-2; 3-1 home), 30, 36, 0, 66
400596487, 2014-12-03, Hartford, (5-3; 0-1 Am. East), 27, 42, 0, 69, UVM, (4-3; 1-0 Am. East), 36, 45, 0, 81
400596535, 2014-12-03, NJIT, (2-5; 1-4 away), 22, 45, 0, 67, UMass Lowell, (6-2; 2-0 home), 35, 36, 0, 71
400597922, 2014-12-03, Non D-I School, NA, 15, 32, 0, 47, UNC-Wilmington, (3-2; 1-0 home), 43, 62, 0, 105
400597939, 2014-12-03, Coppin State, (1-5; 0-5 away), 33, 43, 0, 76, Towson, (7-1; 2-0 home), 38, 46, 0, 84
400599967, 2014-12-03, Florida Tech,  , 30, 28, 0, 58, FGCU, (7-1; 4-0 home), 33, 44, 0, 77
400586338, 2014-12-03, Butler, (6-1; 1-0 away), 37, 40, 0, 77, Indiana State, (3-4; 2-2 home), 22, 32, 0, 54
400587817, 2014-12-03, Michigan State, (5-3; 1-1 away), 35, 32, 11, 78, Notre Dame, (7-1; 6-0 home), 37, 30, 12, 79
400587818, 2014-12-03, VT, (4-3; 0-1 away), 27, 31, 0, 58, Penn State, (7-1; 4-0 home), 30, 31, 0, 61
400588671, 2014-12-03, Lipscomb, (2-5; 0-4 away), 36, 43, 0, 79, Tenn Tech, (4-3; 4-0 home), 34, 50, 0, 84
400587819, 2014-12-03, Iowa, (6-2; 1-0 away), 31, 29, 0, 60, UNC, (5-2; 2-1 home), 29, 26, 0, 55
400591119, 2014-12-03, Old Dominion, (6-1; 1-0 away), 36, 39, 0, 75, George Mason, (2-5; 2-2 home), 32, 37, 0, 69
400591324, 2014-12-03, Yale, (7-2; 2-2 away), 33, 34, 0, 67, Bryant, (1-4; 1-1 home), 28, 32, 0, 60
400597809, 2014-12-03, Non D-I School, NA, 25, 27, 0, 52, Oakland, (3-5; 3-3 home), 34, 50, 0, 84
400587079, 2014-12-03, Binghamton, (1-7; 0-4 away), 23, 42, 0, 65, Boston U, (2-4; 1-1 home), 34, 43, 0, 77
400585717, 2014-12-03, North Texas, (4-3; 0-2 away), 30, 31, 0, 61, Oklahoma State, (7-0; 5-0 home), 42, 45, 0, 87
400586339, 2014-12-03, Tulane, (6-1; 1-0 away), 34, 49, 0, 83, Loyola (CHI), (4-2; 2-1 home), 24, 46, 0, 70
400586340, 2014-12-03, S Illinois, (4-3; 2-2 away), 45, 34, 0, 79, SIU-ED, (1-4; 1-2 home), 22, 45, 0, 67
400586708, 2014-12-03, Creighton, (6-2; 0-1 away), 25, 39, 0, 64, Tulsa, (4-3; 3-0 home), 33, 44, 0, 77
400586903, 2014-12-03, Non D-I School, NA, 27, 28, 0, 55, South Dakota St, (3-3; 3-0 home), 42, 47, 0, 89
400587429, 2014-12-03, Ball State, (2-3; 0-3 away), 24, 30, 0, 54, E Illinois, (3-5; 2-1 home), 18, 43, 0, 61
400587431, 2014-12-03, Bowling Green, (4-1; 2-1 away), 24, 28, 0, 52, W Kentucky, (3-3; 2-1 home), 26, 36, 0, 62
400588672, 2014-12-03, North Florida, (5-3; 1-3 away), 28, 35, 0, 63, Bethune-Cookman, (2-6; 1-2 home), 25, 31, 0, 56
400589112, 2014-12-03, W Carolina, (3-5; 0-1 Southern), 36, 53, 0, 89, East Tenn St, (5-1; 1-0 Southern), 52, 44, 0, 96
400589287, 2014-12-03, Winthrop, (3-3; 1-2 away), 33, 35, 8, 76, Jacksonville St, (5-3; 4-0 home), 31, 37, 11, 79
400591039, 2014-12-03, Jackson State, (1-6; 1-5 away), 27, 26, 0, 53, LA-Lafayette, (3-3; 2-0 home), 35, 41, 0, 76
400591379, 2014-12-03, Houston Baptist, (3-2; 1-2 away), 32, 26, 0, 58, Rice, (1-6; 1-2 home), 25, 30, 0, 55
400591579, 2014-12-03, UNLV, (4-2; 0-1 away), 37, 18, 0, 55, Arizona State, (5-2; 5-0 home), 37, 40, 0, 77
400595213, 2014-12-03, Non D-I School, NA, 18, 13, 0, 31, Texas State, (4-1; 3-0 home), 30, 42, 0, 72
400595593, 2014-12-03, Sam Houston, (4-3; 1-2 away), 27, 36, 0, 63, Texas A&M, (5-1; 3-0 home), 30, 36, 0, 66
400596336, 2014-12-03, Non D-I School, NA, 34, 32, 0, 66, Murray State, (4-4; 2-1 home), 50, 52, 0, 102
400597798, 2014-12-03, UMKC, (3-5; 1-4 away), 22, 34, 0, 56, Milwaukee, (4-4; 3-1 home), 28, 37, 0, 65
400588353, 2014-12-03, Villanova, (7-0; 1-0 away), 47, 37, 0, 84, La Salle, (4-3; 3-1 home), 29, 41, 0, 70
400586904, 2014-12-03, North Dakota St, (4-3; 1-3 away), 21, 44, 0, 65, Southern Miss, (4-2; 4-0 home), 39, 39, 0, 78
400598826, 2014-12-03, Non D-I School, NA, 26, 22, 0, 48, PV A&M, (1-7; 1-0 home), 36, 28, 0, 64
400585718, 2014-12-03, Auburn, (3-3; 0-2 away), 24, 20, 0, 44, Texas Tech, (5-1; 5-0 home), 23, 23, 0, 46
400590750, 2014-12-03, New Mexico St, (3-5; 0-5 away), 28, 19, 0, 47, New Mexico, (4-3; 3-1 home), 34, 28, 0, 62
400591380, 2014-12-03, UTEP, (4-2; 0-1 away), 28, 34, 0, 62, Colorado State, (7-0; 4-0 home), 33, 32, 0, 65
400591578, 2014-12-03, Grambling St, (1-5; 0-5 away), 16, 18, 0, 34, Air Force, (4-3; 3-0 home), 23, 36, 0, 59
400585935, 2014-12-03, SD School of Mines,  , 15, 26, 0, 41, Montana State, (2-5; 2-1 home), 32, 47, 0, 79
400587821, 2014-12-03, UVA, (8-0; 2-0 away), 37, 39, 0, 76, Maryland, (7-1; 5-1 home), 29, 36, 0, 65
400587820, 2014-12-03, Georgia Tech, (6-1; 1-0 away), 31, 35, 0, 66, Northwestern, (5-2; 3-1 home), 18, 40, 0, 58
400587822, 2014-12-03, Duke, (8-0; 1-0 away), 35, 45, 0, 80, Wisconsin, (7-1; 4-1 home), 32, 38, 0, 70
400585937, 2014-12-03, UTSA, (3-3; 1-0 away), 35, 37, 16, 88, N Arizona, (2-6; 1-1 home), 44, 28, 11, 83
400591314, 2014-12-03, Princeton, (2-6; 0-3 away), 33, 52, 0, 85, Fair Dickinson, (3-3; 2-1 home), 25, 64, 0, 89
400595594, 2014-12-03, Non D-I School, NA, 33, 30, 0, 63, McNeese State, (3-2; 3-0 home), 39, 35, 0, 74
400585936, 2014-12-03, Idaho, (3-3; 1-1 away), 32, 45, 0, 77, Washington St, (3-4; 1-1 home), 31, 40, 0, 71
400585938, 2014-12-03, Portland State, (4-2; 2-2 away), 24, 47, 0, 71, Portland, (6-1; 3-0 home), 41, 42, 0, 83
400585939, 2014-12-03, Montana, (2-4; 1-4 away), 29, 34, 13, 76, Cal, (6-1; 4-0 home), 35, 28, 15, 78
400587245, 2014-12-03, Non D-I School, NA, 20, 31, 0, 51, Pacific, (5-3; 2-0 home), 31, 49, 0, 80
400587246, 2014-12-03, Loyola Mary, (3-4; 0-2 away), 21, 40, 0, 61, USC, (5-3; 3-1 home), 36, 41, 0, 77
400587247, 2014-12-03, San Francisco, (4-3; 0-1 away), 34, 21, 0, 55, Colorado, (5-1; 5-0 home), 32, 40, 0, 72
400591580, 2014-12-03, UC Irvine, (3-3; 1-3 away), 27, 36, 0, 63, Fresno State, (2-6; 2-1 home), 36, 36, 0, 72
400591581, 2014-12-03, Nevada, (2-5; 0-2 away), 22, 35, 0, 57, LBSU, (5-4; 3-0 home), 31, 37, 0, 68
400591582, 2014-12-03, San Jose State, (1-7; 0-2 away), 21, 35, 0, 56, UC Davis, (6-0; 4-0 home), 31, 39, 0, 70
400593209, 2014-12-03, Concordia (OR),  , 26, 37, 0, 63, Oregon, (5-2; 5-0 home), 47, 47, 0, 94
400586341, 2014-12-03, Wichita State, (4-1; 0-1 away), 33, 27, 8, 68, Utah, (6-1; 6-0 home), 29, 31, 9, 69
400593210, 2014-12-03, CS Fullerton, (3-5; 0-5 away), 23, 22, 0, 45, UCLA, (6-2; 5-0 home), 40, 33, 0, 73
400598817, 2014-12-03, Miss Valley St, (1-7; 0-7 away), 28, 22, 0, 50, Oregon State, (4-2; 4-0 home), 40, 34, 0, 74
400585720, 2014-12-04, LSU, (6-2; 1-0 away), 38, 36, 0, 74, West Virginia, (7-1; 3-1 home), 43, 30, 0, 73
400585719, 2014-12-04, Baylor, (7-1; 2-0 away), 34, 32, 0, 66, Vanderbilt, (5-2; 4-1 home), 25, 38, 0, 63
400586163, 2014-12-04, Monmouth, (3-4; 1-0 MAAC), 26, 31, 0, 57, Marist, (1-6; 0-1 MAAC), 25, 25, 0, 50
400586906, 2014-12-04, W Illinois, (2-4; 0-3 away), 18, 31, 0, 49, Akron, (6-2; 4-0 home), 39, 34, 0, 73
400588674, 2014-12-04, NC A&T, (1-7; 0-4 away), 17, 37, 0, 54, USC Upstate, (7-2; 6-1 home), 28, 37, 0, 65
400588785, 2014-12-04, Appalachian St, (3-2; 2-2 away), 35, 32, 0, 67, Jacksonville, (2-7; 2-2 home), 25, 31, 0, 56
400591122, 2014-12-04, UMBC, (0-7; 0-5 away), 34, 26, 0, 60, G Washington, (4-2; 3-0 home), 46, 37, 0, 83
400595214, 2014-12-04, Green Bay, (5-2; 0-2 away), 18, 30, 0, 48, Georgia State, (6-2; 2-0 home), 42, 30, 0, 72
400609377, 2014-12-04, University of the Sc,  , 28, 26, 0, 54, Drexel, (2-5; 1-2 home), 22, 30, 0, 52
400589289, 2014-12-04, Non D-I School, NA, 32, 23, 0, 55, Charleston So, (5-2; 4-1 home), 55, 50, 0, 105
400585940, 2014-12-04, Sacramento St, (4-2; 1-2 away), 20, 41, 0, 61, Abil Christian, (3-3; 3-1 home), 33, 39, 0, 72
400586710, 2014-12-04, UT Pan American, (4-3; 1-2 away), 25, 33, 0, 58, Houston, (3-1; 2-0 home), 43, 29, 0, 72
400589114, 2014-12-04, VMI, (4-4; 1-0 Southern), 50, 38, 0, 88, Samford, (3-6; 0-1 Southern), 40, 26, 0, 66
400591381, 2014-12-04, Morehead State, (4-6; 1-4 away), 24, 24, 0, 48, UAB, (3-5; 3-2 home), 24, 34, 0, 58
400595595, 2014-12-04, Non D-I School, NA, 37, 31, 0, 68, Incarnate Word, (5-0; 4-0 home), 40, 45, 0, 85
400586342, 2014-12-04, AR-Little Rock, (4-2; 0-2 away), 32, 36, 0, 68, Missouri State, (4-3; 3-0 home), 27, 46, 0, 73
400588354, 2014-12-04, DePaul, (5-1; 1-0 away), 47, 37, 0, 84, Chicago State, (2-7; 2-1 home), 30, 30, 0, 60
400609379, 2014-12-04, Non D-I School, NA, 29, 33, 0, 62, Savannah State, (3-5; 3-0 home), 43, 32, 0, 75
400585721, 2014-12-04, Arkansas, (6-1; 1-1 away), 32, 45, 0, 77, Iowa State, (5-1; 4-0 home), 52, 43, 0, 95
400585722, 2014-12-04, TCU, (8-0; 1-0 away), 27, 39, 0, 66, Ole Miss, (5-2; 2-2 home), 24, 30, 0, 54
400595918, 2014-12-04, CS Northridge, (2-7; 0-5 away), 20, 36, 0, 56, Pepperdine, (4-1; 3-0 home), 31, 35, 0, 66
400595919, 2014-12-04, Seattle, (3-4; 0-1 away), 19, 27, 0, 46, UCSB, (4-3; 2-0 home), 42, 45, 0, 87
400587248, 2014-12-04, San Diego, (4-4; 0-1 away), 19, 29, 0, 48, San Diego State, (6-1; 4-0 home), 31, 26, 0, 57
400585723, 2014-12-05, Texas, (7-1; 1-1 away), 26, 25, 0, 51, Kentucky, (8-0; 7-0 home), 26, 37, 0, 63
400587824, 2014-12-05, FIU, (5-4; 1-3 away), 23, 34, 0, 57, Louisville, (7-0; 6-0 home), 36, 46, 0, 82
400586164, 2014-12-05, Manhattan, (1-5; 0-1 MAAC), 22, 32, 0, 54, Fairfield, (3-5; 1-0 MAAC), 27, 40, 0, 67
400586711, 2014-12-05, Wyoming, (7-1; 0-1 away), 24, 29, 0, 53, SMU, (5-3; 5-1 home), 26, 40, 0, 66
400586712, 2014-12-05, Yale, (8-2; 3-2 away), 24, 21, 0, 45, UConn, (3-3; 1-2 home), 19, 25, 0, 44
400587823, 2014-12-05, Providence, (6-2; 0-2 away), 34, 26, 0, 60, Boston College, (4-3; 3-0 home), 34, 35, 0, 69
400587825, 2014-12-05, Duquesne, (3-2; 1-0 away), 27, 35, 0, 62, Pitt, (5-3; 2-0 home), 39, 37, 0, 76
400589115, 2014-12-05, W Carolina, (3-6; 0-1 Southern), 38, 26, 0, 64, Minnesota, (6-2; 4-0 home), 39, 45, 0, 84
400589290, 2014-12-05, Non D-I School, NA, 35, 26, 0, 61, Gardner-Webb, (4-4; 2-0 home), 48, 52, 0, 100
400598565, 2014-12-05, NC Central, (25-7; 16-0 MEAC), 30, 38, 0, 68, MD-E Shore, (18-14; 11-5 MEAC), 27, 36, 0, 63
400601257, 2014-12-05, Quinnipiac, (3-3; 0-1 MAAC), 38, 29, 0, 67, Siena, (3-3; 1-0 MAAC), 40, 48, 0, 88
400586907, 2014-12-05, Youngstown St, (6-4; 2-3 away), 37, 50, 0, 87, South Dakota, (3-6; 1-1 home), 33, 46, 0, 79
400591012, 2014-12-05, Non D-I School, NA, 39, 16, 0, 55, Southern, (2-6; 2-1 home), 36, 32, 0, 68
400595596, 2014-12-05, LBSU, (5-5; 0-4 away), 21, 24, 0, 45, SF Austin, (5-3; 2-1 home), 29, 45, 0, 74
400589291, 2014-12-05, Coast Carolina, (6-2; 1-2 away), 23, 35, 0, 58, Auburn, (3-4; 2-1 home), 27, 27, 0, 54
400585724, 2014-12-05, Florida, (3-4; 0-1 away), 39, 26, 0, 65, Kansas, (6-1; 3-0 home), 24, 47, 0, 71
400585725, 2014-12-05, Missouri, (4-4; 0-1 away), 25, 38, 0, 63, Oklahoma, (5-2; 3-0 home), 37, 45, 0, 82
400591583, 2014-12-05, Non D-I School, NA, 26, 27, 0, 53, UNLV, (5-2; 3-0 home), 53, 60, 0, 113
400598837, 2014-12-06, NJIT, (3-5; 2-4 away), 27, 45, 0, 72, Michigan, (6-2; 5-1 home), 32, 38, 0, 70
400585726, 2014-12-06, Oklahoma State, (7-1; 0-1 away), 24, 25, 0, 49, South Carolina, (5-3; 3-1 home), 32, 43, 0, 75
400586716, 2014-12-06, La Salle, (4-4; 1-0 away), 29, 28, 0, 57, Temple, (5-3; 4-0 home), 35, 23, 0, 58
400587437, 2014-12-06, Kent State, (5-2; 2-0 away), 31, 27, 0, 58, Kennesaw St, (3-6; 2-1 home), 27, 19, 0, 46
400587827, 2014-12-06, USC Upstate, (8-2; 2-1 away), 28, 31, 0, 59, Georgia Tech, (6-2; 3-1 home), 28, 26, 0, 54
400588355, 2014-12-06, Rutgers, (4-4; 1-1 away), 25, 29, 0, 54, Seton Hall, (7-0; 4-0 home), 47, 34, 0, 81
400588356, 2014-12-06, Wisconsin, (8-1; 1-0 away), 25, 24, 0, 49, Marquette, (4-4; 2-2 home), 15, 23, 0, 38
400588357, 2014-12-06, Saint Joe's, (4-4; 1-2 away), 24, 22, 0, 46, Villanova, (8-0; 4-0 home), 44, 30, 0, 74
400587081, 2014-12-06, Navy, (2-7; 0-3 away), 24, 36, 0, 60, The Citadel, (4-4; 4-0 home), 26, 41, 0, 67
400587435, 2014-12-06, SIU-ED, (1-5; 0-3 away), 26, 35, 0, 61, Cent Michigan, (6-1; 6-0 home), 54, 40, 0, 94
400595217, 2014-12-06, Cent Arkansas, (0-8; 0-6 away), 42, 31, 0, 73, Troy, (3-3; 3-1 home), 39, 46, 0, 85
400595398, 2014-12-06, UMBC, (0-8; 0-6 away), 20, 27, 0, 47, Iowa, (7-2; 6-0 home), 48, 29, 0, 77
400587826, 2014-12-06, UVA, (9-0; 3-0 away), 38, 36, 0, 74, VCU, (5-3; 2-1 home), 28, 29, 0, 57
400587831, 2014-12-06, Green Bay, (6-2; 1-2 away), 25, 43, 0, 68, Miami (FL), (8-1; 3-1 home), 23, 32, 0, 55
400589294, 2014-12-06, Winthrop, (3-4; 1-3 away), 29, 33, 0, 62, Maryland, (8-1; 6-1 home), 34, 48, 0, 82
400587085, 2014-12-06, American U, (5-4; 1-4 away), 19, 36, 0, 55, Illinois, (7-1; 5-0 home), 32, 38, 0, 70
400586168, 2014-12-06, St Peter's, (3-6; 2-3 away), 41, 29, 0, 70, Boston U, (2-5; 0-2 home), 21, 38, 0, 59
400586344, 2014-12-06, Loyola (CHI), (5-2; 3-1 away), 31, 46, 0, 77, UIC, (2-7; 2-2 home), 23, 44, 0, 67
400586347, 2014-12-06, Indiana State, (3-5; 1-1 away), 30, 33, 0, 63, Ball State, (3-3; 3-0 home), 22, 48, 0, 70
400586715, 2014-12-06, UCF, (5-2; 0-1 away), 37, 36, 0, 73, FSU, (4-4; 4-2 home), 47, 49, 0, 96
400586909, 2014-12-06, UMKC, (3-6; 1-5 away), 25, 36, 0, 61, South Dakota St, (4-3; 4-0 home), 44, 37, 0, 81
400586910, 2014-12-06, Denver, (4-3; 1-3 away), 31, 33, 0, 64, Texas A&M-CC, (3-4; 2-1 home), 23, 25, 0, 48
400587082, 2014-12-06, Lehigh, (16-14; 10-8 Patriot), 34, 46, 0, 80, LIU Brooklyn, (12-18; 8-10 NEC), 31, 45, 0, 76
400587083, 2014-12-06, Wagner, (2-5; 0-5 away), 43, 41, 0, 84, Lafayette, (5-2; 2-0 home), 56, 41, 0, 97
400587432, 2014-12-06, Chicago State, (2-8; 0-5 away), 29, 30, 0, 59, Toledo, (4-4; 3-1 home), 44, 43, 0, 87
400587434, 2014-12-06, E Michigan, (7-1; 0-1 away), 26, 38, 0, 64, Dayton, (6-1; 3-0 home), 28, 45, 0, 73
400587436, 2014-12-06, St Bonaventure, (6-1; 1-0 away), 36, 44, 0, 80, Ohio, (2-3; 2-2 home), 37, 33, 0, 70
400588677, 2014-12-06, North Florida, (6-3; 2-3 away), 28, 45, 0, 73, Purdue, (6-2; 4-1 home), 36, 34, 0, 70
400589119, 2014-12-06, UNC Greensboro, (2-6; 1-2 away), 33, 22, 0, 55, Presbyterian, (3-6; 3-1 home), 28, 25, 0, 53
400589293, 2014-12-06, St Francis (BKN), (2-5; 1-3 away), 26, 39, 0, 65, Liberty, (3-5; 3-1 home), 23, 31, 0, 54
400591305, 2014-12-06, Penn, (2-5; 2-2 away), 40, 39, 0, 79, Binghamton, (1-8; 1-2 home), 34, 36, 0, 70
400593212, 2014-12-06, Arizona State, (5-3; 0-1 away), 45, 26, 0, 71, Texas A&M, (6-1; 4-0 home), 34, 38, 0, 72
400596338, 2014-12-06, Oakland, (4-5; 1-2 away), 36, 28, 6, 70, Morehead State, (4-7; 2-2 home), 22, 42, 4, 68
400596455, 2014-12-06, Albany, (2-5; 1-3 away), 15, 44, 0, 59, St Francis (PA), (4-4; 3-0 home), 31, 38, 0, 69
400597298, 2014-12-06, Miss St, (5-2; 0-1 away), 26, 28, 0, 54, Tulane, (7-1; 6-1 home), 28, 31, 0, 59
400598568, 2014-12-06, NC A&T, (9-23; 6-10 MEAC), 23, 24, 0, 47, Howard, (16-16; 10-6 MEAC), 28, 26, 0, 54
400591383, 2014-12-06, Mid Tennessee, (4-4; 1-1 away), 32, 29, 7, 68, South Alabama, (2-4; 2-1 home), 30, 31, 6, 67
400595396, 2014-12-06, AR-Pine Bluff, (1-7; 0-5 away), 20, 32, 0, 52, Michigan State, (6-3; 3-0 home), 54, 31, 0, 85
400589118, 2014-12-06, Non D-I School, NA, 31, 26, 0, 57, Wofford, (7-2; 4-0 home), 41, 47, 0, 88
400585942, 2014-12-06, Weber State, (3-4; 0-2 away), 21, 35, 0, 56, UT-Arlington, (4-4; 2-1 home), 28, 35, 0, 63
400586167, 2014-12-06, Canisius, (4-3; 2-0 MAAC), 34, 43, 0, 77, Niagara, (1-5; 1-1 MAAC), 34, 30, 0, 64
400586713, 2014-12-06, USF, (5-3; 1-3 away), 28, 29, 0, 57, Detroit, (6-3; 4-1 home), 33, 34, 0, 67
400591275, 2014-12-06, Maine, (1-6; 0-5 away), 29, 22, 0, 51, Dartmouth, (2-4; 2-1 home), 40, 34, 0, 74
400591385, 2014-12-06, UTSA, (3-4; 1-1 away), 26, 45, 0, 71, Washington St, (4-4; 2-1 home), 52, 39, 0, 91
400585941, 2014-12-06, North Dakota, (3-4; 1-3 away), 25, 38, 0, 63, Drake, (1-7; 1-2 home), 29, 33, 0, 62
400585727, 2014-12-06, Kansas State, (4-4; 0-2 away), 17, 47, 0, 64, Tennessee, (3-3; 2-0 home), 25, 40, 0, 65
400587087, 2014-12-06, Holy Cross, (4-2; 0-2 away), 27, 41, 0, 68, Sacred Heart, (4-3; 2-1 home), 40, 41, 0, 81
400587433, 2014-12-06, Alabama A&M, (1-5; 0-4 away), 18, 29, 0, 47, Bowling Green, (5-1; 3-0 home), 32, 32, 0, 64
400588675, 2014-12-06, Jacksonville, (2-8; 0-6 away), 21, 26, 0, 47, Bethune-Cookman, (3-6; 2-2 home), 35, 17, 0, 52
400588678, 2014-12-06, Stetson, (3-7; 0-5 away), 24, 35, 0, 59, Davidson, (6-1; 5-0 home), 48, 42, 0, 90
400589116, 2014-12-06, Samford, (3-7; 0-2 Southern), 25, 39, 0, 64, Furman, (2-4; 1-0 Southern), 28, 46, 0, 74
400589117, 2014-12-06, VMI, (4-5; 1-1 Southern), 45, 36, 0, 81, Mercer, (5-4; 1-0 Southern), 48, 42, 0, 90
400596337, 2014-12-06, Jacksonville St, (5-4; 1-4 away), 25, 30, 0, 55, Alabama State, (3-3; 2-0 home), 41, 39, 0, 80
400597929, 2014-12-06, W Michigan, (5-3; 1-2 away), 25, 44, 0, 69, Northeastern, (6-2; 2-0 home), 35, 46, 0, 81
400587086, 2014-12-06, Colgate, (1-7; 1-5 away), 21, 29, 0, 50, OSU, (6-1; 6-0 home), 31, 39, 0, 70
400588358, 2014-12-06, Northwestern, (5-3; 1-1 away), 28, 28, 0, 56, Butler, (7-1; 4-0 home), 34, 31, 0, 65
400591315, 2014-12-06, Stony Brook, (5-4; 0-4 away), 36, 28, 0, 64, Princeton, (3-6; 2-1 home), 38, 39, 0, 77
400591260, 2014-12-06, UMass Lowell, (6-3; 4-3 away), 25, 35, 0, 60, Cornell, (5-4; 3-0 home), 27, 44, 0, 71
400585944, 2014-12-06, UC Davis, (6-1; 2-1 away), 38, 33, 0, 71, Idaho, (4-3; 3-1 home), 30, 49, 0, 79
400588676, 2014-12-06, Tennessee St, (2-7; 0-4 away), 31, 37, 0, 68, Lipscomb, (3-5; 3-1 home), 36, 41, 0, 77
400589295, 2014-12-06, UT Martin, (5-2; 4-2 away), 35, 42, 0, 77, Longwood, (3-6; 2-1 home), 22, 45, 0, 67
400595216, 2014-12-06, PV A&M, (1-8; 0-6 away), 31, 34, 0, 65, Texas State, (5-1; 4-0 home), 38, 43, 0, 81
400587249, 2014-12-06, Gonzaga, (7-1; 0-1 away), 27, 33, 3, 63, Arizona, (8-0; 5-0 home), 27, 33, 6, 66
400587828, 2014-12-06, St John's, (6-1; 1-0 away), 32, 37, 0, 69, Syracuse, (5-3; 4-1 home), 28, 29, 0, 57
400590754, 2014-12-06, UT Pan American, (4-4; 1-3 away), 31, 28, 0, 59, Sam Houston, (5-3; 3-0 home), 35, 43, 0, 78
400595597, 2014-12-06, Non D-I School, NA, 23, 37, 0, 60, Nicholls State, (1-4; 1-0 home), 36, 53, 0, 89
400586346, 2014-12-06, Saint Louis, (5-3; 1-1 away), 25, 27, 0, 52, Wichita State, (5-1; 4-0 home), 45, 36, 0, 81
400587252, 2014-12-06, Hawaii, (7-3; 0-0 away), 30, 40, 0, 70, BYU, (7-2; 4-0 home), 37, 53, 0, 90
400591382, 2014-12-06, Penn State, (8-1; 2-0 away), 31, 42, 0, 73, Marshall, (3-5; 3-4 home), 24, 45, 0, 69
400598566, 2014-12-06, Florida A&M, (2-27; 2-14 MEAC), 24, 37, 0, 61, S Carolina St, (11-22; 7-9 MEAC), 40, 30, 0, 70
400598569, 2014-12-06, Coppin State, (8-23; 6-10 MEAC), 29, 23, 0, 52, Hampton, (16-17; 8-8 MEAC), 33, 38, 0, 71
400598570, 2014-12-06, Morgan State, (7-24; 5-11 MEAC), 29, 36, 0, 65, Norfolk State, (20-13; 12-4 MEAC), 41, 44, 0, 85
400591386, 2014-12-06, W Kentucky, (3-4; 0-3 away), 32, 49, 0, 81, Murray State, (5-4; 3-1 home), 49, 44, 0, 93
400587084, 2014-12-06, Bucknell, (3-6; 0-4 away), 18, 21, 0, 39, Columbia, (5-2; 4-0 home), 24, 38, 0, 62
400587088, 2014-12-06, Mt St Mary's, (2-4; 2-3 away), 35, 39, 0, 74, Loyola (MD), (3-5; 2-2 home), 30, 35, 0, 65
400589292, 2014-12-06, Thomas (GA),  , 28, 38, 0, 66, Gardner-Webb, (5-4; 3-0 home), 45, 37, 0, 82
400589296, 2014-12-06, William & Mary, (5-3; 1-3 away), 28, 35, 0, 63, High Point, (6-2; 2-0 home), 27, 39, 0, 66
400591040, 2014-12-06, Jackson State, (1-7; 1-6 away), 26, 26, 0, 52, LA Tech, (7-1; 5-0 home), 27, 38, 0, 65
400591293, 2014-12-06, Harvard, (6-1; 1-0 away), 21, 23, 20, 64, UVM, (4-4; 1-0 Am. East), 24, 20, 8, 52
400595598, 2014-12-06, SE Louisiana, (2-7; 0-7 away), 24, 35, 0, 59, SE Missouri St, (4-4; 3-0 home), 36, 27, 0, 63
400596488, 2014-12-06, Cent Conn St, (1-7; 1-4 away), 30, 26, 0, 56, Hartford, (5-4; 0-1 Am. East), 21, 26, 0, 47
400597709, 2014-12-06, Non D-I School, NA, 28, 17, 0, 45, UNH, (5-2; 3-0 home), 45, 51, 0, 96
400586908, 2014-12-06, Miami (OH), (2-6; 0-1 away), 27, 51, 0, 78, IPFW, (5-2; 3-0 home), 30, 56, 0, 86
400595599, 2014-12-06, Non D-I School, NA, 41, 44, 0, 85, New Orleans, (2-3; 2-0 home), 54, 46, 0, 100
400587830, 2014-12-06, Wake Forest, (4-5; 0-1 ACC), 28, 37, 0, 65, NC State, (7-1; 1-0 ACC), 31, 47, 0, 78
400591218, 2014-12-06, Bryant, (1-5; 0-4 away), 30, 32, 0, 62, Brown, (4-6; 3-2 home), 41, 28, 0, 69
400595397, 2014-12-06, Savannah State, (3-6; 0-6 away), 17, 32, 0, 49, Indiana, (7-1; 7-1 home), 43, 52, 0, 95
400585946, 2014-12-06, Portland State, (4-3; 2-3 away), 32, 30, 0, 62, UC Riverside, (5-3; 4-1 home), 37, 51, 0, 88
400586348, 2014-12-06, George Mason, (2-6; 0-1 away), 23, 36, 6, 65, Northern Iowa, (8-0; 5-0 home), 27, 32, 12, 71
400586714, 2014-12-06, Abil Christian, (3-4; 0-3 away), 25, 34, 0, 59, Houston, (4-1; 3-0 home), 33, 38, 0, 71
400587829, 2014-12-06, Fair Dickinson, (3-4; 1-3 away), 22, 35, 0, 57, Notre Dame, (8-1; 7-0 home), 32, 43, 0, 75
400588359, 2014-12-06, Alabama, (5-2; 0-1 away), 30, 54, 0, 84, Xavier, (6-2; 5-0 home), 41, 56, 0, 97
400591123, 2014-12-06, URI, (5-2; 1-0 away), 35, 40, 0, 75, Southern Miss, (4-3; 4-1 home), 17, 26, 0, 43
400591384, 2014-12-06, Non D-I School, NA, 20, 29, 0, 49, Rice, (2-6; 2-2 home), 23, 31, 0, 54
400595218, 2014-12-06, LA-Lafayette, (3-4; 0-3 away), 31, 39, 0, 70, McNeese State, (4-2; 4-0 home), 41, 39, 0, 80
400595219, 2014-12-06, Non D-I School, NA, 23, 32, 0, 55, UL Monroe, (3-3; 2-0 home), 43, 40, 0, 83
400586343, 2014-12-06, IUPUI, (2-5; 1-3 away), 16, 46, 0, 62, Evansville, (6-1; 3-0 home), 40, 49, 0, 89
400591584, 2014-12-06, New Mexico, (5-3; 1-0 away), 30, 33, 0, 63, Valparaiso, (8-2; 2-1 home), 20, 26, 0, 46
400595215, 2014-12-06, Non D-I School, NA, 26, 42, 0, 68, Arkansas State, (2-2; 1-2 home), 38, 57, 0, 95
400586345, 2014-12-06, Austin Peay, (2-6; 0-5 away), 25, 24, 0, 49, S Illinois, (5-3; 2-0 home), 41, 30, 0, 71
400585947, 2014-12-06, Non D-I School, NA, 22, 23, 0, 45, Southern Utah, (2-4; 1-2 home), 40, 52, 0, 92
400590753, 2014-12-06, UTEP, (4-3; 0-2 away), 35, 29, 0, 64, New Mexico St, (4-5; 4-0 home), 35, 36, 0, 71
400595920, 2014-12-06, Pepperdine, (5-1; 2-1 away), 38, 36, 0, 74, CS Fullerton, (3-6; 1-1 home), 27, 35, 0, 62
400598804, 2014-12-06, Selma,  , 32, 32, 0, 64, Grambling St, (2-5; 2-0 home), 37, 37, 0, 74
400600648, 2014-12-06, U of Great Falls,  , 27, 34, 0, 61, Grand Canyon, (4-4; 3-2 home), 38, 42, 0, 80
400585949, 2014-12-06, Pacific, (6-3; 3-1 away), 29, 39, 0, 68, Idaho State, (1-5; 1-2 home), 22, 40, 0, 62
400586349, 2014-12-06, Bradley, (3-5; 0-1 away), 20, 25, 0, 45, Memphis, (3-3; 2-1 home), 34, 39, 0, 73
400585943, 2014-12-06, Utah Valley, (3-4; 2-4 away), 33, 27, 0, 60, Montana State, (3-5; 3-1 home), 37, 31, 0, 68
400587250, 2014-12-06, Oregon State, (5-2; 1-0 away), 24, 29, 12, 65, Portland, (6-2; 3-1 home), 30, 23, 5, 58
400590752, 2014-12-06, Fresno State, (3-6; 1-2 away), 25, 38, 0, 63, CSU Bakersfield, (1-7; 1-3 home), 24, 37, 0, 61
400591585, 2014-12-06, Santa Clara, (4-4; 1-2 away), 32, 29, 0, 61, San Jose State, (1-8; 1-3 home), 32, 18, 0, 50
400595921, 2014-12-06, Non D-I School, NA, 17, 18, 0, 35, Cal Poly, (3-3; 3-0 home), 41, 31, 0, 72
400595922, 2014-12-06, Non D-I School, NA, 28, 30, 0, 58, CS Northridge, (3-7; 2-2 home), 33, 37, 0, 70
400585945, 2014-12-06, Sacramento St, (4-3; 1-3 away), 27, 35, 0, 62, UC Irvine, (4-3; 3-0 home), 34, 40, 0, 74
400585948, 2014-12-06, E Washington, (7-1; 2-1 away), 44, 43, 0, 87, Seattle, (3-5; 2-4 home), 25, 50, 0, 75
400587251, 2014-12-06, Boise State, (5-2; 2-2 away), 41, 41, 0, 82, Saint Mary's, (5-1; 5-1 home), 39, 32, 0, 71
400588362, 2014-12-07, Towson, (7-2; 3-2 away), 17, 29, 0, 46, Georgetown, (5-2; 4-0 home), 40, 38, 0, 78
400593214, 2014-12-07, Colorado, (5-2; 0-2 away), 22, 35, 0, 57, Georgia, (5-3; 4-0 home), 34, 30, 0, 64
400597853, 2014-12-07, Delaware State, (4-4; 3-4 away), 32, 34, 0, 66, Delaware, (0-7; 0-2 home), 21, 32, 0, 53
400586171, 2014-12-07, Fairfield, (4-5; 2-0 MAAC), 26, 20, 10, 56, Quinnipiac, (3-4; 0-2 MAAC), 18, 28, 6, 52
400586911, 2014-12-07, W Illinois, (2-5; 0-4 away), 21, 33, 0, 54, Cleveland State, (4-4; 3-1 home), 44, 32, 0, 76
400587438, 2014-12-07, Buffalo, (5-2; 4-2 away), 33, 41, 0, 74, Robert Morris, (2-6; 0-3 home), 23, 36, 0, 59
400585950, 2014-12-07, N Colorado, (4-3; 0-3 away), 28, 30, 0, 58, Colorado State, (8-0; 5-0 home), 29, 37, 0, 66
400586172, 2014-12-07, Marist, (7-25; 5-15 MAAC), 19, 19, 0, 38, Manhattan, (19-13; 13-7 MAAC), 29, 31, 0, 60
400586267, 2014-12-07, Siena, (3-4; 1-1 MAAC), 30, 38, 0, 68, Rider, (4-5; 1-0 MAAC), 34, 46, 0, 80
400588360, 2014-12-07, Milwaukee, (4-5; 0-3 away), 24, 37, 0, 61, DePaul, (6-1; 5-1 home), 38, 45, 0, 83
400588680, 2014-12-07, FGCU, (8-1; 0-0 away), 36, 48, 0, 84, UMass, (5-4; 3-0 home), 33, 42, 0, 75
400589297, 2014-12-07, Non D-I School, NA, 24, 42, 0, 66, UNC Asheville, (3-4; 2-1 home), 47, 44, 0, 91
400591125, 2014-12-07, Richmond, (3-4; 0-4 away), 24, 22, 0, 46, JMU, (6-2; 6-1 home), 24, 27, 0, 51
400595220, 2014-12-07, Hofstra, (6-2; 2-2 away), 29, 39, 0, 68, Appalachian St, (3-3; 1-1 home), 26, 25, 0, 51
400597886, 2014-12-07, Non D-I School, NA, 41, 32, 0, 73, Elon, (5-3; 3-1 home), 56, 61, 0, 117
400591124, 2014-12-07, Charlotte, (4-4; 2-1 away), 28, 42, 0, 70, G Washington, (5-2; 3-0 home), 31, 47, 0, 78
400586717, 2014-12-07, ECU, (4-5; 0-2 away), 29, 35, 0, 64, UNC, (6-2; 3-1 home), 48, 60, 0, 108
400586350, 2014-12-07, Illinois State, (4-3; 1-0 away), 36, 42, 0, 78, UAB, (3-6; 3-3 home), 30, 44, 0, 74
400586718, 2014-12-07, Tulsa, (5-3; 1-2 away), 33, 45, 0, 78, AR-Little Rock, (4-3; 4-1 home), 25, 48, 0, 73
400587833, 2014-12-07, Radford, (5-3; 1-3 away), 39, 29, 0, 68, VT, (4-4; 3-2 home), 30, 36, 0, 66
400606907, 2014-12-07, Non D-I School, NA, 23, 25, 0, 48, Tenn Tech, (5-3; 5-0 home), 46, 41, 0, 87
400591586, 2014-12-07, Cal, (7-1; 2-0 away), 24, 39, 0, 63, Nevada, (2-6; 2-1 home), 30, 26, 0, 56
400591587, 2014-12-07, Non D-I School, NA, 17, 18, 0, 35, Wyoming, (8-1; 8-0 home), 38, 32, 0, 70
400593213, 2014-12-07, Ole Miss, (6-2; 2-0 away), 47, 32, 0, 79, Oregon, (5-3; 5-1 home), 33, 40, 0, 73
400595600, 2014-12-07, Ouachita Baptist,  , 25, 35, 0, 60, SF Austin, (6-3; 3-1 home), 39, 45, 0, 84
400597831, 2014-12-07, Non D-I School, NA, 21, 24, 0, 45, Youngstown St, (7-4; 3-1 home), 35, 35, 0, 70
400586170, 2014-12-07, Iona, (4-3; 0-1 MAAC), 40, 49, 0, 89, Monmouth, (4-4; 2-0 MAAC), 48, 44, 0, 92
400587832, 2014-12-07, Arkansas, (6-2; 1-2 away), 25, 32, 8, 65, Clemson, (5-3; 3-2 home), 29, 28, 11, 68
400587253, 2014-12-07, Houston Baptist, (3-3; 1-3 away), 23, 31, 0, 54, San Francisco, (5-3; 4-0 home), 33, 52, 0, 85
400591588, 2014-12-07, Utah State, (3-4; 1-3 away), 41, 43, 0, 84, USC, (6-3; 4-1 home), 40, 49, 0, 89
400596339, 2014-12-07, E Kentucky, (4-3; 1-2 away), 14, 35, 0, 49, Kentucky, (9-0; 8-0 home), 41, 41, 0, 82
400585728, 2014-12-07, West Virginia, (8-1; 1-0 away), 20, 47, 0, 67, N Kentucky, (3-5; 2-2 home), 17, 25, 0, 42
400598574, 2014-12-07, NC Central, (6-3; 2-0 MEAC), 27, 34, 0, 61, Howard, (5-5; 1-1 MEAC), 19, 20, 0, 39
400587254, 2014-12-07, San Diego, (4-5; 0-2 away), 35, 33, 0, 68, UCLA, (7-2; 6-0 home), 33, 42, 0, 75
400588361, 2014-12-07, Creighton, (7-2; 1-1 away), 27, 38, 0, 65, Nebraska, (5-2; 4-1 home), 28, 27, 0, 55
400597826, 2014-12-07, Non D-I School, NA, 30, 28, 0, 58, Wright State, (5-4; 3-0 home), 42, 39, 0, 81
400591589, 2014-12-07, San Diego State, (6-2; 0-1 away), 15, 21, 0, 36, Washington, (7-0; 2-0 home), 21, 28, 0, 49
400585951, 2014-12-07, North Dakota St, (4-4; 1-4 away), 21, 36, 0, 57, Montana, (3-4; 2-0 home), 35, 34, 0, 69
400586351, 2014-12-07, Missouri State, (11-20; 5-13 MVC),  ,  , 0, 0, Oral Roberts, (18-14; 10-6 Summit),  ,  , 0, 0
400588363, 2014-12-08, Kennesaw St, (3-7; 0-6 away), 27, 24, 0, 51, Butler, (8-1; 5-0 home), 52, 41, 0, 93
400587834, 2014-12-08, Savannah State, (3-7; 0-7 away), 23, 16, 0, 39, Miami (FL), (9-1; 4-1 home), 34, 36, 0, 70
400586913, 2014-12-08, IPFW, (5-3; 2-3 away), 19, 24, 0, 43, Purdue, (7-2; 5-1 home), 35, 28, 0, 63
400587089, 2014-12-08, Albany, (2-6; 1-4 away), 28, 30, 0, 58, Bucknell, (4-6; 2-2 home), 29, 32, 0, 61
400587090, 2014-12-08, Sacred Heart, (4-4; 0-3 away), 44, 37, 0, 81, Lafayette, (6-2; 2-0 home), 46, 36, 0, 82
400587091, 2014-12-08, Boston U, (2-6; 1-3 away), 33, 23, 0, 56, Harvard, (7-1; 6-0 home), 34, 36, 0, 70
400589120, 2014-12-08, Non D-I School, NA, 26, 24, 0, 50, Chattanooga, (4-5; 4-1 home), 58, 46, 0, 104
400589298, 2014-12-08, Non D-I School, NA, 16, 22, 0, 38, Campbell, (2-5; 2-1 home), 26, 37, 0, 63
400591325, 2014-12-08, Yale, (8-3; 3-3 away), 20, 27, 0, 47, Florida, (4-4; 3-1 home), 46, 39, 0, 85
400596471, 2014-12-08, Non D-I School, NA, 28, 35, 0, 63, Binghamton, (1-9; 1-3 home), 16, 36, 0, 52
400598660, 2014-12-08, Coppin State, (8-23; 6-10 MEAC), 37, 32, 0, 69, Norfolk State, (20-13; 12-4 MEAC), 42, 46, 0, 88
400598573, 2014-12-08, Bethune-Cookman, (11-21; 7-9 MEAC), 17, 49, 0, 66, S Carolina St, (11-22; 7-9 MEAC), 37, 34, 0, 71
400598571, 2014-12-08, NC A&T, (9-23; 6-10 MEAC), 34, 24, 0, 58, MD-E Shore, (18-14; 11-5 MEAC), 26, 43, 0, 69
400586719, 2014-12-08, UCSB, (4-4; 0-3 away), 29, 38, 6, 73, SMU, (6-3; 6-1 home), 38, 29, 13, 80
400598647, 2014-12-08, Morgan State, (7-24; 5-11 MEAC), 28, 30, 0, 58, Hampton, (16-17; 8-8 MEAC), 27, 35, 0, 62
400585952, 2014-12-08, North Dakota, (3-5; 1-4 away), 26, 30, 0, 56, Minnesota, (7-2; 5-0 home), 43, 49, 0, 92
400586912, 2014-12-08, Omaha, (3-4; 1-4 away), 30, 31, 0, 61, Air Force, (5-3; 4-0 home), 37, 40, 0, 77
400588364, 2014-12-08, Brown, (5-6; 1-3 away), 30, 47, 0, 77, Providence, (6-3; 4-1 home), 30, 37, 0, 67
400591387, 2014-12-08, Incarnate Word, (5-1; 1-1 away), 29, 36, 0, 65, UTEP, (5-3; 3-0 home), 40, 41, 0, 81
400588365, 2014-12-09, Villanova, (9-0; 1-0 away), 33, 40, 0, 73, Illinois, (7-2; 5-0 home), 27, 32, 0, 59
400586353, 2014-12-09, Seton Hall, (7-1; 0-1 away), 25, 43, 0, 68, Wichita State, (6-1; 5-0 home), 40, 37, 0, 77
400585729, 2014-12-09, UMKC, (3-7; 1-6 away), 27, 29, 0, 56, Iowa State, (6-1; 5-0 home), 41, 32, 0, 73
400587835, 2014-12-09, Mt St Mary's, (2-5; 2-4 away), 27, 40, 0, 67, Notre Dame, (9-1; 8-0 home), 52, 41, 0, 93
400586916, 2014-12-09, IUPUI, (2-6; 1-4 away), 23, 20, 0, 43, Xavier, (7-2; 6-0 home), 27, 39, 0, 66
400587092, 2014-12-09, Bryant, (2-5; 1-4 away), 42, 38, 0, 80, Army, (6-2; 3-1 home), 31, 42, 0, 73
400587093, 2014-12-09, Non D-I School, NA, 26, 26, 0, 52, Colgate, (2-7; 1-2 home), 48, 40, 0, 88
400587094, 2014-12-09, VMI, (4-6; 1-1 Southern), 43, 23, 0, 66, Navy, (3-7; 2-3 home), 46, 38, 0, 84
400587096, 2014-12-09, Loyola (MD), (3-6; 1-4 away), 24, 18, 0, 42, Saint Joe's, (5-4; 4-1 home), 28, 40, 0, 68
400587440, 2014-12-09, Bowling Green, (5-2; 2-2 away), 32, 20, 0, 52, Dayton, (7-1; 4-0 home), 24, 32, 0, 56
400589299, 2014-12-09, Non D-I School, NA, 28, 23, 0, 51, Winthrop, (4-4; 3-1 home), 50, 46, 0, 96
400591774, 2014-12-09, LIU Brooklyn, (1-6; 1-3 away), 30, 53, 0, 83, Maine, (1-7; 1-1 home), 34, 36, 0, 70
400595402, 2014-12-09, UNH, (5-3; 2-3 away), 32, 24, 0, 56, Rutgers, (5-4; 3-2 home), 38, 22, 0, 60
400587095, 2014-12-09, Hartford, (6-4; 0-1 Am. East), 35, 44, 0, 79, Holy Cross, (4-3; 2-1 home), 29, 32, 0, 61
400596031, 2014-12-09, St Francis (BKN), (2-6; 1-4 away), 33, 33, 0, 66, NJIT, (4-5; 2-1 home), 38, 30, 0, 68
400585730, 2014-12-09, Bradley, (3-6; 0-2 away), 19, 28, 0, 47, Kansas State, (5-4; 4-0 home), 18, 32, 0, 50
400585732, 2014-12-09, Furman, (2-5; 1-0 Southern), 29, 40, 0, 69, TCU, (9-0; 6-0 home), 33, 47, 0, 80
400586173, 2014-12-09, Marist, (1-8; 0-2 MAAC), 14, 28, 0, 42, Penn, (3-5; 1-3 home), 35, 24, 0, 59
400586352, 2014-12-09, Evansville, (7-1; 2-0 away), 29, 36, 0, 65, Belmont, (7-2; 4-1 home), 37, 25, 0, 62
400586915, 2014-12-09, South Dakota St, (5-3; 1-2 away), 25, 37, 0, 62, Saint Louis, (5-4; 3-2 home), 24, 31, 0, 55
400595221, 2014-12-09, Northwestern St, (3-5; 1-4 away), 30, 44, 0, 74, UL Monroe, (4-3; 3-0 home), 42, 40, 0, 82
400593215, 2014-12-09, Utah Valley, (3-5; 2-5 away), 28, 28, 0, 56, Arizona, (9-0; 6-0 home), 42, 45, 0, 87
400585731, 2014-12-09, Texas A&M, (6-2; 0-1 away), 29, 34, 0, 63, Baylor, (8-1; 5-0 home), 36, 41, 0, 77
400585953, 2014-12-09, Idaho State, (2-5; 1-3 away), 30, 37, 0, 67, Grand Canyon, (4-5; 3-3 home), 28, 23, 0, 51
400587439, 2014-12-09, E Michigan, (8-1; 1-1 away), 19, 26, 0, 45, Michigan, (6-3; 5-2 home), 21, 21, 0, 42
400591064, 2014-12-09, Alcorn State, (1-6; 0-4 away), 20, 24, 0, 44, Iowa, (8-2; 7-0 home), 35, 32, 0, 67
400591590, 2014-12-09, Non D-I School, NA, 20, 29, 0, 49, Boise State, (6-2; 2-0 home), 37, 41, 0, 78
400586914, 2014-12-09, South Dakota, (3-7; 2-4 away), 28, 37, 23, 88, Creighton, (8-2; 6-0 home), 25, 40, 26, 91
400587836, 2014-12-09, Indiana, (7-2; 0-0 away), 41, 33, 0, 74, Louisville, (8-0; 6-0 home), 46, 48, 0, 94
400591591, 2014-12-09, Non D-I School, NA, 30, 33, 0, 63, San Jose State, (2-8; 2-3 home), 33, 41, 0, 74
400595923, 2014-12-09, E Illinois, (3-6; 0-4 away), 32, 38, 0, 70, UC Davis, (7-1; 5-0 home), 36, 44, 0, 80
400589121, 2014-12-10, Non D-I School, NA, 41, 37, 0, 78, UNC Greensboro, (3-6; 2-2 home), 41, 41, 0, 82
400591241, 2014-12-10, Columbia, (5-3; 1-2 away), 25, 21, 0, 46, Kentucky, (10-0; 9-0 home), 23, 33, 0, 56
400585733, 2014-12-10, Kansas, (7-1; 1-0 away), 34, 41, 0, 75, Georgetown, (5-3; 4-1 home), 32, 38, 0, 70
400589301, 2014-12-10, High Point, (6-3; 2-3 away), 24, 19, 0, 43, OSU, (7-1; 7-0 home), 43, 54, 0, 97
400598576, 2014-12-10, NC Central, (6-4; 2-0 MEAC), 18, 38, 0, 56, Maryland, (9-1; 7-1 home), 39, 28, 0, 67
400586174, 2014-12-10, Monmouth, (4-5; 2-0 MAAC), 22, 30, 6, 58, Fordham, (3-4; 3-2 home), 31, 21, 16, 68
400586175, 2014-12-10, Rider, (4-6; 1-1 MAAC), 28, 36, 0, 64, Iona, (5-3; 1-1 MAAC), 40, 37, 0, 77
400588366, 2014-12-10, URI, (5-3; 1-1 away), 26, 34, 0, 60, Providence, (7-3; 5-1 home), 31, 37, 0, 68
400589300, 2014-12-10, Campbell, (3-5; 1-4 away), 35, 35, 0, 70, Delaware State, (4-5; 1-1 home), 22, 33, 0, 55
400591735, 2014-12-10, UMBC, (0-9; 0-7 away), 28, 25, 0, 53, Cent Conn St, (2-7; 1-0 home), 28, 37, 0, 65
400595222, 2014-12-10, Arkansas State, (2-3; 1-1 away), 18, 28, 0, 46, Purdue, (8-2; 6-1 home), 52, 35, 0, 87
400597901, 2014-12-10, Hofstra, (7-2; 3-2 away), 48, 57, 0, 105, Coppin State, (1-8; 0-2 MEAC), 26, 38, 0, 64
400588367, 2014-12-10, Fair Dickinson, (3-5; 1-4 away), 25, 27, 0, 52, St John's, (7-1; 5-0 home), 39, 35, 0, 74
400586176, 2014-12-10, Princeton, (3-7; 0-4 away), 25, 21, 0, 46, St Peter's, (4-6; 0-2 MAAC), 25, 35, 0, 60
400586354, 2014-12-10, S Illinois, (5-4; 2-3 away), 33, 21, 0, 54, SE Missouri St, (5-4; 4-0 home), 29, 26, 0, 55
400586720, 2014-12-10, SEOkla St,  , 28, 41, 0, 69, Tulsa, (5-4; 3-1 home), 25, 41, 0, 66
400586721, 2014-12-10, Towson, (7-3; 3-3 away), 20, 44, 0, 64, Temple, (6-3; 5-0 home), 25, 51, 0, 76
400586917, 2014-12-10, Non D-I School, NA, 23, 44, 0, 67, Omaha, (4-4; 3-0 home), 48, 46, 0, 94
400591013, 2014-12-10, Southern, (2-7; 0-4 away), 23, 34, 0, 57, Minnesota, (8-2; 6-0 home), 46, 39, 0, 85
400591276, 2014-12-10, Dartmouth, (3-4; 1-3 away), 36, 33, 0, 69, UMass Lowell, (6-4; 2-1 home), 27, 21, 0, 48
400591388, 2014-12-10, LA Tech, (7-2; 2-2 away), 41, 45, 0, 86, LA-Lafayette, (4-4; 3-0 home), 39, 55, 0, 94
400595404, 2014-12-10, Incarnate Word, (6-1; 2-1 away), 33, 41, 0, 74, Nebraska, (5-3; 4-2 home), 32, 41, 0, 73
400597818, 2014-12-10, TrinIntl,  , 24, 30, 0, 54, Valparaiso, (9-2; 3-1 home), 42, 37, 0, 79
400595405, 2014-12-10, Wisconsin, (9-1; 2-0 away), 45, 48, 0, 93, Milwaukee, (4-6; 3-2 home), 24, 30, 0, 54
400587255, 2014-12-10, Utah, (7-1; 1-1 away), 30, 35, 0, 65, BYU, (7-3; 4-1 home), 31, 30, 0, 61
400586355, 2014-12-10, Northern Iowa, (9-0; 2-0 away), 42, 23, 0, 65, Denver, (4-4; 3-1 home), 25, 30, 0, 55
400585734, 2014-12-10, Fresno State, (3-7; 1-3 away), 31, 25, 0, 56, Texas Tech, (6-1; 6-0 home), 34, 39, 0, 73
400585954, 2014-12-10, Davidson, (7-1; 2-0 away), 45, 65, 0, 110, Montana, (3-5; 2-1 home), 42, 57, 0, 99
400591126, 2014-12-10, Duquesne, (3-3; 1-1 away), 28, 34, 0, 62, Penn State, (9-1; 5-0 home), 29, 35, 0, 64
400591592, 2014-12-10, Colorado State, (9-0; 1-0 away), 30, 32, 0, 62, Colorado, (5-3; 5-1 home), 32, 28, 0, 60
400591593, 2014-12-10, LBSU, (5-6; 0-5 away), 21, 38, 0, 59, San Diego State, (7-2; 5-0 home), 25, 35, 0, 60
400587256, 2014-12-10, Washington St, (4-5; 0-2 away), 29, 37, 0, 66, Gonzaga, (8-1; 5-0 home), 39, 42, 0, 81
400591594, 2014-12-10, Wyoming, (8-2; 0-2 away), 16, 26, 0, 42, Cal, (8-1; 5-0 home), 15, 30, 0, 45
400593216, 2014-12-10, UC Riverside, (5-4; 1-3 away), 36, 30, 0, 66, UCLA, (8-2; 7-0 home), 28, 49, 0, 77
400589122, 2014-12-11, Chattanooga, (5-5; 1-0 Southern), 31, 36, 0, 67, The Citadel, (4-5; 0-1 Southern), 23, 25, 0, 48
400586918, 2014-12-11, Non D-I School, NA, 35, 32, 0, 67, IPFW, (6-3; 4-0 home), 48, 43, 0, 91
400587097, 2014-12-11, Binghamton, (1-10; 0-5 away), 16, 28, 0, 44, Colgate, (3-7; 2-2 home), 26, 39, 0, 65
400587837, 2014-12-11, Maine, (1-8; 0-6 away), 34, 40, 0, 74, Boston College, (5-3; 4-0 home), 42, 43, 0, 85
400588368, 2014-12-11, DePaul, (6-2; 1-1 away), 22, 46, 0, 68, G Washington, (6-2; 4-0 home), 42, 39, 0, 81
400589302, 2014-12-11, Non D-I School, NA, 21, 19, 0, 40, Coast Carolina, (7-2; 5-0 home), 41, 44, 0, 85
400589303, 2014-12-11, Non D-I School, NA, 23, 17, 0, 40, UNC Asheville, (4-4; 3-1 home), 39, 39, 0, 78
400596340, 2014-12-11, Wright State, (6-4; 3-2 away), 32, 47, 0, 79, Belmont, (7-3; 4-2 home), 36, 35, 0, 71
400597299, 2014-12-11, Elon, (5-4; 1-2 away), 27, 46, 0, 73, Missouri, (5-4; 4-1 home), 46, 32, 0, 78
400597834, 2014-12-11, S Carolina St, (3-6; 2-0 MEAC), 20, 27, 0, 47, Charleston, (4-4; 2-1 home), 25, 25, 0, 50
400586722, 2014-12-11, UCF, (5-3; 0-2 away), 30, 30, 0, 60, UIC, (3-7; 3-2 home), 27, 44, 0, 71
400586919, 2014-12-11, Idaho, (4-4; 1-2 away), 36, 39, 0, 75, W Illinois, (3-5; 3-1 home), 25, 53, 0, 78
400595223, 2014-12-11, Non D-I School, NA, 29, 34, 0, 63, Troy, (4-3; 4-1 home), 42, 38, 0, 80
400591595, 2014-12-11, Non D-I School, NA, 20, 31, 0, 51, Boise State, (7-2; 3-0 home), 41, 50, 0, 91
400585956, 2014-12-11, E Washington, (8-1; 3-1 away), 40, 41, 0, 81, San Francisco, (5-4; 4-1 home), 30, 46, 0, 76
400587257, 2014-12-11, San Diego, (5-5; 1-2 away), 41, 38, 0, 79, UCSB, (4-5; 2-1 home), 26, 39, 0, 65
400585955, 2014-12-11, CS Fullerton, (3-7; 0-6 away), 24, 35, 0, 59, Sacramento St, (5-3; 4-0 home), 33, 40, 0, 73
400587838, 2014-12-12, Charleston So, (5-3; 1-2 away), 20, 30, 0, 50, NC State, (8-1; 1-0 ACC), 46, 40, 0, 86
400597300, 2014-12-12, Texas Southern, (1-7; 0-7 away), 22, 28, 0, 50, Florida, (5-4; 4-1 home), 39, 36, 0, 75
400587098, 2014-12-12, NJIT, (4-6; 2-5 away), 30, 36, 0, 66, Holy Cross, (5-3; 3-1 home), 28, 48, 0, 76
400585735, 2014-12-12, Iowa State, (7-1; 1-0 away), 38, 52, 0, 90, Iowa, (8-3; 7-1 home), 33, 42, 0, 75
400588682, 2014-12-13, USC Upstate, (8-3; 2-2 away), 28, 29, 0, 57, Maryland, (10-1; 8-1 home), 24, 43, 0, 67
400587839, 2014-12-13, UNC, (6-3; 0-1 away), 34, 36, 0, 70, Kentucky, (11-0; 10-0 home), 49, 35, 0, 84
400586360, 2014-12-13, Wichita State, (7-1; 1-1 away), 35, 42, 0, 77, Detroit, (6-4; 4-2 home), 31, 37, 0, 68
400588369, 2014-12-13, Radford, (5-4; 1-4 away), 18, 31, 0, 49, Georgetown, (6-3; 5-1 home), 29, 47, 0, 76
400588370, 2014-12-13, Stony Brook, (5-5; 0-5 away), 30, 31, 0, 61, Providence, (8-3; 6-1 home), 36, 43, 0, 79
400595408, 2014-12-13, Morehead State, (4-8; 1-5 away), 28, 43, 0, 71, OSU, (8-1; 8-0 home), 47, 40, 0, 87
400586180, 2014-12-13, Marist, (1-9; 0-2 MAAC), 42, 35, 0, 77, VMI, (5-6; 1-1 Southern), 56, 36, 0, 92
400586920, 2014-12-13, E Kentucky, (5-3; 2-2 away), 34, 39, 0, 73, IUPUI, (2-7; 1-3 home), 32, 32, 0, 64
400591128, 2014-12-13, La Salle, (5-4; 2-0 away), 33, 32, 0, 65, Drexel, (2-6; 1-3 home), 22, 33, 0, 55
400586179, 2014-12-13, Indiana State, (3-6; 1-2 away), 48, 36, 0, 84, Iona, (6-3; 1-1 MAAC), 42, 49, 0, 91
400587446, 2014-12-13, Alcorn State, (1-7; 0-5 away), 29, 26, 0, 55, Ohio, (3-3; 3-2 home), 30, 36, 0, 66
400587840, 2014-12-13, St Bonaventure, (6-2; 1-1 away), 25, 29, 0, 54, Pitt, (6-3; 3-0 home), 24, 34, 0, 58
400589304, 2014-12-13, Non D-I School, NA, 26, 35, 0, 61, Liberty, (4-5; 4-1 home), 30, 49, 0, 79
400589305, 2014-12-13, Non D-I School, NA, 34, 34, 0, 68, Presbyterian, (4-6; 4-1 home), 35, 44, 0, 79
400591129, 2014-12-13, Dayton, (7-2; 1-1 away), 23, 32, 0, 55, Arkansas, (7-2; 6-0 home), 40, 29, 0, 69
400591130, 2014-12-13, Delaware State, (4-6; 3-5 away), 18, 26, 0, 44, URI, (6-3; 4-0 home), 31, 52, 0, 83
400591792, 2014-12-13, Norfolk State, (6-5; 2-0 MEAC), 26, 31, 7, 64, Mt St Mary's, (3-5; 1-1 home), 37, 20, 10, 67
400593217, 2014-12-13, Pepperdine, (5-2; 2-2 away), 31, 43, 0, 74, Arizona State, (6-3; 6-0 home), 29, 52, 0, 81
400596032, 2014-12-13, Non D-I School, NA, 43, 29, 0, 72, St Francis (BKN), (3-6; 1-1 home), 44, 46, 0, 90
400586357, 2014-12-13, Murray State, (6-4; 2-1 away), 42, 39, 0, 81, Evansville, (7-2; 3-1 home), 38, 41, 0, 79
400587258, 2014-12-13, Saint Mary's, (6-1; 1-0 away), 27, 34, 10, 71, Creighton, (8-3; 6-1 home), 27, 34, 6, 67
400585736, 2014-12-13, Oklahoma, (6-2; 1-1 away), 43, 44, 0, 87, Tulsa, (5-5; 3-2 home), 32, 36, 0, 68
400595409, 2014-12-13, Nicholls State, (1-5; 0-5 away), 15, 28, 0, 43, Wisconsin, (10-1; 5-1 home), 47, 39, 0, 86
400595224, 2014-12-13, Non D-I School, NA, 28, 31, 0, 59, LA-Lafayette, (5-4; 4-0 home), 64, 51, 0, 115
400586921, 2014-12-13, Omaha, (4-5; 1-5 away), 35, 37, 0, 72, UMKC, (4-7; 3-0 home), 39, 40, 0, 79
400585737, 2014-12-13, Utah, (7-2; 1-1 away), 21, 39, 0, 60, Kansas, (8-1; 3-0 home), 39, 24, 0, 63
400585959, 2014-12-13, Loyola Mary, (3-5; 0-3 away), 32, 37, 0, 69, N Arizona, (3-6; 2-1 home), 35, 36, 0, 71
400586181, 2014-12-13, Canisius, (4-4; 2-0 MAAC), 21, 37, 0, 58, UMass, (6-4; 4-0 home), 46, 29, 0, 75
400587444, 2014-12-13, Cleveland State, (4-5; 1-4 away), 31, 26, 0, 57, Bowling Green, (6-2; 4-0 home), 24, 43, 0, 67
400588371, 2014-12-13, Xavier, (8-2; 1-0 away), 32, 42, 0, 74, Missouri, (5-5; 4-2 home), 27, 31, 0, 58
400589123, 2014-12-13, UNC Greensboro, (4-6; 1-0 Southern), 47, 33, 0, 80, East Tenn St, (5-2; 1-1 Southern), 43, 36, 0, 79
400591131, 2014-12-13, Duquesne, (3-4; 1-2 away), 30, 29, 0, 59, Robert Morris, (3-6; 1-3 home), 39, 36, 0, 75
400591596, 2014-12-13, AR-Pine Bluff, (1-8; 0-6 away), 19, 28, 0, 47, Air Force, (6-3; 5-0 home), 37, 43, 0, 80
400591597, 2014-12-13, Non D-I School, NA, 18, 42, 0, 60, Colorado State, (10-0; 6-0 home), 40, 48, 0, 88
400593218, 2014-12-13, Miss St, (5-3; 0-2 away), 23, 26, 0, 49, Oregon State, (6-2; 5-0 home), 30, 29, 0, 59
400600647, 2014-12-13, CSU Bakersfield, (1-8; 0-3 away), 24, 35, 0, 59, Portland State, (5-3; 3-0 home), 29, 36, 0, 65
400591390, 2014-12-13, W Kentucky, (4-4; 1-3 away), 32, 49, 0, 81, Ole Miss, (6-3; 2-3 home), 45, 29, 0, 74
400586356, 2014-12-13, Drake, (1-8; 0-3 away), 20, 28, 0, 48, Green Bay, (7-2; 3-0 home), 37, 27, 0, 64
400586723, 2014-12-13, JMU, (6-3; 0-2 away), 28, 30, 0, 58, ECU, (5-5; 4-1 home), 25, 45, 0, 70
400586924, 2014-12-13, Idaho, (4-5; 1-3 away), 35, 50, 0, 85, South Dakota St, (6-3; 5-0 home), 38, 49, 0, 87
400588681, 2014-12-13, Lipscomb, (4-5; 1-4 away), 30, 38, 0, 68, Austin Peay, (2-7; 1-1 home), 26, 33, 0, 59
400590756, 2014-12-13, Grand Canyon, (4-6; 1-3 away), 31, 35, 0, 66, Indiana, (8-2; 8-1 home), 42, 52, 0, 94
400595601, 2014-12-13, Non D-I School, NA, 18, 30, 0, 48, Abil Christian, (4-4; 4-1 home), 35, 41, 0, 76
400597302, 2014-12-13, Youngstown St, (7-5; 2-4 away), 26, 37, 0, 63, Texas A&M, (7-2; 5-0 home), 36, 45, 0, 81
400593219, 2014-12-13, Michigan, (6-4; 0-1 away), 25, 28, 0, 53, Arizona, (10-0; 7-0 home), 36, 44, 0, 80
400585738, 2014-12-13, Oklahoma State, (8-1; 1-1 away), 36, 37, 0, 73, Memphis, (3-4; 2-2 home), 25, 30, 0, 55
400585960, 2014-12-13, N Colorado, (4-4; 0-4 away), 42, 26, 0, 68, Colorado, (6-3; 6-1 home), 44, 49, 0, 93
400586925, 2014-12-13, Denver, (4-5; 1-4 away), 25, 18, 0, 43, Stanford, (5-2; 4-0 home), 17, 32, 0, 49
400591132, 2014-12-13, Howard, (5-6; 1-1 MEAC), 23, 18, 0, 41, Richmond, (4-4; 4-0 home), 28, 26, 0, 54
400586361, 2014-12-13, Northern Iowa, (9-1; 2-1 away), 35, 38, 14, 87, VCU, (6-3; 3-1 home), 37, 36, 20, 93
400586177, 2014-12-13, Niagara, (1-6; 1-1 MAAC), 22, 36, 0, 58, Davidson, (8-1; 6-0 home), 40, 38, 0, 78
400586182, 2014-12-13, Rider, (5-6; 1-1 MAAC), 31, 32, 0, 63, Hartford, (6-5; 0-1 Am. East), 24, 37, 0, 61
400586359, 2014-12-13, Missouri State, (5-3; 2-1 away), 28, 45, 0, 73, SE Missouri St, (5-5; 4-1 home), 32, 29, 0, 61
400587441, 2014-12-13, Arkansas State, (2-4; 1-2 away), 42, 23, 0, 65, Toledo, (5-4; 4-1 home), 37, 36, 0, 73
400587443, 2014-12-13, Mid Tennessee, (5-4; 2-1 away), 37, 25, 0, 62, Akron, (6-3; 4-1 home), 32, 29, 0, 61
400589124, 2014-12-13, Furman, (2-6; 1-0 Southern), 35, 33, 0, 68, Gardner-Webb, (6-4; 4-0 home), 36, 38, 0, 74
400591127, 2014-12-13, SIU-ED, (1-6; 0-4 away), 34, 27, 0, 61, Saint Louis, (6-4; 4-2 home), 37, 30, 0, 67
400593222, 2014-12-13, Oregon, (6-3; 0-0 away), 35, 42, 0, 77, Illinois, (7-3; 5-0 home), 39, 31, 0, 70
400595602, 2014-12-13, Sam Houston, (5-4; 1-3 away), 31, 36, 0, 67, LSU, (7-2; 5-0 home), 34, 42, 0, 76
400586178, 2014-12-13, Albany, (3-6; 2-4 away), 34, 43, 0, 77, Siena, (3-5; 1-1 MAAC), 27, 41, 0, 68
400587099, 2014-12-13, Navy, (3-8; 0-4 away), 27, 19, 0, 46, MD-E Shore, (5-7; 1-1 MEAC), 22, 31, 0, 53
400585740, 2014-12-13, Texas State, (5-2; 1-2 away), 9, 18, 0, 27, Texas, (8-1; 5-0 home), 24, 35, 0, 59
400587841, 2014-12-13, FSU, (4-5; 0-1 ACC), 30, 33, 0, 63, Notre Dame, (10-1; 1-0 ACC), 38, 45, 0, 83
400585739, 2014-12-13, McNeese State, (4-3; 0-3 away), 20, 30, 0, 50, TCU, (10-0; 7-0 home), 29, 39, 0, 68
400585957, 2014-12-13, North Dakota, (3-6; 1-5 away), 19, 23, 0, 42, North Dakota St, (5-4; 4-0 home), 43, 28, 0, 71
400586358, 2014-12-13, Jackson State, (1-8; 1-7 away), 27, 19, 0, 46, Loyola (CHI), (6-2; 3-1 home), 30, 28, 0, 58
400586724, 2014-12-13, FAU, (4-3; 1-3 away), 25, 29, 0, 54, UCF, (5-4; 5-2 home), 26, 15, 0, 41
400586922, 2014-12-13, New Mexico St, (4-6; 0-6 away), 36, 47, 0, 83, Oral Roberts, (3-4; 2-0 home), 32, 54, 0, 86
400586923, 2014-12-13, UNLV, (6-2; 0-1 away), 42, 33, 0, 75, South Dakota, (3-8; 1-1 home), 31, 30, 0, 61
400586926, 2014-12-13, Alabama State, (3-4; 0-3 away), 31, 37, 0, 68, W Illinois, (4-5; 4-1 home), 45, 33, 0, 78
400587442, 2014-12-13, Ball State, (3-4; 0-4 away), 39, 23, 0, 62, Valparaiso, (10-2; 4-1 home), 33, 32, 0, 65
400587445, 2014-12-13, N Illinois, (3-3; 0-3 away), 26, 29, 0, 55, E Illinois, (4-6; 3-1 home), 31, 28, 0, 59
400590758, 2014-12-13, Lamar, (2-6; 1-6 away), 22, 38, 0, 60, UT Pan American, (5-4; 3-0 home), 29, 37, 0, 66
400591389, 2014-12-13, Non D-I School, NA, 28, 28, 0, 56, Southern Miss, (5-3; 5-1 home), 29, 37, 0, 66
400591598, 2014-12-13, UL Monroe, (4-4; 1-2 away), 19, 27, 0, 46, New Mexico, (6-3; 4-1 home), 26, 28, 0, 54
400595603, 2014-12-13, Non D-I School, NA, 41, 43, 0, 84, Houston Baptist, (4-3; 3-0 home), 50, 49, 0, 99
400591316, 2014-12-13, Princeton, (3-8; 0-5 away), 37, 20, 0, 57, Cal, (9-1; 6-0 home), 28, 39, 0, 67
400585958, 2014-12-13, BYU, (8-3; 2-0 away), 39, 37, 0, 76, Weber State, (3-5; 2-1 home), 25, 35, 0, 60
400586725, 2014-12-13, Cincinnati, (6-2; 0-1 away), 21, 23, 11, 55, Nebraska, (6-3; 5-2 home), 23, 21, 12, 56
400595410, 2014-12-13, Purdue, (8-3; 0-1 away), 32, 39, 0, 71, Vanderbilt, (6-2; 5-1 home), 43, 38, 0, 81
400597301, 2014-12-13, Tenn Tech, (5-4; 0-4 away), 36, 17, 0, 53, Alabama, (6-2; 5-0 home), 37, 28, 0, 65
400585961, 2014-12-13, Non D-I School, NA, 22, 35, 0, 57, Idaho State, (3-5; 2-2 home), 33, 36, 0, 69
400590755, 2014-12-13, Utah State, (4-4; 2-3 away), 17, 33, 0, 50, Utah Valley, (3-6; 1-1 home), 23, 24, 0, 47
400593221, 2014-12-13, Gonzaga, (9-1; 1-1 away), 38, 49, 0, 87, UCLA, (8-3; 7-1 home), 27, 47, 0, 74
400590757, 2014-12-13, Seattle, (4-5; 1-1 away), 29, 25, 0, 54, San Jose State, (2-9; 2-4 home), 20, 18, 0, 38
400591599, 2014-12-13, CS Fullerton, (4-7; 1-6 away), 33, 32, 0, 65, Nevada, (2-7; 2-2 home), 26, 29, 0, 55
400591600, 2014-12-13, Cal Poly, (3-4; 0-4 away), 24, 33, 0, 57, Fresno State, (4-7; 3-1 home), 31, 32, 0, 63
400593220, 2014-12-13, Washington St, (4-6; 0-3 away), 30, 37, 0, 67, Santa Clara, (5-4; 3-0 home), 38, 38, 0, 76
400595225, 2014-12-13, UT-Arlington, (5-4; 3-3 away), 40, 30, 0, 70, UC Irvine, (4-4; 3-1 home), 34, 28, 0, 62
400587100, 2014-12-13, Army, (7-2; 4-1 away), 36, 29, 20, 85, USC, (6-4; 4-2 home), 33, 32, 12, 77
400587259, 2014-12-13, New Orleans, (2-4; 0-4 away), 35, 25, 0, 60, San Diego, (6-5; 3-0 home), 48, 37, 0, 85
400586183, 2014-12-14, St Peter's, (4-7; 0-2 MAAC), 27, 25, 0, 52, Seton Hall, (8-1; 5-0 home), 39, 28, 0, 67
400586185, 2014-12-14, Manhattan, (2-6; 1-1 MAAC), 25, 30, 0, 55, Rutgers, (6-4; 3-2 home), 35, 28, 0, 63
400591133, 2014-12-14, G Washington, (6-3; 1-3 away), 28, 23, 0, 51, Penn State, (10-1; 6-0 home), 34, 30, 0, 64
400586184, 2014-12-14, Quinnipiac, (3-5; 0-2 MAAC), 41, 27, 0, 68, Boston U, (3-6; 2-2 home), 36, 35, 0, 71
400587101, 2014-12-14, Colgate, (3-8; 1-6 away), 29, 28, 0, 57, UNH, (6-3; 4-0 home), 29, 34, 0, 63
400587845, 2014-12-14, Binghamton, (1-11; 0-6 away), 18, 31, 0, 49, Boston College, (6-3; 5-0 home), 32, 31, 0, 63
400596043, 2014-12-14, Wagner, (2-6; 0-6 away), 22, 25, 0, 47, UVM, (5-4; 1-0 Am. East), 27, 34, 0, 61
400586726, 2014-12-14, Temple, (6-4; 0-2 away), 26, 36, 0, 62, Villanova, (10-0; 5-0 home), 39, 46, 0, 85
400588373, 2014-12-14, Butler, (8-2; 1-1 away), 34, 21, 0, 55, Tennessee, (4-3; 3-0 home), 25, 42, 0, 67
400585741, 2014-12-14, PV A&M, (1-9; 0-7 away), 26, 25, 0, 51, Texas Tech, (7-1; 7-0 home), 32, 47, 0, 79
400585962, 2014-12-14, Montana State, (3-6; 0-5 away), 37, 24, 0, 61, Wyoming, (9-2; 9-0 home), 37, 33, 0, 70
400588684, 2014-12-14, Non D-I School, NA, 29, 24, 0, 53, N Kentucky, (4-5; 3-2 home), 49, 58, 0, 107
400588685, 2014-12-14, FIU, (6-4; 2-3 away), 28, 41, 0, 69, FGCU, (8-2; 4-1 home), 32, 31, 0, 63
400589307, 2014-12-14, Campbell, (3-6; 1-5 away), 23, 24, 0, 47, Charleston, (5-4; 3-1 home), 26, 32, 0, 58
400591392, 2014-12-14, NC A&T, (1-10; 0-2 MEAC), 21, 27, 0, 48, Old Dominion, (7-1; 4-0 home), 41, 44, 0, 85
400588372, 2014-12-14, Fordham, (3-5; 0-3 away), 28, 25, 0, 53, St John's, (8-1; 6-0 home), 39, 35, 0, 74
400587447, 2014-12-14, Kent State, (6-2; 3-0 away), 35, 16, 9, 60, AR-Little Rock, (4-4; 4-2 home), 32, 19, 4, 55
400587848, 2014-12-14, Alabama A&M, (1-6; 0-5 away), 20, 35, 0, 55, VT, (5-4; 4-2 home), 36, 29, 0, 65
400589309, 2014-12-14, Coast Carolina, (8-2; 2-2 away), 35, 22, 0, 57, S Carolina St, (3-7; 2-0 MEAC), 22, 21, 0, 43
400591277, 2014-12-14, Dartmouth, (3-5; 1-4 away), 28, 39, 0, 67, Jacksonville St, (6-4; 5-0 home), 41, 38, 0, 79
400591775, 2014-12-14, NJIT, (4-7; 2-6 away), 31, 18, 0, 49, LIU Brooklyn, (2-6; 1-2 home), 32, 33, 0, 65
400596019, 2014-12-14, Non D-I School, NA, 39, 29, 0, 68, Sacred Heart, (5-4; 3-1 home), 57, 47, 0, 104
400586362, 2014-12-14, Illinois State, (5-3; 2-0 away), 33, 45, 0, 78, DePaul, (6-3; 5-2 home), 30, 42, 0, 72
400586727, 2014-12-14, Coppin State, (1-9; 0-2 MEAC), 39, 46, 0, 85, UConn, (4-3; 2-2 home), 51, 55, 0, 106
400587842, 2014-12-14, LA Tech, (7-3; 2-3 away), 31, 38, 0, 69, Syracuse, (6-3; 5-1 home), 32, 39, 0, 71
400587846, 2014-12-14, Auburn, (3-5; 0-3 away), 23, 38, 0, 61, Clemson, (6-3; 4-2 home), 29, 43, 0, 72
400587847, 2014-12-14, Wofford, (8-2; 2-2 away), 28, 27, 0, 55, NC State, (8-2; 1-0 ACC), 33, 21, 0, 54
400588683, 2014-12-14, Jacksonville, (2-9; 0-7 away), 24, 10, 0, 34, Florida, (6-4; 5-1 home), 34, 45, 0, 79
400591391, 2014-12-14, North Texas, (4-4; 0-3 away), 20, 28, 0, 48, SF Austin, (7-3; 4-1 home), 26, 33, 0, 59
400586363, 2014-12-14, Chicago State, (2-9; 0-6 away), 21, 29, 0, 50, S Illinois, (6-4; 3-0 home), 27, 38, 0, 65
400585744, 2014-12-14, Marshall, (3-6; 0-1 away), 27, 39, 0, 66, West Virginia, (9-1; 3-1 home), 27, 42, 0, 69
400589308, 2014-12-14, Longwood, (3-7; 0-5 away), 27, 26, 0, 53, UMBC, (1-9; 1-2 home), 27, 31, 0, 58
400587448, 2014-12-14, Miami (OH), (2-7; 0-2 away), 16, 43, 0, 59, Wright State, (7-4; 4-0 home), 30, 38, 0, 68
400587843, 2014-12-14, UNC-Wilmington, (3-3; 2-3 away), 24, 33, 0, 57, Louisville, (9-0; 7-0 home), 32, 36, 0, 68
400585742, 2014-12-14, Southern, (2-8; 0-5 away), 35, 43, 0, 78, Iowa State, (8-1; 6-0 home), 42, 46, 0, 88
400585743, 2014-12-14, Savannah State, (3-8; 0-8 away), 23, 30, 0, 53, Kansas State, (6-4; 5-0 home), 30, 43, 0, 73
400585966, 2014-12-14, Montana, (3-6; 1-5 away), 25, 33, 0, 58, Milwaukee, (5-6; 4-2 home), 37, 36, 0, 73
400587844, 2014-12-14, Samford, (3-8; 0-2 Southern), 41, 27, 0, 68, Wake Forest, (5-5; 0-1 ACC), 47, 39, 0, 86
400595412, 2014-12-14, Miss Valley St, (1-8; 0-8 away), 26, 23, 0, 49, Northwestern, (6-3; 4-1 home), 47, 54, 0, 101
400585964, 2014-12-14, Southern Utah, (2-5; 1-3 away), 32, 28, 0, 60, Boise State, (8-2; 4-0 home), 38, 41, 0, 79
400585965, 2014-12-14, E Washington, (8-2; 3-2 away), 42, 35, 0, 77, Washington, (8-0; 3-0 home), 31, 50, 0, 81
400587260, 2014-12-14, W Michigan, (6-3; 2-2 away), 39, 41, 0, 80, Pacific, (6-4; 2-1 home), 35, 37, 0, 72
400589306, 2014-12-14, UNC Asheville, (4-5; 1-4 away), 35, 36, 0, 71, UAB, (4-6; 4-3 home), 41, 38, 0, 79
400595413, 2014-12-14, Oakland, (4-6; 1-3 away), 31, 30, 0, 61, Michigan State, (7-3; 4-0 home), 44, 43, 0, 87
400585963, 2014-12-14, Portland, (7-2; 2-0 away), 44, 36, 0, 80, Sacramento St, (5-4; 4-1 home), 39, 36, 0, 75
400586927, 2014-12-15, IUPUI, (2-8; 1-5 away), 19, 28, 0, 47, Howard, (6-6; 1-1 MEAC), 28, 29, 0, 57
400587849, 2014-12-15, Elon, (5-5; 1-3 away), 21, 41, 0, 62, Duke, (9-0; 5-0 home), 36, 39, 0, 75
400586728, 2014-12-15, Ga Southern, (5-2; 1-2 away), 32, 36, 0, 68, USF, (5-4; 4-1 home), 28, 35, 0, 63
400587850, 2014-12-15, Appalachian St, (3-4; 2-3 away), 25, 32, 0, 57, Georgia Tech, (7-2; 4-1 home), 36, 34, 0, 70
400588686, 2014-12-15, Tenn Tech, (6-4; 1-4 away), 32, 50, 0, 82, North Florida, (6-4; 2-1 home), 41, 39, 0, 80
400597731, 2014-12-15, Mount Vernon Nazaren,  , 16, 24, 0, 40, Cleveland State, (5-5; 4-1 home), 43, 43, 0, 86
400598578, 2014-12-15, Non D-I School, NA, 26, 23, 0, 49, Norfolk State, (7-5; 2-0 MEAC), 34, 54, 0, 88
400595226, 2014-12-15, Troy, (4-4; 0-3 away), 23, 47, 0, 70, Austin Peay, (3-7; 2-1 home), 30, 43, 0, 73
400595604, 2014-12-15, Non D-I School, NA, 31, 23, 0, 54, Lamar, (3-6; 2-0 home), 63, 65, 0, 128
400596341, 2014-12-15, UT Martin, (6-2; 5-2 away), 33, 32, 16, 81, UIC, (3-8; 3-3 home), 25, 40, 13, 78
400599462, 2014-12-15, NC Central, (6-5; 2-0 MEAC), 18, 29, 0, 47, Memphis, (4-4; 3-2 home), 42, 39, 0, 81
400610534, 2014-12-15, Missouri State, (5-4; 2-2 away), 33, 28, 0, 61, Oral Roberts, (4-4; 3-0 home), 32, 48, 0, 80
400586364, 2014-12-15, Jackson State, (1-9; 1-8 away), 26, 40, 0, 66, Drake, (2-8; 2-2 home), 36, 40, 0, 76
400591393, 2014-12-15, UTSA, (4-4; 2-1 away), 25, 48, 0, 73, Texas A&M-CC, (3-5; 2-2 home), 29, 31, 0, 60
400598834, 2014-12-15, Texas Southern, (1-8; 0-8 away), 16, 38, 0, 54, Gonzaga, (10-1; 6-0 home), 40, 54, 0, 94
400590759, 2014-12-15, Bethune-Cookman, (3-8; 0-1 MEAC), 27, 23, 0, 50, Grand Canyon, (5-6; 4-3 home), 28, 32, 0, 60
400587261, 2014-12-15, Cal Poly, (4-4; 1-4 away), 34, 44, 0, 78, San Francisco, (5-5; 4-2 home), 27, 44, 0, 71
400587262, 2014-12-15, South Alabama, (2-5; 0-4 away), 33, 35, 0, 68, Pepperdine, (6-2; 4-0 home), 34, 44, 0, 78
400590760, 2014-12-15, Non D-I School, NA, 25, 33, 0, 58, Seattle, (5-5; 3-4 home), 37, 47, 0, 84
400593223, 2014-12-15, Grambling St, (2-6; 0-6 away), 9, 34, 0, 43, Oregon State, (7-2; 6-0 home), 41, 30, 0, 71
400585745, 2014-12-16, Oral Roberts, (4-5; 0-4 away), 24, 29, 0, 53, Oklahoma, (7-2; 4-0 home), 39, 46, 0, 85
400587851, 2014-12-16, UNC, (7-3; 1-1 away), 40, 39, 0, 79, UNC Greensboro, (4-7; 1-0 Southern), 19, 37, 0, 56
400587102, 2014-12-16, American U, (6-4; 3-4 away), 36, 23, 9, 68, La Salle, (5-5; 3-2 home), 23, 36, 7, 66
400587103, 2014-12-16, Susqueha,  , 34, 32, 0, 66, Lafayette, (7-2; 4-0 home), 58, 33, 0, 91
400587449, 2014-12-16, Drexel, (2-7; 0-2 away), 32, 38, 0, 70, Buffalo, (6-2; 2-0 home), 38, 42, 0, 80
400588687, 2014-12-16, Stetson, (3-8; 0-6 away), 25, 44, 0, 69, FAU, (5-3; 4-0 home), 45, 34, 0, 79
400588688, 2014-12-16, N Kentucky, (4-6; 1-4 away), 42, 39, 0, 81, Chattanooga, (6-5; 1-0 Southern), 54, 39, 0, 93
400589125, 2014-12-16, East Tenn St, (6-2; 1-1 Southern), 33, 30, 0, 63, E Kentucky, (5-4; 3-2 home), 26, 34, 0, 60
400589127, 2014-12-16, Samford, (4-8; 0-2 Southern), 33, 48, 0, 81, Presbyterian, (4-7; 4-2 home), 34, 37, 0, 71
400589310, 2014-12-16, Non D-I School, NA, 25, 29, 0, 54, Radford, (6-4; 3-0 home), 44, 48, 0, 92
400591134, 2014-12-16, Belmont, (7-4; 3-2 away), 21, 30, 0, 51, VCU, (7-3; 4-1 home), 34, 44, 0, 78
400591395, 2014-12-16, Non D-I School, NA, 35, 41, 0, 76, Marshall, (4-6; 4-4 home), 40, 50, 0, 90
400595924, 2014-12-16, UC Irvine, (4-5; 1-4 away), 26, 36, 0, 62, Morgan State, (2-8; 0-2 MEAC), 25, 38, 0, 63
400586365, 2014-12-16, Non D-I School, NA, 31, 37, 0, 68, Indiana State, (4-6; 3-2 home), 37, 41, 0, 78
400589126, 2014-12-16, Dartmouth, (4-5; 2-4 away), 33, 34, 0, 67, Mercer, (5-5; 1-0 Southern), 22, 29, 0, 51
400585968, 2014-12-16, E Washington, (8-3; 3-3 away), 31, 21, 0, 52, Sam Houston, (6-4; 4-0 home), 42, 34, 0, 76
400595605, 2014-12-16, Non D-I School, NA, 40, 35, 0, 75, Nicholls State, (2-5; 2-0 home), 39, 42, 0, 81
400585747, 2014-12-16, Lipscomb, (4-6; 1-5 away), 32, 29, 0, 61, Texas, (9-1; 6-0 home), 58, 48, 0, 106
400586729, 2014-12-16, Houston Baptist, (4-4; 1-4 away), 35, 41, 0, 76, Houston, (5-1; 4-0 home), 31, 52, 0, 83
400586928, 2014-12-16, Akron, (6-4; 0-2 away), 19, 27, 0, 46, North Dakota St, (6-4; 5-0 home), 22, 33, 0, 55
400587450, 2014-12-16, Miss Valley St, (1-9; 0-9 away), 33, 31, 0, 64, N Illinois, (4-3; 4-0 home), 36, 35, 0, 71
400589311, 2014-12-16, UNC Asheville, (4-6; 1-5 away), 27, 28, 0, 55, Jacksonville St, (7-4; 6-0 home), 33, 31, 0, 64
400591014, 2014-12-16, Non D-I School, NA, 23, 27, 0, 50, Southern, (3-8; 3-1 home), 57, 57, 0, 114
400591394, 2014-12-16, Charleston, (5-5; 1-2 away), 42, 34, 9, 85, Charlotte, (5-4; 1-1 home), 30, 46, 14, 90
400595606, 2014-12-16, Non D-I School, NA, 27, 41, 0, 68, McNeese State, (5-3; 5-0 home), 31, 53, 0, 84
400599465, 2014-12-16, Savannah State, (3-9; 0-9 away), 23, 44, 0, 67, Tulane, (8-1; 7-1 home), 27, 48, 0, 75
400586366, 2014-12-16, Tennessee St, (2-8; 0-5 away), 27, 31, 0, 58, S Illinois, (7-4; 4-0 home), 32, 33, 0, 65
400595227, 2014-12-16, Non D-I School, NA, 20, 33, 0, 53, UL Monroe, (5-4; 4-0 home), 33, 45, 0, 78
400593224, 2014-12-16, Oakland, (4-7; 1-4 away), 25, 39, 0, 64, Arizona, (11-0; 8-0 home), 45, 56, 0, 101
400586367, 2014-12-16, Alabama, (6-3; 0-2 away), 25, 27, 0, 52, Wichita State, (8-1; 6-0 home), 24, 29, 0, 53
400585746, 2014-12-16, Mid Tennessee, (5-5; 2-2 away), 21, 23, 0, 44, Oklahoma State, (9-1; 6-0 home), 40, 28, 0, 68
400588374, 2014-12-16, Arizona State, (6-4; 0-2 away), 32, 39, 0, 71, Marquette, (5-4; 3-2 home), 43, 35, 0, 78
400589128, 2014-12-16, W Carolina, (3-7; 0-1 Southern), 44, 35, 0, 79, Vanderbilt, (7-2; 6-1 home), 41, 58, 0, 99
400591396, 2014-12-16, SE Louisiana, (2-8; 0-8 away), 20, 42, 0, 62, UTEP, (6-3; 4-0 home), 31, 49, 0, 80
400585967, 2014-12-16, N Arizona, (4-6; 1-4 away), 40, 33, 0, 73, Saint Mary's, (6-2; 5-2 home), 31, 40, 0, 71
400591397, 2014-12-17, Langston,  , 23, 42, 0, 65, North Texas, (5-4; 5-1 home), 34, 44, 0, 78
400596033, 2014-12-17, Delaware State, (5-6; 4-5 away), 36, 36, 0, 72, St Francis (BKN), (3-7; 1-2 home), 26, 38, 0, 64
400595415, 2014-12-17, NC A&T, (1-11; 0-2 MEAC), 26, 29, 0, 55, OSU, (9-1; 8-0 home), 39, 58, 0, 97
400586186, 2014-12-17, Manhattan, (2-7; 1-1 MAAC), 21, 35, 0, 56, Pitt, (7-3; 4-0 home), 26, 39, 0, 65
400587451, 2014-12-17, Robert Morris, (3-7; 1-4 away), 28, 29, 0, 57, Toledo, (6-4; 5-1 home), 40, 43, 0, 83
400587452, 2014-12-17, JMU, (7-3; 1-2 away), 30, 42, 0, 72, Ball State, (3-5; 3-1 home), 23, 29, 0, 52
400587453, 2014-12-17, Longwood, (3-8; 0-6 away), 21, 39, 0, 60, Miami (OH), (3-7; 3-3 home), 31, 40, 0, 71
400587852, 2014-12-17, Tennessee, (4-4; 0-1 away), 27, 45, 0, 72, NC State, (9-2; 1-0 ACC), 39, 44, 0, 83
400587853, 2014-12-17, North Florida, (6-5; 2-4 away), 29, 48, 0, 77, FSU, (5-5; 0-1 ACC), 43, 50, 0, 93
400588690, 2014-12-17, Kennesaw St, (4-7; 1-6 away), 46, 44, 0, 90, Youngstown St, (7-6; 3-2 home), 41, 43, 0, 84
400589130, 2014-12-17, Charleston So, (5-4; 1-3 away), 26, 32, 0, 58, Wofford, (9-2; 5-0 home), 27, 37, 0, 64
400589312, 2014-12-17, Gardner-Webb, (6-5; 1-3 away), 43, 22, 0, 65, Jacksonville, (3-9; 3-2 home), 32, 36, 0, 68
400589314, 2014-12-17, SIU-ED, (1-7; 0-5 away), 30, 35, 0, 65, Campbell, (4-6; 3-1 home), 37, 33, 0, 70
400589315, 2014-12-17, Non D-I School, NA, 22, 26, 0, 48, High Point, (7-3; 3-0 home), 47, 59, 0, 106
400591135, 2014-12-17, St Francis (PA), (5-4; 2-4 away), 40, 27, 0, 67, Duquesne, (3-5; 2-2 home), 27, 25, 0, 52
400595228, 2014-12-17, Arkansas State, (3-4; 2-2 away), 35, 34, 0, 69, Miss St, (5-4; 4-1 home), 27, 28, 0, 55
400598579, 2014-12-17, Non D-I School, NA, 20, 32, 0, 52, NC Central, (7-5; 2-0 MEAC), 62, 46, 0, 108
400598580, 2014-12-17, Hampton, (4-6; 2-0 MEAC), 25, 30, 0, 55, Illinois, (8-3; 6-0 home), 37, 36, 0, 73
400611174, 2014-12-17, Catawba,  , 37, 32, 0, 69, George Mason, (3-6; 3-2 home), 45, 54, 0, 99
400586734, 2014-12-17, Detroit, (6-5; 1-3 away), 27, 43, 0, 70, UCF, (6-4; 6-2 home), 35, 40, 0, 75
400589313, 2014-12-17, Liberty, (4-6; 0-3 away), 23, 39, 8, 70, UNC-Wilmington, (4-3; 2-0 home), 31, 31, 11, 73
400585748, 2014-12-17, S Carolina St, (3-8; 2-0 MEAC), 23, 16, 0, 39, Texas Tech, (8-1; 8-0 home), 53, 48, 0, 101
400585969, 2014-12-17, N Colorado, (4-5; 0-5 away), 32, 50, 0, 82, Omaha, (5-5; 4-0 home), 46, 46, 0, 92
400586368, 2014-12-17, UT Martin, (6-3; 5-3 away), 18, 36, 0, 54, Illinois State, (6-3; 2-2 home), 28, 36, 0, 64
400586369, 2014-12-17, Abil Christian, (4-5; 0-4 away), 29, 15, 0, 44, Loyola (CHI), (7-2; 4-1 home), 38, 45, 0, 83
400586370, 2014-12-17, Missouri State, (5-5; 2-3 away), 28, 42, 0, 70, Tulsa, (6-5; 4-2 home), 29, 45, 0, 74
400586730, 2014-12-17, AR-Pine Bluff, (2-8; 1-6 away), 27, 18, 16, 61, Houston, (5-2; 4-1 home), 16, 29, 11, 56
400586731, 2014-12-17, USC Upstate, (8-4; 2-3 away), 29, 44, 0, 73, Memphis, (5-4; 4-2 home), 42, 41, 0, 83
400586732, 2014-12-17, UIC, (3-9; 0-4 away), 15, 31, 0, 46, SMU, (7-3; 7-1 home), 29, 38, 0, 67
400586929, 2014-12-17, Texas A&M-CC, (3-6; 1-3 away), 18, 55, 0, 73, Denver, (5-5; 4-1 home), 36, 47, 0, 83
400587455, 2014-12-17, Cent Michigan, (7-1; 1-1 away), 36, 44, 0, 80, Northwestern, (6-4; 4-2 home), 29, 38, 0, 67
400590763, 2014-12-17, UT Pan American, (5-5; 1-4 away), 26, 43, 0, 69, Saint Louis, (7-4; 5-2 home), 36, 39, 0, 75
400590764, 2014-12-17, Chicago State, (2-10; 0-7 away), 33, 27, 0, 60, W Kentucky, (5-4; 3-1 home), 37, 38, 0, 75
400591065, 2014-12-17, Alcorn State, (1-8; 0-6 away), 24, 32, 0, 56, Murray State, (7-4; 4-1 home), 40, 54, 0, 94
400591398, 2014-12-17, Georgia State, (6-3; 2-3 away), 27, 23, 4, 54, Old Dominion, (8-1; 5-0 home), 23, 27, 8, 58
400595229, 2014-12-17, Texas State, (5-3; 1-3 away), 30, 30, 0, 60, SF Austin, (8-3; 5-1 home), 27, 39, 0, 66
400595230, 2014-12-17, Non D-I School, NA, 43, 33, 0, 76, LA-Lafayette, (6-4; 5-0 home), 64, 51, 0, 115
400596342, 2014-12-17, Morehead State, (4-9; 1-6 away), 27, 23, 0, 50, Green Bay, (8-2; 4-0 home), 36, 30, 0, 66
400586733, 2014-12-17, San Diego State, (7-3; 0-2 away), 20, 37, 5, 62, Cincinnati, (7-2; 6-0 home), 22, 35, 14, 71
400587454, 2014-12-17, E Michigan, (8-2; 1-2 away), 19, 27, 0, 46, Michigan State, (8-3; 5-0 home), 34, 32, 0, 66
400585749, 2014-12-17, New Mexico St, (4-7; 0-7 away), 24, 31, 0, 55, Baylor, (9-1; 6-0 home), 32, 34, 0, 66
400587264, 2014-12-17, Loyola Mary, (3-6; 0-4 away), 31, 27, 0, 58, Stanford, (6-2; 5-0 home), 27, 40, 0, 67
400589316, 2014-12-17, Winthrop, (4-5; 1-4 away), 32, 30, 0, 62, Auburn, (4-5; 3-1 home), 40, 40, 0, 80
400590762, 2014-12-17, Incarnate Word, (7-1; 3-1 away), 39, 43, 0, 82, Grand Canyon, (5-7; 4-4 home), 50, 30, 0, 80
400587263, 2014-12-17, Howard, (6-7; 1-1 MEAC), 23, 22, 0, 45, Pepperdine, (7-2; 5-0 home), 28, 25, 0, 53
400591601, 2014-12-17, Cent Arkansas, (0-9; 0-7 away), 30, 25, 0, 55, New Mexico, (7-3; 5-1 home), 35, 41, 0, 76
400595925, 2014-12-17, Northeastern, (6-3; 1-2 away), 31, 27, 0, 58, Cal Poly, (5-4; 3-0 home), 17, 43, 0, 60
400587265, 2014-12-17, Portland, (7-3; 2-1 away), 29, 33, 11, 73, UNLV, (7-2; 4-0 home), 28, 34, 13, 75
400593226, 2014-12-17, Grambling St, (2-7; 0-7 away), 13, 25, 0, 38, Washington, (9-0; 4-0 home), 45, 41, 0, 86
400593225, 2014-12-17, CS Northridge, (3-8; 0-6 away), 30, 26, 0, 56, Oregon, (7-3; 6-1 home), 39, 40, 0, 79
400591402, 2014-12-18, St. Thomas (TX),  , 17, 44, 0, 61, Rice, (3-6; 3-2 home), 33, 39, 0, 72
400587854, 2014-12-18, Cleveland State, (5-6; 1-5 away), 18, 36, 0, 54, UVA, (10-0; 5-0 home), 31, 39, 0, 70
400586188, 2014-12-18, Lehigh, (4-5; 2-2 away), 32, 33, 0, 65, Quinnipiac, (4-5; 0-2 MAAC), 44, 36, 0, 80
400586189, 2014-12-18, Stony Brook, (5-6; 0-6 away), 23, 29, 7, 59, Canisius, (5-4; 2-0 MAAC), 28, 24, 8, 60
400586735, 2014-12-18, Seton Hall, (9-1; 1-1 away), 45, 44, 0, 89, USF, (5-5; 4-2 home), 33, 36, 0, 69
400586737, 2014-12-18, Temple, (7-4; 1-2 away), 37, 45, 0, 82, Delaware, (0-8; 0-3 home), 21, 41, 0, 62
400588691, 2014-12-18, Ga Southern, (6-2; 2-2 away), 33, 43, 0, 76, Stetson, (3-9; 3-3 home), 40, 27, 0, 67
400589131, 2014-12-18, Wright State, (8-4; 4-2 away), 31, 38, 0, 69, W Carolina, (3-8; 0-1 Southern), 24, 32, 0, 56
400591136, 2014-12-18, South Alabama, (2-6; 0-5 away), 25, 29, 0, 54, Richmond, (5-4; 5-0 home), 28, 37, 0, 65
400591326, 2014-12-18, Yale, (9-3; 4-3 away), 28, 29, 0, 57, UVM, (5-5; 1-0 Am. East), 24, 32, 0, 56
400591400, 2014-12-18, FIU, (6-5; 2-3 away), 25, 33, 0, 58, LIU Brooklyn, (3-6; 1-2 home), 30, 39, 0, 69
400585973, 2014-12-18, Idaho State, (3-6; 1-3 away), 25, 35, 12, 72, South Dakota St, (7-3; 5-0 home), 30, 30, 15, 75
400586187, 2014-12-18, Morgan State, (2-9; 0-2 MEAC), 27, 21, 0, 48, Rider, (6-6; 1-1 MAAC), 29, 33, 0, 62
400591401, 2014-12-18, Nicholls State, (2-6; 0-6 away), 28, 26, 0, 54, LA Tech, (8-3; 6-0 home), 42, 37, 0, 79
400586736, 2014-12-18, UConn, (4-4; 0-0 away), 25, 31, 0, 56, Duke, (10-0; 5-0 home), 30, 36, 0, 66
400586371, 2014-12-18, Non D-I School, NA, 26, 12, 0, 38, Bradley, (4-6; 4-2 home), 43, 37, 0, 80
400589317, 2014-12-18, Coast Carolina, (8-3; 2-3 away), 41, 27, 0, 68, Ole Miss, (7-3; 3-3 home), 28, 43, 0, 71
400591041, 2014-12-18, Southern Miss, (5-4; 0-3 away), 16, 30, 0, 46, Jackson State, (2-9; 1-1 home), 38, 28, 0, 66
400591399, 2014-12-18, Appalachian St, (3-5; 2-4 away), 32, 33, 0, 65, Charlotte, (6-4; 2-1 home), 27, 48, 0, 75
400596343, 2014-12-18, Non D-I School, NA, 16, 36, 0, 52, Austin Peay, (4-7; 3-1 home), 35, 41, 0, 76
400585970, 2014-12-18, Montana State, (3-7; 0-6 away), 26, 27, 0, 53, South Dakota, (4-8; 2-1 home), 27, 28, 0, 55
400591403, 2014-12-18, LSU, (8-2; 2-0 away), 33, 46, 0, 79, UAB, (4-7; 4-4 home), 39, 31, 0, 70
400586372, 2014-12-18, Ohio, (3-4; 0-2 away), 38, 31, 0, 69, Evansville, (8-2; 4-1 home), 36, 33, 12, 81
400585971, 2014-12-18, Non D-I School, NA, 18, 21, 0, 39, Idaho, (5-5; 4-1 home), 49, 37, 0, 86
400585972, 2014-12-18, Portland State, (5-4; 2-4 away), 22, 18, 0, 40, San Francisco, (6-5; 5-2 home), 46, 31, 0, 77
400587266, 2014-12-18, Nevada, (2-8; 0-3 away), 17, 48, 0, 65, Pacific, (7-4; 3-1 home), 35, 34, 0, 69
400588375, 2014-12-18, DePaul, (6-4; 1-2 away), 28, 31, 0, 59, Oregon State, (8-2; 7-0 home), 48, 42, 0, 90
400595926, 2014-12-18, Non D-I School, NA, 17, 33, 0, 50, CS Fullerton, (5-7; 2-1 home), 30, 42, 0, 72
400590765, 2014-12-18, CSU Bakersfield, (1-9; 0-4 away), 18, 38, 0, 56, Utah State, (5-4; 3-1 home), 20, 37, 0, 57
400597832, 2014-12-19, Wilberforce,  , 29, 42, 0, 71, Youngstown St, (8-6; 4-2 home), 42, 50, 0, 92
400591042, 2014-12-19, Jackson State, (2-10; 1-9 away), 18, 31, 0, 49, Tulane, (9-1; 8-1 home), 25, 31, 0, 56
400586190, 2014-12-19, Siena, (3-6; 1-1 MAAC), 29, 37, 0, 66, Radford, (7-4; 4-0 home), 38, 38, 0, 76
400587856, 2014-12-19, E Kentucky, (6-4; 3-2 away), 27, 45, 0, 72, Miami (FL), (9-2; 4-2 home), 25, 19, 0, 44
400587267, 2014-12-19, Saint Mary's, (6-3; 1-1 away), 33, 14, 0, 47, St John's, (9-1; 7-0 home), 18, 35, 0, 53
400585975, 2014-12-19, N Arizona, (4-7; 1-5 away), 20, 42, 0, 62, Norfolk State, (8-5; 2-0 MEAC), 38, 43, 0, 81
400586191, 2014-12-19, Niagara, (1-7; 1-1 MAAC), 28, 34, 0, 62, Buffalo, (7-2; 3-0 home), 38, 50, 0, 88
400587104, 2014-12-19, Case Western Reserve,  , 36, 29, 0, 65, Bucknell, (5-6; 3-2 home), 38, 50, 0, 88
400587456, 2014-12-19, NC A&T, (1-12; 0-2 MEAC), 25, 32, 0, 57, Kent State, (7-2; 4-2 home), 32, 39, 0, 71
400587457, 2014-12-19, N Illinois, (4-4; 0-4 away), 19, 27, 9, 55, Dartmouth, (5-5; 3-1 home), 33, 13, 12, 58
400587458, 2014-12-19, Non D-I School, NA, 28, 32, 0, 60, Cent Michigan, (8-1; 7-0 home), 51, 46, 0, 97
400587855, 2014-12-19, Clemson, (6-4; 0-1 away), 30, 15, 0, 45, South Carolina, (6-3; 4-1 home), 28, 40, 0, 68
400588693, 2014-12-19, North Florida, (7-5; 3-4 away), 38, 45, 0, 83, Florida A&M, (0-10; 0-1 MEAC), 21, 44, 0, 65
400588694, 2014-12-19, N Kentucky, (5-6; 2-4 away), 49, 34, 0, 83, Morehead State, (4-10; 2-3 home), 27, 33, 0, 60
400589318, 2014-12-19, Non D-I School, NA, 34, 37, 0, 71, Gardner-Webb, (7-5; 5-0 home), 52, 39, 0, 91
400589319, 2014-12-19, Non D-I School, NA, 35, 30, 0, 65, Liberty, (5-6; 5-1 home), 51, 43, 0, 94
400591404, 2014-12-19, MD-E Shore, (5-8; 1-1 MEAC), 26, 17, 0, 43, Old Dominion, (9-1; 6-0 home), 31, 29, 0, 60
400595927, 2014-12-19, Non D-I School, NA, 18, 28, 0, 46, UCSB, (5-5; 3-1 home), 34, 35, 0, 69
400596344, 2014-12-19, Tennessee St, (2-9; 0-6 away), 24, 30, 0, 54, Hampton, (5-6; 2-0 MEAC), 29, 37, 0, 66
400597303, 2014-12-19, Non D-I School, NA, 21, 28, 0, 49, Alabama, (7-3; 6-0 home), 34, 35, 0, 69
400597304, 2014-12-19, Tenn Tech, (6-5; 1-5 away), 32, 26, 0, 58, Tennessee, (5-4; 4-0 home), 26, 35, 0, 61
400597943, 2014-12-19, Non D-I School, NA, 16, 30, 0, 46, William & Mary, (6-3; 5-0 home), 46, 40, 0, 86
400589132, 2014-12-19, Bethune-Cookman, (3-9; 0-1 MEAC), 24, 22, 0, 46, Mercer, (6-5; 1-0 Southern), 33, 34, 0, 67
400586930, 2014-12-19, South Dakota St, (8-3; 1-2 away), 28, 25, 0, 53, CSU Bakersfield, (1-10; 1-3 home), 24, 25, 0, 49
400588695, 2014-12-19, Furman, (2-7; 1-0 Southern), 34, 44, 0, 78, FGCU, (9-2; 5-1 home), 38, 45, 0, 83
400585974, 2014-12-19, Dickinson State,  , 13, 35, 0, 48, North Dakota, (4-6; 2-0 home), 33, 45, 0, 78
400585976, 2014-12-19, Southern Utah, (2-6; 1-4 away), 20, 37, 0, 57, Loyola (CHI), (8-2; 5-1 home), 38, 35, 0, 73
400588692, 2014-12-19, Lipscomb, (4-7; 1-6 away), 27, 28, 0, 55, Princeton, (4-8; 3-1 home), 44, 33, 0, 77
400589133, 2014-12-19, Chattanooga, (6-6; 1-0 Southern), 20, 38, 0, 58, Mid Tennessee, (6-5; 4-1 home), 29, 39, 0, 68
400589320, 2014-12-19, Winthrop, (4-6; 1-5 away), 32, 39, 0, 71, SE Louisiana, (3-8; 2-0 home), 44, 37, 0, 81
400590766, 2014-12-19, Seattle, (5-6; 1-2 away), 21, 36, 0, 57, Minnesota, (9-2; 7-0 home), 43, 49, 0, 92
400595231, 2014-12-19, Non D-I School, NA, 27, 44, 0, 71, UL Monroe, (6-4; 5-0 home), 31, 45, 0, 76
400595607, 2014-12-19, Non D-I School, NA, 24, 29, 0, 53, Lamar, (4-6; 3-0 home), 48, 32, 0, 80
400586373, 2014-12-19, New Orleans, (3-4; 1-4 away), 21, 35, 0, 56, S Illinois, (7-5; 4-1 home), 29, 23, 0, 52
400585750, 2014-12-19, AR-Pine Bluff, (2-9; 1-7 away), 26, 25, 0, 51, Texas Tech, (9-1; 9-0 home), 35, 37, 0, 72
400586931, 2014-12-19, Colorado State, (11-0; 2-0 away), 34, 51, 0, 85, Denver, (5-6; 4-2 home), 37, 47, 0, 84
400588376, 2014-12-19, Alabama A&M, (1-7; 0-6 away), 20, 29, 0, 49, Marquette, (6-4; 4-2 home), 40, 43, 0, 83
400588377, 2014-12-19, UT Pan American, (5-6; 1-5 away), 27, 33, 0, 60, Creighton, (9-3; 7-1 home), 41, 34, 0, 75
400585977, 2014-12-19, E Washington, (8-4; 3-4 away), 26, 41, 0, 67, Cal, (10-1; 7-0 home), 37, 41, 0, 78
400585978, 2014-12-19, Idaho State, (3-7; 1-4 away), 24, 32, 0, 56, Utah State, (6-4; 4-1 home), 30, 39, 0, 69
400591405, 2014-12-19, Arizona, (12-0; 1-0 away), 28, 32, 0, 60, UTEP, (6-4; 4-1 home), 25, 30, 0, 55
400595928, 2014-12-19, Hawaii, (8-3; 1-0 away), 55, 39, 0, 94, Non D-I School, NA, 32, 31, 0, 63
400587861, 2014-12-20, Louisville, (10-0; 1-0 away), 29, 47, 0, 76, W Kentucky, (5-5; 3-2 home), 24, 43, 0, 67
400586739, 2014-12-20, VCU, (8-3; 2-1 away), 34, 34, 0, 68, Cincinnati, (7-3; 6-1 home), 21, 26, 0, 47
400586741, 2014-12-20, SMU, (8-3; 1-2 away), 30, 32, 0, 62, Michigan, (6-5; 5-3 home), 27, 24, 0, 51
400588378, 2014-12-20, Charlotte, (6-5; 2-2 away), 31, 47, 0, 78, Georgetown, (7-3; 6-1 home), 38, 43, 0, 81
400587863, 2014-12-20, Syracuse, (6-4; 0-2 away), 43, 26, 8, 77, Villanova, (11-0; 6-0 home), 31, 38, 13, 82
400587857, 2014-12-20, OSU, (9-2; 0-1 away), 31, 43, 0, 74, UNC, (8-3; 3-1 home), 43, 39, 0, 82
400586933, 2014-12-20, South Alabama, (2-7; 0-6 away), 30, 29, 6, 65, IUPUI, (3-8; 2-3 home), 30, 29, 12, 71
400587105, 2014-12-20, Mt St Mary's, (3-6; 2-5 away), 19, 26, 0, 45, American U, (7-4; 2-0 home), 21, 25, 0, 46
400587864, 2014-12-20, The Citadel, (4-6; 0-1 Southern), 27, 34, 0, 61, VT, (6-4; 5-2 home), 22, 42, 0, 64
400588379, 2014-12-20, UMass, (6-5; 0-3 away), 24, 41, 0, 65, Providence, (9-3; 7-1 home), 37, 48, 0, 85
400591139, 2014-12-20, UMass Lowell, (6-5; 4-4 away), 24, 39, 0, 63, Duquesne, (4-5; 3-2 home), 40, 39, 0, 79
400591602, 2014-12-20, Abil Christian, (4-6; 0-5 away), 19, 14, 0, 33, Boise State, (9-2; 5-0 home), 34, 43, 0, 77
400586195, 2014-12-20, Belmont, (8-4; 4-2 away), 29, 44, 0, 73, Fairfield, (4-6; 2-0 MAAC), 27, 34, 0, 61
400586738, 2014-12-20, S Carolina St, (4-8; 2-0 MEAC), 32, 39, 0, 71, Houston, (5-3; 4-2 home), 27, 36, 0, 63
400586742, 2014-12-20, USF, (5-6; 1-3 away), 28, 34, 0, 62, FSU, (6-5; 0-1 ACC), 34, 41, 0, 75
400587459, 2014-12-20, Toledo, (7-4; 2-3 away), 47, 36, 0, 83, McNeese State, (5-4; 5-1 home), 30, 39, 0, 69
400587860, 2014-12-20, Vanderbilt, (7-3; 0-1 away), 33, 27, 0, 60, Georgia Tech, (8-2; 5-1 home), 25, 40, 0, 65
400588696, 2014-12-20, Non D-I School, NA, 25, 30, 0, 55, Jacksonville, (4-9; 4-2 home), 36, 48, 0, 84
400589134, 2014-12-20, Elon, (6-5; 2-3 away), 35, 36, 0, 71, UNC Greensboro, (4-8; 1-0 Southern), 29, 35, 0, 64
400589322, 2014-12-20, Non D-I School, NA, 23, 41, 0, 64, Campbell, (5-6; 4-1 home), 44, 46, 0, 90
400589323, 2014-12-20, Non D-I School, NA, 34, 40, 0, 74, Longwood, (4-8; 3-1 home), 51, 55, 0, 106
400591140, 2014-12-20, St Bonaventure, (7-2; 2-1 away), 26, 43, 0, 69, Binghamton, (1-12; 1-4 home), 22, 29, 0, 51
400591327, 2014-12-20, Albany, (4-6; 3-4 away), 29, 35, 0, 64, Yale, (9-4; 3-1 home), 28, 32, 0, 60
400591756, 2014-12-20, Delaware, (0-9; 0-6 away), 38, 36, 0, 74, Fair Dickinson, (4-5; 3-1 home), 36, 40, 0, 76
400595418, 2014-12-20, Missouri, (5-6; 0-1 away), 30, 29, 0, 59, Illinois, (9-3; 6-0 home), 32, 30, 0, 62
400595419, 2014-12-20, Drexel, (2-8; 0-2 away), 28, 40, 0, 68, Penn State, (11-1; 6-0 home), 36, 37, 0, 73
400595420, 2014-12-20, St Francis (PA), (6-4; 3-4 away), 34, 39, 0, 73, Rutgers, (6-5; 3-3 home), 39, 29, 0, 68
400586375, 2014-12-20, E Illinois, (5-6; 1-4 away), 20, 40, 0, 60, Indiana State, (4-7; 3-3 home), 17, 39, 0, 56
400588380, 2014-12-20, Indiana, (9-2; 0-0 away), 38, 44, 0, 82, Butler, (8-3; 5-0 home), 38, 35, 0, 73
400585751, 2014-12-20, Lafayette, (7-3; 3-3 away), 28, 41, 0, 69, Kansas, (9-1; 4-0 home), 45, 51, 0, 96
400586743, 2014-12-20, Oral Roberts, (4-6; 0-5 away), 28, 35, 0, 63, Memphis, (6-4; 5-2 home), 35, 43, 0, 78
400588698, 2014-12-20, UMBC, (2-9; 1-7 away), 37, 29, 0, 66, Kennesaw St, (4-8; 2-2 home), 38, 15, 0, 53
400590768, 2014-12-20, Non D-I School, NA, 22, 32, 0, 54, Chicago State, (3-10; 3-1 home), 23, 53, 0, 76
400591406, 2014-12-20, FAU, (5-4; 1-4 away), 28, 28, 0, 56, St Francis (BKN), (4-7; 2-2 home), 27, 34, 0, 61
400591407, 2014-12-20, Marshall, (4-7; 0-2 away), 32, 26, 0, 58, Arkansas State, (4-4; 2-2 home), 27, 40, 0, 67
400593227, 2014-12-20, Delaware State, (5-7; 4-6 away), 27, 43, 0, 70, Oregon, (8-3; 7-1 home), 38, 45, 0, 83
400595234, 2014-12-20, Non D-I School, NA, 25, 25, 0, 50, UT-Arlington, (6-4; 3-1 home), 39, 50, 0, 89
400595421, 2014-12-20, W Michigan, (6-4; 2-3 away), 28, 33, 0, 61, Northwestern, (7-4; 5-2 home), 25, 42, 0, 67
400595609, 2014-12-20, Arkansas Tech,  , 28, 29, 0, 57, SF Austin, (9-3; 6-1 home), 49, 45, 0, 94
400586376, 2014-12-20, E Michigan, (9-2; 2-2 away), 31, 46, 0, 77, Missouri State, (5-6; 3-1 home), 19, 46, 0, 65
400593228, 2014-12-20, UCLA, (8-4; 0-0 away), 7, 37, 0, 44, Kentucky, (12-0; 10-0 home), 41, 42, 0, 83
400586196, 2014-12-20, Monmouth, (5-5; 2-0 MAAC), 31, 43, 0, 74, Wagner, (2-7; 2-1 home), 26, 40, 0, 66
400587862, 2014-12-20, Oakland, (4-8; 1-5 away), 34, 38, 5, 77, Pitt, (8-3; 5-0 home), 33, 39, 9, 81
400588697, 2014-12-20, USC Upstate, (9-4; 2-3 away), 22, 31, 0, 53, Miss St, (5-5; 4-1 home), 15, 36, 0, 51
400589321, 2014-12-20, Presbyterian, (4-8; 0-4 away), 24, 36, 0, 60, UT Martin, (7-3; 2-0 home), 33, 44, 0, 77
400591015, 2014-12-20, Southern, (3-9; 0-6 away), 19, 20, 0, 39, Wyoming, (10-2; 10-0 home), 28, 29, 0, 57
400591137, 2014-12-20, Davidson, (9-1; 3-0 away), 41, 39, 0, 80, Charleston, (5-6; 3-2 home), 33, 35, 0, 68
400591141, 2014-12-20, Detroit, (6-6; 1-4 away), 36, 19, 0, 55, URI, (7-3; 5-0 home), 34, 35, 0, 69
400591603, 2014-12-20, UC Davis, (8-1; 3-1 away), 35, 46, 0, 81, Air Force, (6-4; 5-1 home), 26, 49, 0, 75
400595233, 2014-12-20, LA-Lafayette, (6-5; 0-4 away), 44, 41, 0, 85, Northwestern St, (4-5; 3-1 home), 50, 39, 0, 89
400595608, 2014-12-20, Houston Baptist, (4-5; 1-5 away), 25, 42, 0, 67, UC Riverside, (6-4; 5-1 home), 37, 41, 0, 78
400598581, 2014-12-20, NC Central, (8-5; 2-0 MEAC), 47, 47, 0, 94, Miss Valley St, (1-10; 0-1 home), 30, 30, 0, 60
400586374, 2014-12-20, Illinois State, (6-4; 2-1 away), 42, 35, 0, 77, Murray State, (8-4; 5-1 home), 37, 52, 0, 89
400585752, 2014-12-20, Iowa State, (9-1; 1-0 away), 36, 47, 0, 83, Drake, (2-9; 2-2 home), 20, 34, 0, 54
400595422, 2014-12-20, Texas Southern, (2-8; 1-8 away), 25, 30, 16, 71, Michigan State, (8-4; 5-1 home), 30, 25, 9, 64
400587858, 2014-12-20, Wake Forest, (5-6; 0-1 ACC), 19, 31, 0, 50, Florida, (7-4; 5-1 home), 28, 35, 0, 63
400589324, 2014-12-20, High Point, (8-3; 3-3 away), 36, 44, 0, 80, JMU, (7-4; 6-2 home), 37, 34, 0, 71
400595232, 2014-12-20, Non D-I School, NA, 35, 21, 0, 56, Texas State, (6-3; 5-0 home), 49, 41, 0, 90
400596020, 2014-12-20, UNH, (6-4; 2-4 away), 25, 35, 0, 60, Sacred Heart, (6-4; 4-1 home), 35, 38, 0, 73
400597930, 2014-12-20, Northeastern, (7-3; 2-2 away), 42, 36, 0, 78, Santa Clara, (5-5; 3-1 home), 33, 39, 0, 72
400587859, 2014-12-20, Purdue, (8-4; 0-1 away), 39, 24, 0, 63, Notre Dame, (11-1; 1-0 ACC), 46, 48, 0, 94
400595610, 2014-12-20, PV A&M, (1-10; 0-8 away), 17, 27, 0, 44, Sam Houston, (7-4; 5-0 home), 34, 27, 0, 61
400588381, 2014-12-20, Xavier, (8-3; 1-1 away), 38, 35, 15, 88, Auburn, (5-5; 4-1 home), 25, 48, 16, 89
400585753, 2014-12-20, Texas A&M, (7-3; 0-1 away), 32, 32, 0, 64, Kansas State, (7-4; 5-0 home), 39, 32, 0, 71
400586192, 2014-12-20, Saint Joe's, (6-4; 2-2 away), 37, 38, 0, 75, Marist, (1-10; 0-2 MAAC), 22, 36, 0, 58
400586193, 2014-12-20, Iona, (6-4; 1-1 MAAC), 38, 43, 0, 81, George Mason, (4-6; 4-2 home), 45, 41, 0, 86
400586194, 2014-12-20, Morgan State, (2-10; 0-2 MEAC), 33, 36, 0, 69, Manhattan, (3-7; 1-1 MAAC), 31, 42, 0, 73
400586740, 2014-12-20, ECU, (5-6; 0-3 away), 23, 31, 0, 54, UNC-Wilmington, (5-3; 3-0 home), 33, 33, 0, 66
400586932, 2014-12-20, Valparaiso, (11-2; 2-1 away), 33, 42, 0, 75, IPFW, (6-4; 4-1 home), 42, 30, 0, 72
400587107, 2014-12-20, Boston U, (3-7; 1-4 away), 32, 30, 0, 62, Dayton, (8-2; 5-0 home), 39, 39, 0, 78
400587268, 2014-12-20, Richmond, (6-4; 0-4 away), 33, 32, 0, 65, Pepperdine, (7-3; 5-0 home), 32, 31, 0, 63
400587460, 2014-12-20, Bluffton,  , 27, 26, 0, 53, Akron, (7-4; 5-1 home), 48, 44, 0, 92
400590770, 2014-12-20, Incarnate Word, (8-1; 4-1 away), 31, 43, 36, 110, UMKC, (4-8; 3-1 home), 44, 30, 30, 104
400591138, 2014-12-20, La Salle, (6-5; 3-0 away), 32, 35, 0, 67, Towson, (7-4; 2-1 home), 15, 38, 0, 53
400591242, 2014-12-20, Hofstra, (7-3; 3-3 away), 38, 39, 0, 77, Columbia, (6-3; 5-1 home), 34, 48, 0, 82
400591736, 2014-12-20, NJIT, (5-7; 3-6 away), 45, 39, 0, 84, Cent Conn St, (2-8; 1-1 home), 38, 38, 0, 76
400585982, 2014-12-20, CSU Bakersfield, (2-10; 0-4 away), 32, 27, 0, 59, Idaho State, (3-8; 2-2 home), 29, 21, 0, 50
400586377, 2014-12-20, Iowa, (8-4; 1-0 away), 29, 15, 0, 44, Northern Iowa, (10-1; 5-0 home), 23, 33, 0, 56
400596345, 2014-12-20, Milwaukee, (5-7; 0-4 away), 28, 28, 0, 56, SIU-ED, (2-7; 2-2 home), 25, 36, 0, 61
400585757, 2014-12-20, LBSU, (5-7; 0-6 away), 34, 34, 0, 68, Texas, (10-1; 7-0 home), 42, 36, 0, 78
400585756, 2014-12-20, UTSA, (4-5; 2-2 away), 26, 31, 0, 57, TCU, (11-0; 8-0 home), 43, 45, 0, 88
400596346, 2014-12-20, SE Missouri St, (5-6; 1-4 away), 28, 39, 0, 67, Arkansas, (8-2; 7-0 home), 45, 39, 0, 84
400585754, 2014-12-20, Oklahoma, (7-3; 1-1 away), 27, 40, 0, 67, Washington, (10-0; 4-0 home), 40, 29, 0, 69
400585979, 2014-12-20, Utah Valley, (3-7; 2-6 away), 28, 33, 0, 61, Weber State, (4-5; 3-1 home), 31, 42, 0, 73
400585981, 2014-12-20, Jacksonville St, (7-5; 1-5 away), 31, 29, 0, 60, N Colorado, (5-5; 5-0 home), 32, 37, 0, 69
400587106, 2014-12-20, Lehigh, (5-5; 3-2 away), 32, 32, 20, 84, Arizona State, (6-5; 6-1 home), 24, 40, 17, 81
400590767, 2014-12-20, New Mexico, (8-3; 2-0 away), 30, 39, 0, 69, New Mexico St, (4-8; 4-1 home), 20, 47, 0, 67
400590769, 2014-12-20, Non D-I School, NA, 34, 21, 0, 55, Grand Canyon, (6-7; 5-4 home), 38, 43, 0, 81
400585755, 2014-12-20, NC State, (9-3; 1-0 ACC), 32, 37, 0, 69, West Virginia, (10-1; 3-1 home), 41, 42, 0, 83
400595929, 2014-12-20, Cal Poly, (5-5; 1-4 away), 20, 30, 0, 50, Gonzaga, (11-1; 6-0 home), 28, 35, 0, 63
400587461, 2014-12-20, Ball State, (3-6; 0-5 away), 26, 31, 0, 57, San Diego State, (8-3; 6-0 home), 36, 34, 0, 70
400587269, 2014-12-20, Fresno State, (4-8; 1-4 away), 24, 44, 0, 68, Pacific, (8-4; 4-1 home), 31, 40, 0, 71
400595611, 2014-12-20, Texas A&M-CC, (4-6; 2-3 away), 23, 52, 0, 75, CS Northridge, (3-9; 2-3 home), 27, 41, 0, 68
400585980, 2014-12-20, Montana State, (3-8; 0-7 away), 29, 31, 0, 60, Portland, (8-3; 4-1 home), 50, 37, 0, 87
400586934, 2014-12-20, South Dakota St, (9-3; 2-2 away), 28, 33, 7, 68, Utah State, (6-5; 4-2 home), 28, 33, 4, 65
400587270, 2014-12-20, Stanford, (6-3; 0-2 away), 35, 42, 0, 77, BYU, (9-3; 5-1 home), 36, 43, 0, 79
400591604, 2014-12-20, Utah, (8-2; 1-1 away), 24, 35, 0, 59, UNLV, (7-3; 4-0 home), 23, 23, 0, 46
400587865, 2014-12-21, Harvard, (7-2; 1-1 away), 8, 19, 0, 27, UVA, (11-0; 6-0 home), 39, 37, 0, 76
400586197, 2014-12-21, Oregon State, (8-3; 1-1 away), 26, 26, 0, 52, Quinnipiac, (5-5; 0-2 MAAC), 32, 28, 0, 60
400587108, 2014-12-21, Maine, (1-9; 0-7 away), 29, 31, 9, 69, Army, (8-2; 4-1 home), 29, 31, 12, 72
400587271, 2014-12-21, San Francisco, (6-6; 0-2 away), 30, 32, 3, 65, Cleveland State, (6-6; 5-1 home), 26, 36, 7, 69
400587462, 2014-12-21, FerrisSt,  , 37, 45, 0, 82, Bowling Green, (6-3; 4-1 home), 36, 32, 0, 68
400589325, 2014-12-21, Coast Carolina, (9-3; 3-3 away), 26, 46, 0, 72, Cent Arkansas, (0-10; 0-3 home), 27, 28, 0, 55
400585758, 2014-12-21, Maryland, (11-1; 1-0 away), 32, 41, 0, 73, Oklahoma State, (9-2; 6-1 home), 27, 37, 0, 64
400586198, 2014-12-21, Holy Cross, (5-4; 1-3 away), 18, 30, 0, 48, Canisius, (6-4; 2-0 MAAC), 24, 43, 0, 67
400586937, 2014-12-21, UT Pan American, (5-7; 1-6 away), 35, 37, 0, 72, Omaha, (6-5; 5-0 home), 41, 36, 0, 77
400587109, 2014-12-21, Loyola (MD), (3-7; 1-5 away), 26, 26, 0, 52, Stony Brook, (6-6; 5-0 home), 26, 41, 0, 67
400588383, 2014-12-21, Creighton, (9-4; 1-2 away), 18, 40, 0, 58, North Texas, (6-4; 6-1 home), 35, 27, 0, 62
400589136, 2014-12-21, W Carolina, (4-8; 0-1 Southern), 28, 38, 0, 66, UNC Asheville, (4-7; 3-2 home), 34, 28, 0, 62
400589326, 2014-12-21, Cornell, (5-5; 2-2 away), 38, 23, 0, 61, Radford, (8-4; 5-0 home), 32, 42, 0, 74
400589327, 2014-12-21, Non D-I School, NA, 32, 40, 0, 72, Winthrop, (5-6; 4-1 home), 44, 56, 0, 100
400591142, 2014-12-21, UVM, (5-6; 1-0 Am. East), 24, 31, 0, 55, Saint Louis, (8-4; 6-2 home), 25, 33, 0, 58
400591410, 2014-12-21, Southern Miss, (5-5; 0-4 away), 29, 26, 0, 55, Georgia State, (7-3; 3-0 home), 38, 30, 0, 68
400595237, 2014-12-21, AR-Little Rock, (4-5; 0-2 away), 29, 17, 0, 46, Green Bay, (9-2; 4-0 home), 33, 33, 0, 66
400586378, 2014-12-21, Alabama State, (3-5; 0-4 away), 49, 14, 0, 63, Evansville, (9-2; 5-1 home), 47, 34, 0, 81
400591408, 2014-12-21, FIU, (6-6; 2-4 away), 31, 38, 0, 69, Hartford, (7-5; 0-1 Am. East), 42, 40, 0, 82
400597819, 2014-12-21, Goshen,  , 25, 30, 0, 55, Valparaiso, (12-2; 5-1 home), 38, 44, 0, 82
400585985, 2014-12-21, South Dakota, (5-8; 3-4 away), 33, 34, 0, 67, Montana, (3-7; 2-2 home), 37, 25, 0, 62
400586935, 2014-12-21, Bryant, (3-5; 2-4 away), 22, 26, 0, 48, Denver, (5-7; 4-3 home), 12, 34, 0, 46
400588699, 2014-12-21, Austin Peay, (4-8; 0-6 away), 24, 39, 0, 63, Lipscomb, (5-7; 4-1 home), 32, 37, 0, 69
400591409, 2014-12-21, Tennessee St, (2-10; 0-7 away), 23, 24, 0, 47, Mid Tennessee, (7-5; 5-1 home), 36, 29, 0, 65
400589135, 2014-12-21, UL Monroe, (6-5; 1-3 away), 28, 22, 0, 50, Samford, (5-8; 0-2 Southern), 32, 32, 0, 64
400597305, 2014-12-21, Non D-I School, NA, 23, 29, 0, 52, South Carolina, (7-3; 5-1 home), 35, 43, 0, 78
400585984, 2014-12-21, N Arizona, (4-8; 1-6 away), 23, 43, 0, 66, Hampton, (6-6; 2-0 MEAC), 31, 44, 0, 75
400587272, 2014-12-21, Non D-I School, NA, 22, 39, 0, 61, San Diego, (7-5; 4-0 home), 43, 28, 0, 71
400587866, 2014-12-21, USC, (7-4; 2-0 away), 37, 38, 0, 75, Boston College, (6-4; 5-1 home), 41, 30, 0, 71
400586379, 2014-12-21, UC Irvine, (5-5; 1-4 away), 22, 33, 0, 55, Bradley, (4-7; 4-2 home), 27, 20, 0, 47
400595236, 2014-12-21, Troy, (5-4; 1-3 away), 25, 40, 0, 65, Nicholls State, (2-7; 2-1 home), 32, 32, 0, 64
400588382, 2014-12-21, Seton Hall, (9-2; 1-2 away), 22, 25, 0, 47, Georgia, (6-3; 5-0 home), 41, 24, 0, 65
400595235, 2014-12-21, Appalachian St, (3-6; 2-5 away), 29, 30, 0, 59, Alabama, (8-3; 7-0 home), 27, 33, 0, 60
400586936, 2014-12-21, North Dakota St, (6-5; 1-4 away), 21, 31, 0, 52, Kent State, (8-2; 4-2 home), 23, 30, 0, 53
400591605, 2014-12-21, San Jose State, (2-10; 0-3 away), 27, 26, 0, 53, Washington St, (5-6; 3-1 home), 42, 40, 0, 82
400591066, 2014-12-21, Alcorn State, (1-9; 0-7 away), 15, 30, 0, 45, UTEP, (7-4; 5-1 home), 39, 39, 0, 78
400585983, 2014-12-21, Sacramento St, (5-5; 1-4 away), 17, 30, 0, 47, Seattle, (6-6; 4-4 home), 30, 36, 0, 66
400587868, 2014-12-22, Stetson, (3-10; 0-7 away), 26, 33, 0, 59, FSU, (7-5; 0-1 ACC), 29, 34, 0, 63
400591219, 2014-12-22, Brown, (6-6; 2-3 away), 36, 31, 0, 67, Cent Conn St, (2-9; 1-2 home), 21, 34, 0, 55
400597783, 2014-12-22, UIC, (3-10; 0-5 away), 16, 30, 0, 46, Northwestern, (8-4; 6-2 home), 31, 32, 0, 63
400749796, 2014-12-22, Bradley, (4-8; 0-2 away), 24, 30, 0, 54, AR-Little Rock, (5-5; 4-2 home), 29, 35, 0, 64
400587463, 2014-12-22, Ohio, (3-5; 0-2 away), 34, 15, 0, 49, G Washington, (7-3; 4-0 home), 43, 34, 0, 77
400585990, 2014-12-22, Southern Utah, (2-7; 1-4 away), 30, 31, 0, 61, AR-Pine Bluff, (3-9; 0-0 home), 26, 44, 0, 70
400588701, 2014-12-22, Elon, (7-5; 3-3 away), 31, 36, 0, 67, Kennesaw St, (4-9; 2-3 home), 40, 25, 0, 65
400591278, 2014-12-22, Dartmouth, (5-6; 2-5 away), 16, 33, 0, 49, Penn State, (12-1; 7-0 home), 41, 28, 0, 69
400749797, 2014-12-22, UC Irvine, (6-5; 1-4 away), 39, 33, 0, 72, Green Bay, (9-3; 4-0 home), 33, 37, 0, 70
400588384, 2014-12-22, DePaul, (6-5; 1-2 away), 33, 35, 0, 68, Colorado, (7-3; 6-1 home), 36, 46, 0, 82
400587273, 2014-12-22, Lewis & Clark,  , 24, 25, 0, 49, Portland, (9-3; 5-1 home), 38, 33, 0, 71
400595612, 2014-12-22, S Carolina St, (4-9; 2-0 MEAC), 30, 29, 0, 59, Abil Christian, (5-6; 4-1 home), 23, 42, 0, 65
400587464, 2014-12-22, Miami (OH), (3-8; 0-3 away), 24, 31, 0, 55, OSU, (10-2; 9-0 home), 46, 47, 0, 93
400585988, 2014-12-22, Idaho, (5-6; 1-4 away), 34, 34, 0, 68, N Kentucky, (6-6; 4-2 home), 40, 41, 0, 81
400586200, 2014-12-22, Manhattan, (4-7; 1-1 MAAC), 30, 41, 0, 71, Fordham, (3-6; 3-2 home), 25, 32, 0, 57
400589138, 2014-12-22, The Citadel, (4-7; 0-1 Southern), 26, 30, 0, 56, Michigan State, (9-4; 6-1 home), 32, 50, 0, 82
400589329, 2014-12-22, Gardner-Webb, (8-5; 2-3 away), 38, 51, 0, 89, Purdue, (8-5; 6-2 home), 38, 46, 0, 84
400595238, 2014-12-22, Non D-I School, NA, 20, 37, 0, 57, Ga Southern, (7-2; 5-0 home), 41, 49, 0, 90
400586748, 2014-12-22, Kansas, (9-2; 1-1 away), 25, 27, 0, 52, Temple, (8-4; 6-0 home), 35, 42, 0, 77
400587467, 2014-12-22, N Illinois, (4-5; 0-5 away), 35, 31, 0, 66, Notre Dame, (12-1; 1-0 ACC), 48, 43, 0, 91
400586199, 2014-12-22, Fairfield, (4-7; 2-0 MAAC), 29, 37, 0, 66, Albany, (5-6; 2-2 home), 34, 43, 0, 77
400586383, 2014-12-22, IPFW, (6-5; 2-4 away), 17, 26, 0, 43, Illinois State, (7-4; 3-2 home), 37, 31, 0, 68
400586744, 2014-12-22, Florida A&M, (0-11; 0-1 MEAC), 29, 28, 0, 57, ECU, (6-6; 5-1 home), 27, 48, 0, 75
400586749, 2014-12-22, SE Louisiana, (3-9; 0-9 away), 29, 36, 0, 65, UCF, (7-4; 7-2 home), 33, 37, 0, 70
400587110, 2014-12-22, Bucknell, (5-7; 1-5 away), 20, 33, 0, 53, Wake Forest, (6-6; 0-1 ACC), 31, 29, 0, 60
400587111, 2014-12-22, Colgate, (3-9; 1-7 away), 13, 30, 0, 43, Syracuse, (7-4; 6-1 home), 43, 35, 0, 78
400587112, 2014-12-22, Towson, (7-5; 3-4 away), 24, 32, 0, 56, Navy, (4-8; 3-3 home), 32, 29, 0, 61
400587867, 2014-12-22, Oakland, (4-9; 1-6 away), 26, 34, 0, 60, Clemson, (7-4; 5-2 home), 36, 34, 0, 70
400587870, 2014-12-22, VMI, (5-7; 1-1 Southern), 27, 47, 0, 74, VT, (7-4; 6-2 home), 51, 36, 0, 87
400588385, 2014-12-22, UT Martin, (7-4; 5-4 away), 23, 14, 0, 37, Butler, (9-3; 6-0 home), 31, 33, 0, 64
400589139, 2014-12-22, East Tenn St, (6-3; 1-1 Southern), 26, 34, 0, 60, VCU, (9-3; 5-1 home), 35, 49, 0, 84
400589141, 2014-12-22, Mercer, (6-6; 1-0 Southern), 15, 39, 0, 54, Tennessee, (6-4; 5-0 home), 27, 37, 0, 64
400589330, 2014-12-22, Liberty, (5-7; 0-4 away), 27, 20, 0, 47, Princeton, (5-8; 4-1 home), 31, 34, 0, 65
400591143, 2014-12-22, MD-E Shore, (6-8; 1-1 MEAC), 45, 37, 0, 82, St Bonaventure, (7-3; 4-2 home), 33, 47, 0, 80
400591411, 2014-12-22, E Kentucky, (6-5; 3-3 away), 30, 36, 0, 66, FAU, (6-4; 5-0 home), 30, 39, 0, 69
400591413, 2014-12-22, William & Mary, (6-4; 1-4 away), 26, 36, 0, 62, Old Dominion, (10-1; 7-0 home), 31, 38, 0, 69
400591776, 2014-12-22, LIU Brooklyn, (4-6; 2-3 away), 38, 26, 9, 73, UNH, (6-5; 4-1 home), 37, 27, 8, 72
400591793, 2014-12-22, Binghamton, (1-13; 0-7 away), 25, 43, 0, 68, Mt St Mary's, (4-6; 2-1 home), 32, 37, 0, 69
400591812, 2014-12-22, Delaware, (0-10; 0-7 away), 30, 51, 0, 81, Robert Morris, (4-7; 2-3 home), 36, 48, 0, 84
400595425, 2014-12-22, New Orleans, (3-5; 1-5 away), 22, 37, 0, 59, Indiana, (10-2; 9-1 home), 44, 35, 0, 79
400597913, 2014-12-22, Norfolk State, (9-5; 2-0 MEAC), 28, 37, 9, 74, JMU, (7-5; 6-3 home), 34, 31, 6, 71
400600053, 2014-12-22, Alabama A&M, (1-8; 0-7 away), 23, 39, 0, 62, W Michigan, (7-4; 3-0 home), 34, 37, 0, 71
400749809, 2014-12-22, North Dakota St, (7-5; 1-4 away), 36, 25, 0, 61, Alcorn State, (1-10; 1-0 home), 18, 32, 0, 50
400588386, 2014-12-22, LBSU, (5-8; 0-7 away), 20, 29, 0, 49, St John's, (10-1; 8-0 home), 24, 42, 0, 66
400585764, 2014-12-22, Wofford, (9-3; 2-3 away), 20, 24, 0, 44, West Virginia, (11-1; 4-1 home), 42, 35, 0, 77
400586746, 2014-12-22, Columbia, (6-4; 1-2 away), 36, 29, 0, 65, UConn, (5-4; 2-2 home), 39, 41, 0, 80
400585987, 2014-12-22, Weber State, (4-6; 0-3 away), 12, 39, 0, 51, Oklahoma, (8-3; 5-0 home), 51, 34, 0, 85
400591016, 2014-12-22, Southern, (3-10; 0-7 away), 31, 35, 0, 66, Baylor, (10-1; 7-0 home), 34, 36, 0, 70
400589328, 2014-12-22, Charleston So, (5-5; 1-4 away), 21, 33, 0, 54, Colorado State, (12-0; 7-0 home), 38, 37, 0, 75
400598805, 2014-12-22, Grambling St, (2-8; 0-8 away), 17, 22, 0, 39, TCU, (12-0; 9-0 home), 42, 38, 0, 80
400586384, 2014-12-22, Loyola (CHI), (9-2; 3-1 away), 28, 34, 0, 62, Texas Tech, (9-2; 9-0 home), 19, 25, 0, 44
400586747, 2014-12-22, Incarnate Word, (8-2; 4-2 away), 16, 31, 0, 47, Tulsa, (7-5; 5-2 home), 41, 35, 0, 76
400587465, 2014-12-22, Cent Michigan, (9-1; 2-1 away), 43, 44, 0, 87, McNeese State, (5-5; 5-2 home), 27, 31, 0, 58
400588700, 2014-12-22, North Florida, (7-6; 3-5 away), 31, 39, 0, 70, Iowa, (9-4; 8-1 home), 44, 36, 0, 80
400589137, 2014-12-22, UAB, (4-8; 0-1 away), 25, 42, 0, 67, Chattanooga, (7-6; 1-0 Southern), 46, 37, 0, 83
400589140, 2014-12-22, Furman, (2-8; 1-0 Southern), 33, 43, 0, 76, Minnesota, (10-2; 8-0 home), 40, 46, 0, 86
400590772, 2014-12-22, Chicago State, (3-11; 0-8 away), 21, 17, 0, 38, SIU-ED, (3-7; 3-2 home), 36, 27, 0, 63
400591043, 2014-12-22, NC Central, (9-5; 2-0 MEAC), 29, 27, 11, 67, Jackson State, (2-11; 1-2 home), 27, 29, 8, 64
400591306, 2014-12-22, Penn, (3-6; 2-3 away), 29, 21, 0, 50, Vanderbilt, (8-3; 7-1 home), 40, 39, 0, 79
400591414, 2014-12-22, Rice, (3-7; 0-3 away), 33, 31, 8, 72, Lamar, (5-6; 4-0 home), 32, 32, 15, 79
400595426, 2014-12-22, Coppin State, (1-10; 0-2 MEAC), 26, 30, 0, 56, Michigan, (7-5; 6-3 home), 42, 30, 0, 72
400596347, 2014-12-22, SE Missouri St, (5-7; 1-4 away), 24, 27, 0, 51, Ole Miss, (8-3; 3-3 home), 47, 35, 0, 82
400586380, 2014-12-22, Oral Roberts, (4-7; 0-6 away), 31, 14, 0, 45, Missouri State, (6-6; 4-1 home), 21, 31, 0, 52
400586381, 2014-12-22, Murray State, (9-4; 3-1 away), 44, 39, 0, 83, S Illinois, (7-6; 4-2 home), 39, 32, 0, 71
400586385, 2014-12-22, Non D-I School, NA, 26, 36, 0, 62, Drake, (3-9; 3-2 home), 46, 38, 0, 84
400590771, 2014-12-22, Tenn Tech, (7-5; 2-5 away), 45, 36, 0, 81, UMKC, (4-9; 3-2 home), 24, 36, 0, 60
400593229, 2014-12-22, Wisconsin, (11-1; 3-0 away), 32, 36, 0, 68, Cal, (10-2; 7-1 home), 20, 36, 0, 56
400585986, 2014-12-22, North Dakota, (4-7; 1-6 away), 29, 25, 0, 54, Marquette, (7-4; 5-2 home), 24, 43, 0, 67
400585991, 2014-12-22, UC Davis, (9-1; 4-1 away), 30, 43, 0, 73, N Colorado, (5-6; 5-1 home), 29, 34, 0, 63
400587869, 2014-12-22, Miami (FL), (9-3; 2-0 away), 33, 29, 0, 62, Providence, (10-3; 7-1 home), 33, 43, 0, 76
400591606, 2014-12-22, Jacksonville St, (7-6; 1-6 away), 28, 29, 8, 65, Air Force, (7-4; 6-1 home), 30, 27, 9, 66
400593230, 2014-12-22, UCSB, (5-6; 0-4 away), 30, 41, 7, 78, Oregon, (9-3; 8-1 home), 36, 35, 11, 82
400596107, 2014-12-22, Milwaukee, (5-8; 0-5 away), 24, 30, 0, 54, Arkansas, (9-2; 8-0 home), 35, 49, 0, 84
400597306, 2014-12-22, Charleston, (5-7; 1-3 away), 15, 32, 0, 47, LSU, (9-2; 6-0 home), 35, 36, 0, 71
400597931, 2014-12-22, Northeastern, (7-4; 2-3 away), 40, 23, 5, 68, Saint Mary's, (7-3; 6-2 home), 38, 25, 9, 72
400600650, 2014-12-22, Non D-I School, NA, 20, 19, 0, 39, New Mexico St, (5-8; 5-1 home), 39, 39, 0, 78
400749808, 2014-12-22, Kent State, (8-3; 3-1 away), 37, 38, 0, 75, UTEP, (8-4; 6-1 home), 44, 34, 0, 78
400585989, 2014-12-22, Non D-I School, NA, 29, 23, 0, 52, Portland State, (6-4; 4-0 home), 46, 48, 0, 94
400606908, 2014-12-22, Non D-I School, NA, 30, 51, 0, 81, E Washington, (9-4; 6-0 home), 43, 44, 0, 87
400591412, 2014-12-22, Marshall, (4-8; 0-3 away), 30, 25, 0, 55, Nevada, (3-8; 3-2 home), 38, 45, 0, 83
400595613, 2014-12-22, Texas A&M-CC, (4-7; 2-4 away), 32, 45, 0, 77, CS Fullerton, (6-7; 3-1 home), 36, 46, 0, 82
400586745, 2014-12-22, Boise State, (10-2; 2-2 away), 31, 31, 13, 75, Houston, (5-4; 4-2 home), 22, 40, 11, 73
400586382, 2014-12-22, Loyola Mary, (3-7; 0-4 away), 23, 30, 0, 53, Wichita State, (9-1; 6-0 home), 37, 43, 0, 80
400593231, 2014-12-22, Tulane, (9-2; 1-1 away), 26, 31, 0, 57, Washington, (11-0; 5-0 home), 28, 38, 0, 66
400591607, 2014-12-22, UC Riverside, (6-5; 1-4 away), 11, 22, 0, 33, San Diego State, (9-3; 7-0 home), 26, 35, 0, 61
400595427, 2014-12-22, Nebraska, (6-4; 1-2 away), 23, 35, 0, 58, Hawaii, (9-3; 6-1 home), 34, 32, 0, 66
400586938, 2014-12-23, IUPUI, (3-9; 1-6 away), 22, 31, 0, 53, Richmond, (7-4; 6-0 home), 29, 28, 0, 57
400586750, 2014-12-23, SE Louisiana, (3-10; 0-10 away), 30, 33, 0, 63, USF, (6-6; 5-2 home), 38, 40, 0, 78
400587274, 2014-12-23, UMass, (6-6; 0-4 away), 30, 32, 9, 71, BYU, (10-3; 6-1 home), 32, 30, 15, 77
400588703, 2014-12-23, FGCU, (9-3; 0-1 away), 38, 29, 0, 67, Iona, (7-4; 1-1 MAAC), 49, 37, 0, 86
400589331, 2014-12-23, UNC-Wilmington, (5-4; 2-4 away), 35, 28, 0, 63, Campbell, (6-6; 5-1 home), 35, 34, 0, 69
400596348, 2014-12-23, E Illinois, (6-6; 2-4 away), 35, 32, 0, 67, Cleveland State, (6-7; 5-2 home), 36, 29, 0, 65
400750094, 2014-12-23, Ohio, (4-5; 0-2 away), 44, 55, 0, 99, DePaul, (6-6; 5-2 home), 30, 48, 0, 78
400593232, 2014-12-23, Detroit, (6-7; 1-5 away), 22, 32, 0, 54, Arizona State, (7-5; 7-1 home), 50, 43, 0, 93
400750096, 2014-12-23, S Carolina St, (4-10; 2-0 MEAC), 32, 24, 0, 56, Southern Utah, (3-7; 1-2 home), 28, 38, 0, 66
400586203, 2014-12-23, Fair Dickinson, (4-6; 1-5 away), 36, 24, 0, 60, St Peter's, (5-7; 0-2 MAAC), 27, 42, 0, 69
400591144, 2014-12-23, La Salle, (7-5; 4-0 away), 44, 39, 0, 83, Hofstra, (7-4; 4-1 home), 36, 38, 0, 74
400750095, 2014-12-23, G Washington, (8-3; 1-3 away), 30, 23, 0, 53, Colorado, (7-4; 6-1 home), 26, 24, 0, 50
400595930, 2014-12-23, Cal Poly, (6-5; 2-4 away), 38, 31, 0, 69, Santa Clara, (5-6; 3-2 home), 32, 26, 0, 58
400587468, 2014-12-23, Coppin State, (1-11; 0-2 MEAC), 24, 40, 0, 64, E Michigan, (10-2; 8-0 home), 34, 53, 0, 87
400750097, 2014-12-23, Abil Christian, (6-6; 0-5 away), 37, 32, 0, 69, AR-Pine Bluff, (3-10; 0-0 home), 25, 36, 0, 61
400587872, 2014-12-23, CS Northridge, (3-10; 0-7 away), 25, 30, 0, 55, Louisville, (11-0; 8-0 home), 36, 44, 0, 80
400588387, 2014-12-23, NJIT, (5-8; 3-7 away), 44, 23, 0, 67, Villanova, (12-0; 7-0 home), 41, 51, 0, 92
400585765, 2014-12-23, Stanford, (7-3; 1-2 away), 31, 33, 10, 74, Texas, (10-2; 7-1 home), 31, 33, 7, 71
400586201, 2014-12-23, Arkansas State, (5-4; 3-2 away), 36, 38, 0, 74, Niagara, (1-8; 1-1 MAAC), 41, 28, 0, 69
400586202, 2014-12-23, St Francis (BKN), (5-7; 2-4 away), 32, 39, 0, 71, Monmouth, (5-6; 2-0 MAAC), 23, 23, 0, 46
400586204, 2014-12-23, Cornell, (6-5; 3-2 away), 27, 48, 0, 75, Siena, (3-7; 1-1 MAAC), 26, 31, 0, 57
400586752, 2014-12-23, Wagner, (2-8; 0-7 away), 19, 29, 0, 48, Cincinnati, (8-3; 7-1 home), 32, 40, 0, 72
400587113, 2014-12-23, American U, (7-5; 3-5 away), 25, 22, 0, 47, Stony Brook, (7-6; 6-0 home), 25, 34, 0, 59
400587114, 2014-12-23, Holy Cross, (5-5; 1-4 away), 14, 25, 0, 39, Pitt, (9-3; 6-0 home), 27, 31, 0, 58
400587873, 2014-12-23, LA Tech, (8-4; 2-4 away), 39, 26, 0, 65, NC State, (10-3; 1-0 ACC), 24, 49, 0, 73
400591145, 2014-12-23, George Mason, (5-6; 1-1 away), 35, 33, 0, 68, Wright State, (8-5; 4-1 home), 28, 32, 0, 60
400596021, 2014-12-23, Sacred Heart, (6-5; 1-4 away), 18, 36, 0, 54, Rutgers, (7-5; 4-3 home), 34, 45, 0, 79
400586751, 2014-12-23, W Illinois, (4-6; 0-5 away), 14, 37, 0, 51, Memphis, (7-4; 6-2 home), 41, 37, 0, 78
400587871, 2014-12-23, Georgia Tech, (8-3; 1-1 away), 33, 28, 0, 61, Dayton, (9-2; 6-0 home), 39, 36, 0, 75
400588702, 2014-12-23, Jacksonville, (4-10; 0-8 away), 27, 20, 0, 47, Miss St, (6-5; 5-1 home), 36, 34, 0, 70
400591415, 2014-12-23, PV A&M, (2-10; 1-8 away), 27, 43, 0, 70, North Texas, (6-5; 6-2 home), 34, 33, 0, 67
400597307, 2014-12-23, Texas Southern, (2-9; 1-9 away), 28, 32, 0, 60, Auburn, (6-5; 5-1 home), 27, 34, 0, 61
400598582, 2014-12-23, Howard, (7-7; 1-1 MEAC), 36, 37, 0, 73, South Alabama, (2-8; 2-2 home), 33, 27, 0, 60
400750174, 2014-12-23, Wichita State, (10-1; 2-1 away), 34, 36, 10, 80, Hawaii, (9-4; 6-2 home), 33, 37, 9, 79
400586939, 2014-12-23, South Dakota St, (9-4; 2-3 away), 28, 38, 0, 66, Utah, (9-2; 7-0 home), 45, 35, 0, 80
400590773, 2014-12-23, New Mexico, (8-4; 2-1 away), 30, 35, 0, 65, Grand Canyon, (7-7; 6-4 home), 30, 38, 0, 68
400750154, 2014-12-23, Houston, (6-4; 1-1 away), 41, 41, 0, 82, Texas Tech, (9-3; 9-0 home), 34, 35, 0, 69
400585992, 2014-12-23, Wyoming, (11-2; 1-2 away), 27, 34, 0, 61, Montana State, (3-9; 3-2 home), 22, 29, 0, 51
400585993, 2014-12-23, Idaho State, (3-9; 1-5 away), 21, 26, 0, 47, Utah Valley, (4-7; 2-1 home), 25, 26, 0, 51
400591608, 2014-12-23, Arizona, (12-1; 1-1 away), 41, 26, 0, 67, UNLV, (8-3; 5-0 home), 36, 35, 0, 71
400750155, 2014-12-23, Boise State, (10-3; 2-2 away), 27, 18, 0, 45, Loyola (CHI), (10-2; 5-1 home), 22, 26, 0, 48
400750175, 2014-12-23, Loyola Mary, (3-8; 0-5 away), 16, 19, 7, 42, Nebraska, (7-4; 6-2 home), 21, 14, 15, 50
400750236, 2014-12-25, DePaul, (6-7; 1-2 away), 31, 38, 0, 69, Loyola Mary, (4-8; 3-2 home), 29, 43, 0, 72
400750237, 2014-12-25, Ohio, (4-6; 0-2 away), 30, 28, 0, 58, Nebraska, (8-4; 6-2 home), 32, 39, 0, 71
400750234, 2014-12-25, Colorado, (7-5; 0-3 away), 33, 33, 0, 66, Hawaii, (10-4; 7-2 home), 32, 37, 0, 69
400750235, 2014-12-25, G Washington, (9-3; 1-3 away), 28, 32, 0, 60, Wichita State, (10-2; 6-0 home), 28, 26, 0, 54
400588388, 2014-12-27, Georgetown, (8-3; 0-0 away), 30, 47, 14, 91, Indiana, (10-3; 9-1 home), 40, 37, 10, 87
400588389, 2014-12-27, Maine, (1-10; 0-8 away), 16, 27, 0, 43, Seton Hall, (10-2; 6-0 home), 36, 36, 0, 72
400595240, 2014-12-27, Georgia State, (7-4; 2-4 away), 37, 24, 0, 61, Green Bay, (10-3; 5-0 home), 35, 43, 0, 78
400595432, 2014-12-27, UNC-Wilmington, (5-5; 2-5 away), 38, 44, 0, 82, Minnesota, (11-2; 9-0 home), 54, 54, 0, 108
400588704, 2014-12-27, Jacksonville St, (7-7; 1-7 away), 20, 41, 0, 61, Jacksonville, (5-10; 5-2 home), 25, 50, 0, 75
400587874, 2014-12-27, Kentucky, (13-0; 1-0 away), 22, 36, 0, 58, Louisville, (11-1; 8-1 home), 18, 32, 0, 50
400588705, 2014-12-27, N Kentucky, (6-7; 2-5 away), 24, 31, 0, 55, Northwestern, (9-4; 7-2 home), 36, 40, 0, 76
400587875, 2014-12-27, UAB, (4-9; 0-2 away), 23, 35, 0, 58, UNC, (9-3; 4-1 home), 44, 45, 0, 89
400586940, 2014-12-27, IUPUI, (4-9; 2-6 away), 28, 27, 0, 55, Pepperdine, (7-4; 5-1 home), 27, 26, 0, 53
400587278, 2014-12-27, Santa Clara, (5-7; 0-1 WCC), 30, 30, 0, 60, Saint Mary's, (8-3; 1-0 WCC), 34, 39, 0, 73
400595431, 2014-12-27, Oakland, (4-10; 1-7 away), 19, 37, 0, 56, Maryland, (12-1; 9-1 home), 37, 35, 0, 72
400587275, 2014-12-27, Gonzaga, (12-1; 1-0 WCC), 43, 44, 0, 87, BYU, (10-4; 0-1 WCC), 43, 37, 0, 80
400587277, 2014-12-27, San Francisco, (7-6; 1-0 WCC), 32, 45, 0, 77, Pacific, (8-5; 0-1 WCC), 37, 34, 0, 71
400589142, 2014-12-27, Mercer, (6-7; 1-0 Southern), 23, 28, 26, 77, Georgia, (7-3; 6-0 home), 32, 19, 35, 86
400595433, 2014-12-27, Wright State, (8-6; 4-3 away), 18, 37, 0, 55, OSU, (11-2; 10-0 home), 47, 53, 0, 100
400587876, 2014-12-27, Presbyterian, (4-9; 0-5 away), 32, 33, 0, 65, VT, (8-4; 7-2 home), 45, 42, 0, 87
400591416, 2014-12-27, Non D-I School, NA, 18, 24, 0, 42, W Kentucky, (6-5; 4-2 home), 40, 49, 0, 89
400596349, 2014-12-27, Tennessee St, (2-11; 0-8 away), 26, 20, 0, 46, Tennessee, (7-4; 6-0 home), 29, 38, 0, 67
400590774, 2014-12-27, Colorado State, (13-0; 3-0 away), 22, 29, 7, 58, New Mexico St, (5-9; 5-2 home), 20, 31, 6, 57
400585994, 2014-12-27, Non D-I School, NA, 33, 26, 0, 59, Weber State, (5-6; 4-1 home), 53, 56, 0, 109
400587276, 2014-12-27, Portland, (10-3; 1-0 WCC), 29, 32, 0, 61, San Diego, (7-6; 0-1 WCC), 27, 31, 0, 58
400588706, 2014-12-27, Kennesaw St, (4-10; 1-7 away), 18, 27, 0, 45, Illinois, (10-3; 7-0 home), 54, 39, 0, 93
400585995, 2014-12-27, Sacramento St, (6-5; 2-4 away), 38, 36, 0, 74, Utah Valley, (4-8; 2-2 home), 32, 17, 0, 49
400591609, 2014-12-27, Non D-I School, NA, 27, 36, 0, 63, Utah State, (7-5; 5-2 home), 33, 42, 0, 75
400585996, 2014-12-27, Southern Utah, (3-8; 1-5 away), 28, 17, 0, 45, UNLV, (9-3; 6-0 home), 36, 43, 0, 79
400591610, 2014-12-27, Non D-I School, NA, 20, 30, 0, 50, San Diego State, (10-3; 8-0 home), 38, 34, 0, 72
400588390, 2014-12-28, Tulane, (9-3; 1-1 away), 22, 35, 0, 57, St John's, (11-1; 8-0 home), 47, 35, 0, 82
400586756, 2014-12-28, Cent Conn St, (2-10; 1-5 away), 23, 25, 0, 48, UConn, (6-4; 3-2 home), 35, 46, 0, 81
400587470, 2014-12-28, Non D-I School, NA, 16, 26, 0, 42, E Michigan, (11-2; 9-0 home), 47, 53, 0, 100
400597870, 2014-12-28, Iona, (8-4; 1-1 MAAC), 40, 41, 0, 81, Drexel, (2-9; 1-4 home), 29, 33, 0, 62
400586208, 2014-12-28, Bucknell, (5-8; 1-6 away), 38, 33, 0, 71, Siena, (4-7; 1-1 MAAC), 35, 38, 0, 73
400586754, 2014-12-28, UNC Greensboro, (4-9; 1-0 Southern), 26, 24, 0, 50, ECU, (7-6; 6-1 home), 45, 26, 0, 71
400587115, 2014-12-28, Colgate, (3-10; 1-8 away), 33, 31, 0, 64, Columbia, (7-4; 6-1 home), 31, 38, 0, 69
400587117, 2014-12-28, NJIT, (5-9; 3-8 away), 31, 40, 0, 71, Lafayette, (8-3; 5-0 home), 33, 43, 0, 76
400587469, 2014-12-28, Longwood, (4-9; 0-7 away), 22, 42, 0, 64, Ball State, (4-6; 4-1 home), 28, 41, 0, 69
400587877, 2014-12-28, LBSU, (5-9; 0-8 away), 40, 27, 0, 67, Syracuse, (8-4; 7-1 home), 44, 41, 0, 85
400588391, 2014-12-28, Morgan State, (2-11; 0-2 MEAC), 17, 36, 0, 53, Marquette, (8-4; 6-2 home), 37, 44, 0, 81
400589143, 2014-12-28, Campbell, (6-7; 1-6 away), 23, 33, 0, 56, Samford, (6-8; 0-2 Southern), 28, 37, 0, 65
400589332, 2014-12-28, Non D-I School, NA, 23, 35, 0, 58, Liberty, (6-7; 6-1 home), 34, 44, 0, 78
400591146, 2014-12-28, MD-E Shore, (7-8; 1-1 MEAC), 45, 33, 0, 78, Duquesne, (4-6; 3-3 home), 38, 31, 0, 69
400591220, 2014-12-28, Sacred Heart, (6-6; 1-5 away), 37, 39, 0, 76, Brown, (7-6; 4-2 home), 40, 39, 0, 79
400591294, 2014-12-28, Harvard, (7-3; 1-2 away), 28, 18, 0, 46, Arizona State, (8-5; 8-1 home), 32, 24, 0, 56
400597887, 2014-12-28, Marist, (1-11; 0-2 MAAC), 18, 46, 0, 64, Elon, (8-5; 4-1 home), 34, 35, 0, 69
400586387, 2014-12-28, Coppin State, (1-12; 0-2 MEAC), 30, 50, 0, 80, Evansville, (10-2; 6-1 home), 45, 40, 0, 85
400586389, 2014-12-28, UMKC, (5-9; 2-6 away), 29, 27, 17, 73, Indiana State, (4-8; 3-4 home), 29, 27, 14, 70
400591777, 2014-12-28, Hofstra, (8-4; 3-3 away), 45, 43, 0, 88, LIU Brooklyn, (4-7; 1-2 home), 25, 37, 0, 62
400586388, 2014-12-28, South Dakota St, (9-5; 2-4 away), 30, 33, 0, 63, Northern Iowa, (11-1; 6-0 home), 39, 35, 0, 74
400585766, 2014-12-28, Texas Southern, (3-9; 2-9 away), 21, 37, 0, 58, Kansas State, (7-5; 5-1 home), 23, 33, 0, 56
400586206, 2014-12-28, Rutgers, (8-5; 2-1 away), 29, 30, 0, 59, Monmouth, (5-7; 2-0 MAAC), 31, 27, 0, 58
400586753, 2014-12-28, Bowling Green, (7-3; 3-2 away), 31, 48, 0, 79, USF, (6-7; 5-3 home), 34, 36, 0, 70
400586942, 2014-12-28, Northland,  , 31, 28, 0, 59, North Dakota St, (8-5; 6-0 home), 46, 37, 0, 83
400586944, 2014-12-28, Milwaukee, (5-9; 0-6 away), 23, 37, 0, 60, South Dakota, (6-8; 3-1 home), 33, 51, 0, 84
400587118, 2014-12-28, Non D-I School, NA, 24, 24, 0, 48, Army, (9-2; 5-1 home), 63, 30, 0, 93
400589333, 2014-12-28, Thomas (GA),  , 29, 19, 0, 48, High Point, (9-3; 4-0 home), 39, 46, 0, 85
400589334, 2014-12-28, Non D-I School, NA, 27, 42, 0, 69, Radford, (9-4; 6-0 home), 63, 56, 0, 119
400596350, 2014-12-28, Non D-I School, NA, 25, 31, 0, 56, SIU-ED, (4-7; 4-2 home), 55, 49, 0, 104
400596351, 2014-12-28, Harris Stowe,  , 31, 35, 0, 66, SE Missouri St, (6-7; 5-1 home), 36, 58, 0, 94
400598583, 2014-12-28, Non D-I School, NA, 22, 32, 0, 54, NC A&T, (2-12; 0-2 MEAC), 27, 31, 0, 58
400595615, 2014-12-28, Northwestern St, (4-6; 1-5 away), 39, 53, 0, 92, Arkansas, (10-2; 9-0 home), 48, 52, 0, 100
400585997, 2014-12-28, Non D-I School, NA, 13, 32, 0, 45, N Arizona, (5-8; 3-1 home), 42, 29, 0, 71
400586207, 2014-12-28, St Peter's, (6-7; 0-2 MAAC), 15, 30, 14, 59, Cornell, (6-6; 3-1 home), 17, 28, 7, 52
400586943, 2014-12-28, Non D-I School, NA, 20, 22, 0, 42, Oral Roberts, (5-7; 4-0 home), 43, 51, 0, 94
400587878, 2014-12-28, Wake Forest, (7-6; 0-1 ACC), 33, 32, 0, 65, Richmond, (7-5; 6-1 home), 25, 38, 0, 63
400588392, 2014-12-28, FGCU, (9-4; 0-2 away), 29, 28, 0, 57, Xavier, (9-3; 7-0 home), 43, 28, 0, 71
400591612, 2014-12-28, Non D-I School, NA, 29, 33, 0, 62, Fresno State, (5-8; 4-1 home), 55, 38, 0, 93
400586941, 2014-12-28, Non D-I School, NA, 22, 24, 0, 46, IPFW, (7-5; 5-1 home), 44, 36, 0, 80
400586205, 2014-12-28, Loyola (MD), (4-7; 1-5 away), 23, 32, 6, 61, Fairfield, (4-8; 2-0 MAAC), 29, 26, 4, 59
400586386, 2014-12-28, UIC, (3-11; 0-6 away), 25, 35, 0, 60, Bradley, (5-8; 5-2 home), 27, 41, 0, 68
400586755, 2014-12-28, Miss Valley St, (1-11; 0-10 away), 33, 20, 0, 53, Houston, (7-4; 5-2 home), 40, 40, 0, 80
400586757, 2014-12-28, Delaware State, (5-8; 4-7 away), 21, 35, 0, 56, Temple, (9-4; 7-0 home), 31, 35, 0, 66
400587116, 2014-12-28, Lehigh, (6-5; 4-2 away), 32, 26, 0, 58, UMBC, (2-10; 1-3 home), 31, 24, 0, 55
400588393, 2014-12-28, Belmont, (8-5; 4-3 away), 38, 18, 0, 56, Butler, (10-3; 7-0 home), 39, 28, 0, 67
400590776, 2014-12-28, Abil Christian, (6-7; 0-6 away), 34, 47, 0, 81, Grand Canyon, (8-7; 7-4 home), 33, 50, 0, 83
400591147, 2014-12-28, Howard, (7-8; 1-1 MEAC), 26, 33, 0, 59, Fordham, (4-6; 4-2 home), 28, 46, 0, 74
400591611, 2014-12-28, Non D-I School, NA, 24, 43, 0, 67, Nevada, (4-8; 4-2 home), 41, 40, 0, 81
400593233, 2014-12-28, UC Davis, (9-2; 4-2 away), 32, 51, 0, 83, Washington St, (6-6; 4-1 home), 46, 44, 0, 90
400593235, 2014-12-28, UCLA, (8-5; 0-1 away), 17, 33, 0, 50, Alabama, (9-3; 8-0 home), 29, 27, 0, 56
400587471, 2014-12-28, Buffalo, (7-3; 4-3 away), 27, 29, 0, 56, Wisconsin, (12-1; 6-1 home), 26, 42, 0, 68
400593234, 2014-12-28, Stony Brook, (8-6; 1-6 away), 26, 36, 0, 62, Washington, (11-1; 5-1 home), 35, 22, 0, 57
400590775, 2014-12-28, CSU Bakersfield, (3-10; 1-4 away), 30, 25, 0, 55, Cal, (10-3; 7-2 home), 20, 32, 0, 52
400585769, 2014-12-29, Rice, (3-8; 0-4 away), 22, 33, 0, 55, Texas, (11-2; 8-1 home), 29, 37, 0, 66
400587879, 2014-12-29, UMass Lowell, (6-6; 4-5 away), 22, 25, 0, 47, Boston College, (7-4; 6-1 home), 29, 41, 0, 70
400589335, 2014-12-29, Non D-I School, NA, 17, 30, 0, 47, Charleston So, (6-5; 5-1 home), 49, 32, 0, 81
400587472, 2014-12-29, Toledo, (7-5; 2-4 away), 37, 32, 0, 69, Duke, (11-0; 6-0 home), 41, 45, 0, 86
400586209, 2014-12-29, Maine, (1-11; 0-9 away), 30, 34, 0, 64, Quinnipiac, (6-5; 0-2 MAAC), 33, 48, 0, 81
400586210, 2014-12-29, Rider, (7-6; 1-1 MAAC), 36, 40, 0, 76, Wagner, (2-9; 2-2 home), 25, 46, 0, 71
400586390, 2014-12-29, Non D-I School, NA, 23, 34, 0, 57, Illinois State, (8-4; 4-2 home), 59, 40, 0, 99
400586947, 2014-12-29, IUPUI, (4-10; 2-7 away), 22, 27, 0, 49, NC Central, (10-5; 2-0 MEAC), 32, 38, 0, 70
400587119, 2014-12-29, Wentworth,  , 25, 21, 0, 46, Boston U, (4-7; 3-2 home), 34, 35, 0, 69
400587473, 2014-12-29, Capital (OH),  , 20, 26, 0, 46, Miami (OH), (4-8; 4-3 home), 39, 30, 0, 69
400588707, 2014-12-29, Lipscomb, (5-8; 1-7 away), 35, 25, 0, 60, Chattanooga, (8-6; 1-0 Southern), 36, 42, 0, 78
400588708, 2014-12-29, North Florida, (7-7; 3-6 away), 39, 45, 0, 84, Tenn Tech, (8-5; 6-0 home), 36, 51, 0, 87
400591148, 2014-12-29, Cleveland State, (6-8; 1-6 away), 27, 36, 0, 63, VCU, (10-3; 6-1 home), 32, 40, 0, 72
400591417, 2014-12-29, FIU, (7-6; 3-4 away), 38, 38, 0, 76, Florida A&M, (0-12; 0-1 MEAC), 19, 36, 0, 55
400591420, 2014-12-29, Southern Miss, (5-6; 0-5 away), 33, 34, 0, 67, LSU, (10-2; 7-0 home), 49, 38, 0, 87
400591757, 2014-12-29, Fair Dickinson, (5-6; 2-5 away), 32, 45, 8, 85, Towson, (7-6; 2-2 home), 46, 31, 7, 84
400597820, 2014-12-29, Valparaiso, (13-2; 3-1 away), 40, 39, 0, 79, JMU, (7-6; 6-4 home), 16, 36, 0, 52
400595617, 2014-12-29, Non D-I School, NA, 16, 31, 0, 47, Sam Houston, (8-4; 6-0 home), 56, 46, 0, 102
400606909, 2014-12-29, Non D-I School, NA, 28, 24, 0, 52, LA Tech, (9-4; 7-0 home), 38, 36, 0, 74
400585767, 2014-12-29, North Texas, (6-6; 0-4 away), 22, 23, 0, 45, Texas Tech, (10-3; 10-0 home), 26, 34, 0, 60
400585768, 2014-12-29, Tennessee St, (2-12; 0-9 away), 19, 21, 0, 40, TCU, (13-0; 10-0 home), 33, 27, 0, 60
400586758, 2014-12-29, Midwest,  , 34, 27, 0, 61, SMU, (9-3; 8-1 home), 36, 34, 0, 70
400587474, 2014-12-29, Hampton, (6-7; 2-0 MEAC), 35, 16, 0, 51, N Illinois, (5-5; 5-0 home), 46, 37, 0, 83
400591419, 2014-12-29, Mt St Mary's, (4-7; 2-6 away), 19, 16, 0, 35, Old Dominion, (11-1; 8-0 home), 42, 27, 0, 69
400591421, 2014-12-29, Non D-I School, NA, 31, 31, 0, 62, W Kentucky, (7-5; 5-2 home), 60, 44, 0, 104
400595616, 2014-12-29, Morehead State, (5-10; 2-6 away), 48, 47, 0, 95, Cent Arkansas, (0-11; 0-4 home), 28, 32, 0, 60
400586945, 2014-12-29, Omaha, (6-6; 1-6 away), 25, 41, 0, 66, Chicago State, (4-11; 4-1 home), 36, 33, 0, 69
400586946, 2014-12-29, Saint Joe's, (6-5; 2-3 away), 37, 28, 8, 73, Denver, (6-7; 5-3 home), 30, 35, 12, 77
400587279, 2014-12-29, San Francisco, (7-7; 1-1 WCC), 24, 32, 0, 56, Saint Mary's, (9-3; 2-0 WCC), 29, 40, 0, 69
400587281, 2014-12-29, Pepperdine, (8-4; 1-0 WCC), 32, 37, 0, 69, Loyola Mary, (4-9; 0-1 WCC), 25, 31, 0, 56
400587282, 2014-12-29, Portland, (10-4; 1-1 WCC), 37, 51, 0, 88, BYU, (11-4; 1-1 WCC), 43, 54, 0, 97
400591418, 2014-12-29, Mid Tennessee, (7-6; 2-3 away), 20, 28, 0, 48, Auburn, (7-5; 6-1 home), 31, 33, 0, 64
400587283, 2014-12-29, Santa Clara, (6-7; 1-1 WCC), 28, 29, 0, 57, Pacific, (8-6; 0-2 WCC), 18, 22, 0, 40
400595618, 2014-12-29, SF Austin, (10-3; 2-2 away), 25, 36, 0, 61, CS Northridge, (3-11; 2-4 home), 34, 23, 0, 57
400587280, 2014-12-29, Gonzaga, (13-1; 2-0 WCC), 35, 25, 0, 60, San Diego, (7-7; 0-2 WCC), 20, 28, 0, 48
400593236, 2014-12-29, AR-Pine Bluff, (3-11; 1-8 away), 14, 25, 0, 39, Stanford, (8-3; 6-0 home), 45, 29, 0, 74
400593237, 2014-12-29, UC Irvine, (6-6; 1-5 away), 33, 24, 10, 67, Oregon, (10-3; 9-1 home), 26, 31, 12, 69
400591017, 2014-12-29, Southern, (3-11; 0-8 away), 23, 34, 0, 57, Hawaii, (11-4; 8-2 home), 31, 40, 0, 71
400599466, 2014-12-30, Northwestern, (10-4; 1-0 Big Ten), 27, 24, 0, 51, Rutgers, (8-6; 0-1 Big Ten), 22, 25, 0, 47
400595435, 2014-12-30, Iowa, (10-4; 1-0 Big Ten), 43, 28, 0, 71, OSU, (11-3; 0-1 Big Ten), 31, 34, 0, 65
400588711, 2014-12-30, Florida Tech,  , 31, 30, 0, 61, Stetson, (4-10; 4-3 home), 41, 36, 0, 77
400596352, 2014-12-30, E Kentucky, (7-5; 4-3 away), 31, 35, 0, 66, Coppin State, (1-13; 0-2 MEAC), 28, 35, 0, 63
400585770, 2014-12-30, VT, (8-5; 0-2 away), 30, 21, 0, 51, West Virginia, (12-1; 5-1 home), 33, 49, 0, 82
400591328, 2014-12-30, Yale, (10-4; 5-3 away), 30, 40, 0, 70, Sacred Heart, (6-7; 4-2 home), 27, 37, 0, 64
400591422, 2014-12-30, Non D-I School, NA, 33, 35, 0, 68, UTSA, (5-5; 3-3 home), 43, 36, 0, 79
400595436, 2014-12-30, Illinois, (10-4; 0-1 Big Ten), 32, 27, 6, 65, Michigan, (8-5; 1-0 Big Ten), 26, 33, 14, 73
400587885, 2014-12-30, LBSU, (5-10; 0-9 away), 19, 29, 0, 48, Louisville, (12-1; 9-1 home), 34, 29, 0, 63
400586759, 2014-12-30, Cincinnati, (9-3; 1-1 away), 41, 35, 0, 76, NC State, (10-4; 1-0 ACC), 26, 34, 0, 60
400591067, 2014-12-30, Concordia (AL),  , 38, 41, 0, 79, Alcorn State, (1-11; 1-1 home), 33, 37, 0, 70
400595437, 2014-12-30, Maryland, (13-1; 1-0 Big Ten), 17, 31, 20, 68, Michigan State, (9-5; 0-1 Big Ten), 14, 34, 18, 66
400587880, 2014-12-30, Davidson, (9-2; 3-1 away), 36, 36, 0, 72, UVA, (12-0; 7-0 home), 32, 51, 0, 83
400589147, 2014-12-30, Non D-I School, NA, 21, 14, 0, 35, Furman, (3-8; 1-0 Southern), 30, 42, 0, 72
400587887, 2014-12-30, William & Mary, (6-5; 1-5 away), 27, 37, 0, 64, UNC, (10-3; 5-1 home), 49, 37, 0, 86
400586211, 2014-12-30, UMKC, (5-10; 2-7 away), 23, 32, 0, 55, Canisius, (7-4; 2-0 MAAC), 31, 36, 0, 67
400586213, 2014-12-30, Iona, (8-5; 1-1 MAAC), 40, 42, 0, 82, UMass, (7-6; 5-0 home), 46, 41, 0, 87
400586948, 2014-12-30, Oral Roberts, (6-7; 1-6 away), 31, 33, 13, 77, Detroit, (6-8; 4-3 home), 25, 39, 9, 73
400587475, 2014-12-30, Buffalo, (8-3; 5-3 away), 40, 36, 0, 76, Binghamton, (1-14; 1-5 home), 21, 29, 0, 50
400587476, 2014-12-30, UNC-Wilmington, (5-6; 2-6 away), 34, 19, 0, 53, Ohio, (5-6; 4-2 home), 30, 42, 0, 72
400587477, 2014-12-30, Marshall, (4-9; 0-4 away), 24, 39, 0, 63, Akron, (8-4; 6-1 home), 35, 35, 0, 70
400587881, 2014-12-30, Robert Morris, (4-8; 1-5 away), 26, 31, 0, 57, Clemson, (8-4; 6-2 home), 30, 34, 0, 64
400587882, 2014-12-30, Florida, (7-5; 0-2 away), 24, 39, 0, 63, FSU, (8-5; 0-1 ACC), 26, 39, 0, 65
400587883, 2014-12-30, Charlotte, (6-6; 2-3 away), 20, 46, 0, 66, Georgia Tech, (9-3; 6-1 home), 28, 39, 0, 67
400587886, 2014-12-30, Charleston, (5-8; 1-4 away), 12, 28, 0, 40, Miami (FL), (10-3; 5-2 home), 32, 35, 0, 67
400588709, 2014-12-30, FAU, (7-4; 2-4 away), 28, 40, 0, 68, Jacksonville, (5-11; 5-3 home), 27, 23, 0, 50
400588710, 2014-12-30, Non D-I School, NA, 19, 36, 0, 55, USC Upstate, (10-4; 7-1 home), 50, 51, 0, 101
400589146, 2014-12-30, Bethune-Cookman, (3-10; 0-1 MEAC), 22, 25, 0, 47, The Citadel, (5-7; 0-1 Southern), 23, 28, 0, 51
400590778, 2014-12-30, UT Pan American, (5-8; 1-7 away), 34, 38, 0, 72, Duquesne, (5-6; 4-3 home), 41, 37, 0, 78
400591149, 2014-12-30, VMI, (5-8; 1-1 Southern), 29, 31, 0, 60, G Washington, (10-3; 5-0 home), 35, 45, 0, 80
400591150, 2014-12-30, St Bonaventure, (7-4; 2-2 away), 40, 37, 0, 77, Delaware, (1-10; 1-3 home), 38, 44, 0, 82
400591151, 2014-12-30, Penn, (3-7; 2-4 away), 35, 32, 0, 67, La Salle, (8-5; 4-2 home), 47, 37, 0, 84
400591243, 2014-12-30, Columbia, (7-5; 1-3 away), 24, 40, 0, 64, St Francis (BKN), (6-7; 3-2 home), 34, 38, 0, 72
400597308, 2014-12-30, NC A&T, (2-13; 0-2 MEAC), 16, 38, 0, 54, South Carolina, (8-3; 6-1 home), 47, 44, 0, 91
400597710, 2014-12-30, UNH, (6-6; 2-5 away), 32, 24, 0, 56, W Michigan, (8-4; 4-0 home), 39, 31, 0, 70
400598787, 2014-12-30, St Francis (PA), (6-5; 3-5 away), 24, 41, 0, 65, NJIT, (6-9; 3-1 home), 28, 49, 0, 77
400606910, 2014-12-30, Non D-I School, NA, 30, 40, 0, 70, W Carolina, (5-8; 0-1 Southern), 40, 46, 0, 86
400586212, 2014-12-30, Albany, (5-7; 3-5 away), 25, 22, 0, 47, Niagara, (2-8; 1-1 MAAC), 27, 38, 0, 65
400587884, 2014-12-30, Hartford, (7-6; 0-1 Am. East), 28, 32, 0, 60, Notre Dame, (13-1; 1-0 ACC), 43, 44, 0, 87
400587888, 2014-12-30, FGCU, (9-5; 0-3 away), 24, 30, 0, 54, Pitt, (10-3; 7-0 home), 33, 38, 0, 71
400595241, 2014-12-30, UL Monroe, (6-6; 0-1 Sun Belt), 26, 19, 0, 45, Georgia State, (8-4; 1-0 Sun Belt), 23, 42, 0, 65
400595619, 2014-12-30, Non D-I School, NA, 33, 31, 0, 64, Nicholls State, (3-7; 3-1 home), 41, 30, 0, 71
400596353, 2014-12-30, MD-E Shore, (8-8; 1-1 MEAC), 26, 37, 0, 63, UT Martin, (7-5; 2-1 home), 26, 34, 0, 60
400585771, 2014-12-30, Kent State, (8-4; 3-2 away), 33, 29, 0, 62, Kansas, (10-2; 5-0 home), 39, 39, 0, 78
400585773, 2014-12-30, Norfolk State, (9-6; 2-0 MEAC), 27, 24, 0, 51, Baylor, (11-1; 8-0 home), 32, 60, 0, 92
400586949, 2014-12-30, Cal Poly, (7-5; 3-4 away), 34, 37, 0, 71, IPFW, (7-6; 5-2 home), 22, 35, 0, 57
400590777, 2014-12-30, Harvard, (8-3; 2-2 away), 34, 38, 0, 72, Grand Canyon, (8-8; 7-5 home), 24, 35, 0, 59
400591152, 2014-12-30, Ole Miss, (8-4; 2-1 away), 32, 42, 0, 74, Dayton, (10-2; 7-0 home), 41, 37, 0, 78
400595620, 2014-12-30, Non D-I School, NA, 22, 25, 0, 47, Houston Baptist, (5-5; 4-0 home), 39, 59, 0, 98
400595621, 2014-12-30, Non D-I School, NA, 25, 34, 0, 59, Lamar, (6-6; 5-0 home), 48, 37, 0, 85
400595622, 2014-12-30, McNeese State, (6-5; 1-3 away), 36, 30, 0, 66, Miss St, (6-6; 5-2 home), 23, 24, 0, 47
400597309, 2014-12-30, Mercer, (6-8; 1-0 Southern), 23, 27, 0, 50, Texas A&M, (8-3; 6-0 home), 30, 35, 0, 65
400598790, 2014-12-30, Non D-I School, NA, 30, 35, 0, 65, Alabama State, (4-5; 3-0 home), 41, 35, 0, 76
400600688, 2014-12-30, Non D-I School, NA, 26, 34, 0, 60, Samford, (7-8; 0-2 Southern), 40, 54, 0, 94
400595244, 2014-12-30, Ga Southern, (7-3; 0-1 Sun Belt), 27, 34, 0, 61, UT-Arlington, (7-4; 1-0 Sun Belt), 40, 22, 0, 62
400596354, 2014-12-30, Alabama A&M, (1-9; 0-8 away), 17, 22, 0, 39, Murray State, (10-4; 6-1 home), 43, 33, 0, 76
400597784, 2014-12-30, Non D-I School, NA, 14, 24, 0, 38, UIC, (4-11; 4-3 home), 45, 34, 0, 79
400595242, 2014-12-30, Arkansas State, (6-4; 1-0 Sun Belt), 28, 25, 10, 63, South Alabama, (2-9; 0-1 Sun Belt), 33, 20, 7, 60
400595245, 2014-12-30, Texas State, (7-3; 1-0 Sun Belt), 29, 28, 0, 57, Troy, (5-5; 0-1 Sun Belt), 15, 31, 0, 46
400595624, 2014-12-30, Non D-I School, NA, 21, 34, 0, 55, Texas A&M-CC, (5-7; 3-2 home), 43, 44, 0, 87
400586950, 2014-12-30, Non D-I School, NA, 17, 45, 0, 62, W Illinois, (5-6; 5-1 home), 29, 45, 0, 74
400595623, 2014-12-30, Non D-I School, NA, 28, 32, 0, 60, New Orleans, (4-5; 3-0 home), 46, 44, 0, 90
400595243, 2014-12-30, LA-Lafayette, (7-5; 1-0 Sun Belt), 39, 35, 9, 83, AR-Little Rock, (5-6; 0-1 Sun Belt), 37, 37, 5, 79
400585772, 2014-12-30, Oklahoma State, (10-2; 1-1 away), 24, 38, 12, 74, Missouri, (5-7; 4-2 home), 31, 31, 10, 72
400590779, 2014-12-30, Texas Southern, (3-10; 2-10 away), 33, 19, 0, 52, New Mexico St, (6-9; 6-2 home), 25, 29, 0, 54
400600653, 2014-12-30, Non D-I School, NA, 24, 26, 0, 50, Utah Valley, (5-8; 3-2 home), 40, 43, 0, 83
400593239, 2014-12-30, Non D-I School, NA, 23, 26, 0, 49, Utah, (10-2; 8-0 home), 54, 31, 0, 85
400593238, 2014-12-30, UCSB, (5-7; 0-5 away), 36, 28, 0, 64, Oregon State, (9-3; 8-0 home), 37, 39, 0, 76
400590780, 2014-12-30, UC Davis, (9-3; 4-3 away), 30, 37, 0, 67, Seattle, (7-6; 5-4 home), 39, 37, 0, 76
400595934, 2014-12-30, Non D-I School, NA, 19, 26, 0, 45, CS Fullerton, (7-7; 4-1 home), 33, 44, 0, 77
400595935, 2014-12-30, Morgan State, (2-12; 0-2 MEAC), 37, 26, 0, 63, UC Riverside, (7-5; 6-1 home), 24, 44, 0, 68
400593240, 2014-12-30, UVM, (5-7; 1-0 Am. East), 26, 30, 0, 56, USC, (8-4; 5-2 home), 43, 21, 0, 64
400751434, 2014-12-30, PV A&M, (2-11; 1-9 away), 36, 32, 0, 68, Hawaii, (12-4; 9-2 home), 38, 38, 0, 76
400588394, 2014-12-31, St John's, (11-2; 0-1 Big East), 35, 32, 0, 67, Seton Hall, (11-2; 1-0 Big East), 40, 38, 0, 78
400586761, 2014-12-31, Tulane, (10-3; 1-0 American), 35, 32, 0, 67, ECU, (7-7; 0-1 American), 26, 33, 0, 59
400586764, 2014-12-31, Tulsa, (8-5; 1-0 American), 36, 20, 0, 56, UCF, (7-5; 0-1 American), 21, 33, 0, 54
400591154, 2014-12-31, S Carolina St, (4-11; 2-0 MEAC), 32, 22, 0, 54, Fordham, (5-6; 5-2 home), 37, 37, 0, 74
400595440, 2014-12-31, Penn State, (12-2; 0-1 Big Ten), 36, 36, 0, 72, Wisconsin, (13-1; 1-0 Big Ten), 43, 46, 0, 89
400586763, 2014-12-31, Temple, (10-4; 1-0 American), 25, 26, 6, 57, UConn, (6-5; 0-1 American), 21, 30, 2, 53
400587890, 2014-12-31, Princeton, (5-9; 0-6 away), 20, 46, 0, 66, Wake Forest, (8-6; 0-1 ACC), 32, 48, 0, 80
400588713, 2014-12-31, N Kentucky, (6-8; 2-6 away), 41, 33, 0, 74, Youngstown St, (9-6; 5-2 home), 40, 38, 0, 78
400589149, 2014-12-31, East Tenn St, (6-4; 1-1 Southern), 31, 30, 0, 61, Tennessee, (8-4; 7-0 home), 32, 39, 0, 71
400589336, 2014-12-31, Longwood, (4-10; 0-1 Big South), 35, 30, 7, 72, Winthrop, (6-6; 1-0 Big South), 33, 32, 17, 82
400590782, 2014-12-31, Chicago State, (4-12; 0-9 away), 20, 30, 0, 50, Green Bay, (11-3; 6-0 home), 23, 31, 0, 54
400591279, 2014-12-31, Dartmouth, (6-6; 3-5 away), 35, 41, 0, 76, Bryant, (3-6; 1-2 home), 25, 34, 0, 59
400586392, 2014-12-31, Bradley, (5-9; 0-1 MVC), 23, 26, 0, 49, Loyola (CHI), (11-2; 1-0 MVC), 37, 27, 0, 64
400586760, 2014-12-31, Houston, (7-5; 0-1 American), 35, 19, 0, 54, Memphis, (8-4; 1-0 American), 37, 36, 0, 73
400587120, 2014-12-31, Colgate, (4-10; 1-0 Patriot), 34, 34, 0, 68, Lehigh, (6-6; 0-1 Patriot), 29, 32, 0, 61
400589148, 2014-12-31, Non D-I School, NA, 25, 23, 0, 48, UNC Greensboro, (5-9; 1-0 Southern), 42, 50, 0, 92
400589337, 2014-12-31, Liberty, (6-8; 0-1 Big South), 19, 27, 0, 46, Campbell, (7-7; 1-0 Big South), 20, 33, 0, 53
400591153, 2014-12-31, Vanderbilt, (9-3; 1-1 away), 33, 37, 0, 70, Saint Louis, (8-5; 6-3 home), 26, 29, 0, 55
400587124, 2014-12-31, Boston U, (5-7; 1-0 Patriot), 40, 24, 11, 75, Holy Cross, (5-6; 0-1 Patriot), 36, 28, 8, 72
400588395, 2014-12-31, Butler, (10-4; 0-1 Big East), 32, 23, 0, 55, Villanova, (13-0; 1-0 Big East), 36, 31, 0, 67
400587121, 2014-12-31, American U, (7-6; 0-1 Patriot), 22, 25, 0, 47, Bucknell, (6-8; 1-0 Patriot), 22, 35, 0, 57
400587889, 2014-12-31, Wofford, (9-4; 2-4 away), 34, 21, 0, 55, Duke, (12-0; 7-0 home), 41, 43, 0, 84
400587122, 2014-12-31, Lafayette, (9-3; 1-0 Patriot), 43, 49, 0, 92, Army, (9-3; 0-1 Patriot), 33, 45, 0, 78
400588712, 2014-12-31, North Florida, (7-8; 3-7 away), 37, 23, 0, 60, Austin Peay, (5-8; 4-1 home), 31, 34, 0, 65
400588714, 2014-12-31, Kennesaw St, (4-11; 1-8 away), 24, 38, 0, 62, Tennessee St, (3-12; 3-2 home), 30, 43, 0, 73
400595439, 2014-12-31, Minnesota, (11-3; 0-1 Big Ten), 36, 32, 0, 68, Purdue, (9-5; 1-0 Big Ten), 25, 47, 0, 72
400585774, 2014-12-31, Georgia, (8-3; 2-1 away), 20, 30, 0, 50, Kansas State, (7-6; 5-2 home), 12, 34, 0, 46
400586391, 2014-12-31, Indiana State, (5-8; 1-0 MVC), 23, 40, 0, 63, Illinois State, (8-5; 0-1 MVC), 25, 36, 0, 61
400587123, 2014-12-31, Loyola (MD), (4-8; 0-1 Patriot), 28, 19, 0, 47, Navy, (5-8; 1-0 Patriot), 37, 33, 0, 70
400589338, 2014-12-31, UNC Asheville, (5-7; 1-0 Big South), 31, 31, 0, 62, Radford, (9-5; 0-1 Big South), 32, 28, 0, 60
400591155, 2014-12-31, Brown, (7-7; 2-4 away), 28, 32, 0, 60, URI, (8-3; 6-0 home), 46, 34, 0, 80
400591156, 2014-12-31, Northeastern, (8-4; 3-3 away), 23, 35, 0, 58, Richmond, (7-6; 6-2 home), 35, 22, 0, 57
400591737, 2014-12-31, Hofstra, (9-4; 4-3 away), 47, 37, 0, 84, Cent Conn St, (2-11; 1-3 home), 25, 31, 0, 56
400595625, 2014-12-31, Non D-I School, NA, 35, 33, 0, 68, Northwestern St, (5-6; 4-1 home), 51, 43, 0, 94
400585775, 2014-12-31, George Mason, (5-7; 1-2 away), 23, 20, 0, 43, Oklahoma, (9-3; 6-0 home), 37, 24, 0, 61
400586762, 2014-12-31, USF, (6-8; 0-1 American), 15, 34, 0, 49, SMU, (10-3; 1-0 American), 49, 34, 0, 83
400588396, 2014-12-31, Marquette, (8-5; 0-1 Big East), 32, 26, 0, 58, DePaul, (7-7; 1-0 Big East), 26, 35, 0, 61
400590781, 2014-12-31, Non D-I School, NA, 14, 22, 0, 36, CSU Bakersfield, (4-10; 2-3 home), 43, 44, 0, 87
400591613, 2014-12-31, Air Force, (7-5; 0-1 MW), 19, 30, 0, 49, San Diego State, (11-3; 1-0 MW), 33, 20, 0, 53
400595936, 2014-12-31, Hampden,  , 18, 35, 0, 53, UC Irvine, (7-6; 4-1 home), 35, 47, 0, 82
400595438, 2014-12-31, Indiana, (11-3; 1-0 Big Ten), 40, 30, 0, 70, Nebraska, (8-5; 0-1 Big Ten), 32, 33, 0, 65
400587891, 2014-12-31, Cornell, (6-7; 3-3 away), 12, 32, 0, 44, Syracuse, (9-4; 8-1 home), 23, 38, 0, 61
400589339, 2014-12-31, Gardner-Webb, (9-5; 1-0 Big South), 41, 40, 0, 81, Presbyterian, (4-10; 0-1 Big South), 32, 32, 0, 64
400586394, 2014-12-31, Wichita State, (11-2; 1-0 MVC), 29, 37, 0, 66, Drake, (3-10; 0-1 MVC), 25, 33, 0, 58
400586393, 2014-12-31, Missouri State, (7-6; 1-0 MVC), 26, 27, 0, 53, S Illinois, (7-7; 0-1 MVC), 15, 35, 0, 50
400585776, 2014-12-31, Miss Valley St, (1-12; 0-11 away), 18, 15, 0, 33, Iowa State, (10-1; 7-0 home), 47, 36, 0, 83
400589340, 2014-12-31, Coast Carolina, (10-3; 1-0 Big South), 43, 40, 0, 83, High Point, (9-4; 0-1 Big South), 34, 34, 0, 68
400591614, 2014-12-31, Fresno State, (5-9; 0-1 MW), 29, 35, 0, 64, New Mexico, (9-4; 1-0 MW), 36, 40, 0, 76
400588397, 2014-12-31, Creighton, (9-5; 0-1 Big East), 28, 25, 0, 53, Providence, (11-3; 1-0 Big East), 32, 33, 0, 65
400591615, 2014-12-31, Boise State, (10-4; 0-1 MW), 33, 32, 0, 65, Colorado State, (14-0; 1-0 MW), 28, 43, 0, 71
400591616, 2014-12-31, San Jose State, (2-11; 0-1 MW), 12, 21, 0, 33, Utah State, (8-5; 1-0 MW), 35, 26, 0, 61
400591617, 2014-12-31, UNLV, (9-4; 0-1 MW), 37, 34, 0, 71, Wyoming, (12-2; 1-0 MW), 33, 43, 0, 76
400588398, 2014-12-31, Georgetown, (8-4; 0-1 Big East), 25, 28, 0, 53, Xavier, (10-3; 1-0 Big East), 31, 39, 0, 70
400596355, 2015-01-01, SE Missouri St, (6-8; 0-1 OVC), 41, 36, 0, 77, Belmont, (9-5; 1-0 OVC), 47, 31, 0, 78
400596357, 2015-01-01, Non D-I School, NA, 25, 36, 0, 61, UT Martin, (8-5; 3-1 home), 31, 53, 0, 84
400596358, 2015-01-01, Jacksonville St, (7-8; 0-1 OVC), 22, 35, 0, 57, SIU-ED, (5-7; 1-0 OVC), 35, 38, 0, 73
400585998, 2015-01-01, North Dakota, (5-7; 1-0 Big Sky), 28, 39, 0, 67, Montana State, (3-10; 0-1 Big Sky), 22, 38, 0, 60
400587285, 2015-01-01, Pacific, (9-6; 1-2 WCC), 36, 41, 0, 77, Loyola Mary, (4-10; 0-2 WCC), 27, 36, 0, 63
400596356, 2015-01-01, Tenn Tech, (8-6; 0-1 OVC), 24, 35, 0, 59, E Illinois, (7-6; 1-0 OVC), 23, 38, 0, 61
400585999, 2015-01-01, Weber State, (5-7; 0-1 Big Sky), 36, 42, 0, 78, E Washington, (10-4; 1-0 Big Sky), 38, 46, 0, 84
400587284, 2015-01-01, BYU, (12-4; 2-1 WCC), 41, 40, 0, 81, Santa Clara, (6-8; 1-2 WCC), 22, 24, 0, 46
400586395, 2015-01-01, Northern Iowa, (11-2; 0-1 MVC), 30, 19, 0, 49, Evansville, (11-2; 1-0 MVC), 20, 32, 0, 52
400587286, 2015-01-01, Saint Mary's, (10-3; 3-0 WCC), 32, 36, 0, 68, Pepperdine, (8-5; 1-1 WCC), 21, 38, 0, 59
400586003, 2015-01-01, N Colorado, (5-7; 0-1 Big Sky), 21, 27, 0, 48, Montana, (4-7; 1-0 Big Sky), 33, 33, 0, 66
400586000, 2015-01-01, Idaho State, (3-10; 0-1 Big Sky), 21, 33, 0, 54, Idaho, (6-6; 1-0 Big Sky), 40, 37, 0, 77
400586002, 2015-01-01, Southern Utah, (3-9; 0-1 Big Sky), 36, 32, 0, 68, Portland State, (7-4; 1-0 Big Sky), 40, 31, 0, 71
400587287, 2015-01-01, San Diego, (8-7; 1-2 WCC), 28, 29, 0, 57, San Francisco, (7-8; 1-2 WCC), 33, 23, 0, 56
400586001, 2015-01-01, N Arizona, (5-9; 0-1 Big Sky), 27, 46, 0, 73, Sacramento St, (7-5; 1-0 Big Sky), 31, 47, 0, 78
400593241, 2015-01-02, Washington St, (6-7; 0-1 Pac-12), 24, 32, 0, 56, Stanford, (9-3; 1-0 Pac-12), 27, 44, 0, 71
400586247, 2015-01-02, St Peter's, (7-7; 1-2 MAAC), 29, 37, 0, 66, Quinnipiac, (6-6; 0-3 MAAC), 21, 39, 0, 60
400597785, 2015-01-02, Youngstown St, (9-7; 0-1 Horizon), 37, 34, 0, 71, UIC, (5-11; 1-0 Horizon), 28, 49, 0, 77
400586215, 2015-01-02, Monmouth, (6-7; 3-0 MAAC), 32, 41, 0, 73, Canisius, (7-5; 2-1 MAAC), 34, 34, 0, 68
400586216, 2015-01-02, Siena, (5-7; 2-1 MAAC), 32, 36, 0, 68, Fairfield, (4-9; 2-1 MAAC), 34, 33, 0, 67
400586217, 2015-01-02, Manhattan, (4-8; 1-2 MAAC), 24, 37, 0, 61, Niagara, (3-8; 2-1 MAAC), 42, 31, 0, 73
400587478, 2015-01-02, UT Pan American, (5-9; 1-8 away), 25, 29, 0, 54, Kent State, (9-4; 5-2 home), 40, 34, 0, 74
400587479, 2015-01-02, Non D-I School, NA, 43, 37, 0, 80, Cent Michigan, (10-1; 8-0 home), 68, 57, 0, 125
400588715, 2015-01-02, Non D-I School, NA, 13, 23, 0, 36, FGCU, (10-5; 6-1 home), 12, 37, 0, 49
400588716, 2015-01-02, North Florida, (7-9; 3-8 away), 37, 24, 0, 61, Alabama, (10-3; 9-0 home), 45, 31, 0, 76
400589151, 2015-01-02, VMI, (5-9; 1-2 Southern), 44, 44, 0, 88, East Tenn St, (7-4; 2-1 Southern), 50, 48, 0, 98
400596472, 2015-01-02, Binghamton, (1-15; 0-1 Am. East), 23, 17, 0, 40, UMass Lowell, (7-6; 1-0 Am. East), 20, 30, 0, 50
400597724, 2015-01-02, NJIT, (7-9; 4-8 away), 26, 44, 0, 70, UMBC, (2-11; 1-4 home), 24, 31, 0, 55
400597732, 2015-01-02, Milwaukee, (5-10; 0-1 Horizon), 30, 27, 0, 57, Cleveland State, (7-8; 1-0 Horizon), 27, 57, 0, 84
400597752, 2015-01-02, Detroit, (6-9; 0-1 Horizon), 24, 33, 0, 57, Wright State, (9-6; 1-0 Horizon), 26, 44, 0, 70
400597810, 2015-01-02, Valparaiso, (13-3; 0-1 Horizon), 31, 40, 4, 75, Oakland, (5-10; 1-0 Horizon), 36, 35, 18, 89
400601250, 2015-01-02, Rider, (8-6; 2-1 MAAC), 29, 40, 0, 69, Marist, (1-12; 0-3 MAAC), 29, 30, 0, 59
400751636, 2015-01-02, Non D-I School, NA, 19, 35, 0, 54, W Michigan, (9-4; 5-0 home), 36, 33, 0, 69
400586952, 2015-01-02, Oral Roberts, (6-8; 0-1 Summit), 34, 32, 0, 66, North Dakota St, (9-5; 1-0 Summit), 34, 38, 0, 72
400586953, 2015-01-02, Omaha, (7-6; 1-0 Summit), 29, 57, 0, 86, South Dakota, (6-9; 0-1 Summit), 41, 36, 0, 77
400586954, 2015-01-02, IPFW, (7-7; 0-1 Summit), 29, 38, 0, 67, W Illinois, (6-6; 1-0 Summit), 28, 45, 0, 73
400587480, 2015-01-02, UC Riverside, (7-6; 1-5 away), 21, 37, 9, 67, N Illinois, (6-5; 6-0 home), 30, 28, 14, 72
400587892, 2015-01-02, FSU, (8-6; 0-1 ACC), 25, 30, 0, 55, Miss St, (7-6; 6-2 home), 22, 40, 0, 62
400591423, 2015-01-02, UTEP, (9-4; 1-0 C-USA), 44, 41, 0, 85, North Texas, (6-7; 0-1 C-USA), 33, 38, 0, 71
400591424, 2015-01-02, UTSA, (5-6; 0-1 C-USA), 22, 30, 0, 52, Rice, (4-8; 1-0 C-USA), 29, 38, 0, 67
400586951, 2015-01-02, South Dakota St, (9-6; 0-1 Summit), 28, 41, 0, 69, Denver, (7-7; 1-0 Summit), 39, 37, 0, 76
400593242, 2015-01-02, Washington, (11-2; 0-1 Pac-12), 32, 43, 0, 75, Cal, (11-3; 1-0 Pac-12), 27, 54, 0, 81
400593243, 2015-01-02, UCLA, (8-6; 0-1 Pac-12), 27, 29, 0, 56, Colorado, (8-5; 1-0 Pac-12), 28, 34, 0, 62
400595937, 2015-01-02, Morgan State, (2-13; 0-2 MEAC), 40, 22, 0, 62, CS Northridge, (4-11; 3-4 home), 45, 33, 0, 78
400595938, 2015-01-02, UVM, (5-8; 1-0 Am. East), 28, 29, 0, 57, UCSB, (6-7; 4-1 home), 32, 32, 0, 64
400593244, 2015-01-02, USC, (8-5; 0-1 Pac-12), 22, 33, 0, 55, Utah, (11-2; 1-0 Pac-12), 39, 40, 0, 79
400586768, 2015-01-03, SMU, (10-4; 1-1 American), 22, 28, 0, 50, Cincinnati, (10-3; 1-0 American), 19, 37, 0, 56
400588399, 2015-01-03, Villanova, (13-1; 1-1 Big East), 27, 31, 3, 61, Seton Hall, (12-2; 2-0 Big East), 31, 27, 8, 66
400595441, 2015-01-03, Minnesota, (11-4; 0-2 Big Ten), 33, 25, 0, 58, Maryland, (14-1; 2-0 Big Ten), 36, 34, 0, 70
400585777, 2015-01-03, Kansas State, (7-7; 0-1 Big 12), 29, 18, 0, 47, Oklahoma State, (11-2; 1-0 Big 12), 27, 34, 0, 61
400587893, 2015-01-03, Pitt, (10-4; 0-1 ACC), 20, 30, 0, 50, NC State, (11-4; 2-0 ACC), 27, 41, 0, 68
400587898, 2015-01-03, Syracuse, (10-4; 1-0 ACC), 42, 26, 0, 68, VT, (8-6; 0-1 ACC), 23, 43, 0, 66
400587125, 2015-01-03, Holy Cross, (5-7; 0-2 Patriot), 21, 28, 0, 49, American U, (8-6; 1-1 Patriot), 27, 26, 0, 53
400587129, 2015-01-03, Lehigh, (6-7; 0-2 Patriot), 24, 32, 0, 56, Boston U, (6-7; 2-0 Patriot), 37, 38, 0, 75
400588719, 2015-01-03, Florida A&M, (0-13; 0-1 MEAC), 18, 42, 0, 60, Stetson, (5-10; 5-3 home), 27, 38, 0, 65
400589342, 2015-01-03, High Point, (10-4; 1-1 Big South), 33, 32, 25, 90, Winthrop, (6-7; 1-1 Big South), 25, 40, 22, 87
400591157, 2015-01-03, Duquesne, (5-7; 0-1 A 10), 22, 33, 0, 55, Dayton, (11-2; 1-0 A 10), 39, 42, 0, 81
400597312, 2015-01-03, North Alabama,  , 30, 31, 0, 61, Auburn, (8-5; 7-1 home), 32, 50, 0, 82
400585778, 2015-01-03, Texas, (12-2; 1-0 Big 12), 31, 39, 0, 70, Texas Tech, (10-4; 0-1 Big 12), 22, 39, 0, 61
400586767, 2015-01-03, UConn, (7-5; 0-1 American), 31, 32, 0, 63, Florida, (7-6; 5-2 home), 37, 22, 0, 59
400587126, 2015-01-03, Bucknell, (6-9; 1-1 Patriot), 33, 29, 0, 62, Colgate, (5-10; 2-0 Patriot), 20, 48, 0, 68
400587127, 2015-01-03, Navy, (6-8; 2-0 Patriot), 32, 37, 0, 69, Lafayette, (9-4; 1-1 Patriot), 26, 39, 0, 65
400587128, 2015-01-03, Army, (10-3; 1-1 Patriot), 36, 41, 0, 77, Loyola (MD), (4-9; 0-2 Patriot), 32, 21, 0, 53
400587481, 2015-01-03, Bethune-Cookman, (3-11; 0-1 MEAC), 27, 21, 0, 48, Ball State, (5-6; 5-1 home), 20, 31, 0, 51
400588400, 2015-01-03, Providence, (11-4; 1-1 Big East), 33, 33, 0, 66, Marquette, (9-5; 1-1 Big East), 33, 42, 0, 75
400588401, 2015-01-03, Xavier, (10-4; 1-1 Big East), 28, 40, 0, 68, DePaul, (8-7; 2-0 Big East), 26, 45, 0, 71
400588720, 2015-01-03, Thomas (GA),  , 31, 35, 0, 66, Kennesaw St, (5-11; 3-3 home), 52, 40, 0, 92
400589155, 2015-01-03, The Citadel, (5-8; 0-2 Southern), 36, 34, 0, 70, W Carolina, (6-8; 1-1 Southern), 37, 41, 0, 78
400589341, 2015-01-03, Charleston So, (6-6; 0-1 Big South), 36, 38, 0, 74, Coast Carolina, (11-3; 2-0 Big South), 36, 47, 0, 83
400589343, 2015-01-03, Gardner-Webb, (9-6; 1-1 Big South), 24, 31, 0, 55, UNC Asheville, (6-7; 2-0 Big South), 41, 39, 0, 80
400591329, 2015-01-03, Yale, (10-5; 5-4 away), 29, 30, 15, 74, Vanderbilt, (10-3; 8-1 home), 24, 35, 20, 79
400591618, 2015-01-03, Utah State, (9-5; 2-0 MW), 41, 21, 0, 62, Boise State, (10-5; 0-2 MW), 31, 30, 0, 61
400596364, 2015-01-03, Austin Peay, (5-9; 0-7 away), 29, 34, 0, 63, Ole Miss, (9-4; 4-3 home), 42, 50, 0, 92
400597313, 2015-01-03, Norfolk State, (9-7; 2-0 MEAC), 23, 27, 0, 50, Georgia, (9-3; 7-0 home), 36, 27, 0, 63
400597835, 2015-01-03, Charleston, (5-9; 0-1 CAA), 23, 22, 0, 45, William & Mary, (7-5; 1-0 CAA), 36, 39, 0, 75
400597854, 2015-01-03, Northeastern, (9-4; 1-0 CAA), 32, 40, 0, 72, Delaware, (1-11; 0-1 CAA), 22, 31, 0, 53
400597902, 2015-01-03, Hofstra, (10-4; 1-0 CAA), 25, 43, 0, 68, UNC-Wilmington, (5-7; 0-1 CAA), 36, 20, 0, 56
400599613, 2015-01-03, G Washington, (11-3; 1-0 A 10), 31, 33, 0, 64, Saint Joe's, (6-6; 0-1 A 10), 18, 42, 0, 60
400595248, 2015-01-03, AR-Little Rock, (5-7; 0-2 Sun Belt), 32, 37, 0, 69, Georgia State, (9-4; 2-0 Sun Belt), 37, 45, 0, 82
400595442, 2015-01-03, Michigan, (8-6; 1-1 Big Ten), 33, 18, 0, 51, Purdue, (10-5; 2-0 Big Ten), 25, 39, 0, 64
400587894, 2015-01-03, Georgia Tech, (9-4; 0-1 ACC), 31, 28, 17, 76, Notre Dame, (14-1; 2-0 ACC), 27, 32, 24, 83
400597690, 2015-01-03, UNH, (6-7; 0-1 Am. East), 22, 39, 0, 61, Stony Brook, (9-6; 1-0 Am. East), 25, 46, 0, 71
400589154, 2015-01-03, Wofford, (10-4; 1-0 Southern), 25, 43, 0, 68, Samford, (7-9; 0-3 Southern), 24, 41, 0, 65
400597314, 2015-01-03, Utah Valley, (5-9; 2-7 away), 23, 23, 0, 46, Arkansas, (11-2; 10-0 home), 42, 37, 0, 79
400599785, 2015-01-03, URI, (9-3; 1-0 A 10), 27, 38, 0, 65, Saint Louis, (8-6; 0-1 A 10), 27, 26, 0, 53
400595443, 2015-01-03, Illinois, (10-5; 0-2 Big Ten), 37, 24, 0, 61, OSU, (12-3; 1-1 Big Ten), 36, 41, 0, 77
400587483, 2015-01-03, UMKC, (5-11; 2-8 away), 24, 37, 0, 61, Miami (OH), (5-8; 5-3 home), 26, 40, 0, 66
400587486, 2015-01-03, Cornell, (6-8; 3-4 away), 39, 34, 0, 73, Buffalo, (9-3; 4-0 home), 41, 51, 0, 92
400591738, 2015-01-03, Fair Dickinson, (6-6; 1-0 NEC), 31, 42, 0, 73, Cent Conn St, (2-12; 0-1 NEC), 33, 34, 0, 67
400596022, 2015-01-03, St Francis (BKN), (7-7; 1-0 NEC), 32, 41, 0, 73, Sacred Heart, (6-8; 0-1 NEC), 42, 29, 0, 71
400587897, 2015-01-03, Boston College, (7-5; 0-1 ACC), 22, 40, 0, 62, Duke, (13-0; 1-0 ACC), 38, 47, 0, 85
400588403, 2015-01-03, Butler, (11-4; 1-1 Big East), 26, 47, 0, 73, St John's, (11-3; 0-2 Big East), 30, 39, 0, 69
400585781, 2015-01-03, West Virginia, (13-1; 1-0 Big 12), 30, 48, 0, 78, TCU, (13-1; 0-1 Big 12), 32, 35, 0, 67
400585779, 2015-01-03, Baylor, (11-2; 0-1 Big 12), 33, 30, 0, 63, Oklahoma, (10-3; 1-0 Big 12), 37, 36, 0, 73
400586396, 2015-01-03, Drake, (3-11; 0-2 MVC), 22, 15, 0, 37, Missouri State, (8-6; 2-0 MVC), 35, 27, 0, 62
400587291, 2015-01-03, Saint Mary's, (11-3; 4-0 WCC), 29, 43, 0, 72, Loyola Mary, (4-11; 0-3 WCC), 24, 39, 0, 63
400587482, 2015-01-03, Toledo, (8-5; 3-4 away), 20, 37, 0, 57, N Kentucky, (6-9; 4-3 home), 34, 21, 0, 55
400588718, 2015-01-03, Hampton, (6-8; 2-0 MEAC), 22, 32, 0, 54, USC Upstate, (11-4; 8-1 home), 35, 33, 0, 68
400591794, 2015-01-03, Mt St Mary's, (4-8; 0-1 NEC), 16, 29, 0, 45, Robert Morris, (5-8; 1-0 NEC), 36, 34, 0, 70
400596044, 2015-01-03, Wagner, (2-10; 0-1 NEC), 33, 35, 0, 68, St Francis (PA), (7-5; 1-0 NEC), 41, 44, 0, 85
400597871, 2015-01-03, Elon, (9-5; 1-0 CAA), 46, 31, 0, 77, Drexel, (2-10; 0-1 CAA), 28, 39, 0, 67
400597914, 2015-01-03, Towson, (7-7; 0-1 CAA), 24, 28, 0, 52, JMU, (8-6; 1-0 CAA), 28, 33, 0, 61
400599776, 2015-01-03, St Bonaventure, (8-4; 1-0 A 10), 28, 41, 0, 69, UMass, (7-7; 0-1 A 10), 19, 36, 0, 55
400596359, 2015-01-03, Jacksonville St, (7-9; 0-2 OVC), 23, 23, 4, 50, E Illinois, (8-6; 2-0 OVC), 17, 29, 13, 59
400588402, 2015-01-03, Creighton, (9-6; 0-2 Big East), 31, 30, 0, 61, Georgetown, (9-4; 1-1 Big East), 33, 43, 0, 76
400591714, 2015-01-03, Bryant, (4-6; 1-0 NEC), 22, 45, 0, 67, LIU Brooklyn, (4-8; 0-1 NEC), 27, 36, 0, 63
400595626, 2015-01-03, SF Austin, (11-3; 1-0 Southland), 40, 40, 0, 80, McNeese State, (6-6; 0-1 Southland), 35, 40, 0, 75
400586005, 2015-01-03, N Colorado, (6-7; 1-1 Big Sky), 34, 28, 0, 62, Montana State, (3-11; 0-2 Big Sky), 23, 31, 0, 54
400588717, 2015-01-03, Lipscomb, (5-9; 1-8 away), 35, 25, 0, 60, Missouri, (6-7; 5-2 home), 33, 39, 0, 72
400589153, 2015-01-03, Mercer, (7-8; 2-0 Southern), 33, 43, 0, 76, UNC Greensboro, (5-10; 1-1 Southern), 25, 30, 0, 55
400589344, 2015-01-03, Radford, (9-6; 0-2 Big South), 29, 29, 21, 79, Longwood, (5-10; 1-1 Big South), 31, 27, 32, 90
400591158, 2015-01-03, Richmond, (7-7; 0-1 A 10), 32, 35, 0, 67, Davidson, (10-2; 1-0 A 10), 45, 36, 0, 81
400596489, 2015-01-03, Hartford, (7-7; 0-1 Am. East), 17, 32, 0, 49, Texas A&M, (9-3; 7-0 home), 23, 35, 0, 58
400586009, 2015-01-03, Idaho State, (3-11; 0-2 Big Sky), 27, 30, 0, 57, E Washington, (11-4; 2-0 Big Sky), 30, 35, 0, 65
400587895, 2015-01-03, UVA, (13-0; 1-0 ACC), 38, 25, 26, 89, Miami (FL), (10-4; 0-1 ACC), 20, 43, 17, 80
400595628, 2015-01-03, Incarnate Word, (8-3; 0-1 Southland), 38, 40, 0, 78, Sam Houston, (9-4; 1-0 Southland), 47, 37, 0, 84
400585780, 2015-01-03, South Carolina, (9-3; 1-0 away), 36, 28, 0, 64, Iowa State, (10-2; 7-0 home), 35, 25, 0, 60
400586766, 2015-01-03, Tulane, (11-3; 2-0 American), 29, 45, 0, 74, Memphis, (8-5; 1-1 American), 29, 37, 0, 66
400591619, 2015-01-03, Air Force, (7-6; 0-2 MW), 21, 41, 0, 62, Nevada, (5-8; 1-0 MW), 34, 46, 0, 80
400598791, 2015-01-03, Grambling St, (2-9; 0-1 SWAC), 28, 22, 0, 50, Alabama State, (5-5; 1-0 SWAC), 28, 43, 0, 71
400591018, 2015-01-03, PV A&M, (2-12; 0-1 SWAC), 32, 24, 0, 56, Southern, (4-11; 1-0 SWAC), 27, 41, 0, 68
400591068, 2015-01-03, Texas Southern, (4-10; 1-0 SWAC), 41, 31, 0, 72, Alcorn State, (1-12; 0-1 SWAC), 18, 37, 0, 55
400586765, 2015-01-03, ECU, (7-8; 0-2 American), 27, 23, 0, 50, USF, (7-8; 1-1 American), 25, 33, 0, 58
400587484, 2015-01-03, Chicago State, (4-13; 0-10 away), 14, 21, 0, 35, Bowling Green, (8-3; 5-1 home), 39, 19, 0, 58
400587485, 2015-01-03, Coppin State, (1-14; 0-2 MEAC), 33, 29, 0, 62, Akron, (9-4; 7-1 home), 43, 36, 0, 79
400589152, 2015-01-03, Furman, (3-9; 1-1 Southern), 32, 28, 0, 60, Chattanooga, (9-6; 2-0 Southern), 36, 36, 0, 72
400589345, 2015-01-03, Presbyterian, (5-10; 1-1 Big South), 31, 31, 0, 62, Liberty, (6-9; 0-2 Big South), 24, 34, 0, 58
400590783, 2015-01-03, CSU Bakersfield, (4-11; 1-5 away), 34, 36, 0, 70, NC A&T, (3-13; 0-2 MEAC), 36, 47, 0, 83
400595247, 2015-01-03, Texas State, (7-4; 1-1 Sun Belt), 21, 15, 0, 36, Ga Southern, (8-3; 1-1 Sun Belt), 19, 21, 0, 40
400595939, 2015-01-03, Non D-I School, NA, 16, 30, 0, 46, LBSU, (6-10; 4-0 home), 31, 50, 0, 81
400596360, 2015-01-03, S Carolina St, (4-12; 2-0 MEAC), 24, 28, 0, 52, E Kentucky, (8-5; 4-2 home), 35, 28, 0, 63
400596456, 2015-01-03, Maine, (1-12; 0-1 Am. East), 33, 23, 0, 56, Albany, (6-7; 1-0 Am. East), 39, 41, 0, 80
400599600, 2015-01-03, La Salle, (8-6; 0-1 A 10), 34, 28, 0, 62, George Mason, (6-7; 1-0 A 10), 31, 39, 0, 70
400597315, 2015-01-03, Savannah State, (3-10; 0-10 away), 25, 34, 0, 59, LSU, (11-2; 8-0 home), 31, 44, 0, 75
400595629, 2015-01-03, Nicholls State, (3-8; 0-1 Southland), 31, 31, 0, 62, Lamar, (7-6; 1-0 Southland), 23, 52, 0, 75
400591044, 2015-01-03, Jackson State, (3-11; 1-0 SWAC), 43, 27, 0, 70, Alabama A&M, (1-10; 0-1 SWAC), 41, 26, 0, 67
400595444, 2015-01-03, Penn State, (12-3; 0-2 Big Ten), 19, 27, 0, 46, Rutgers, (9-6; 1-1 Big Ten), 30, 20, 0, 50
400596361, 2015-01-03, Tenn Tech, (8-7; 0-2 OVC), 26, 36, 0, 62, SIU-ED, (6-7; 2-0 OVC), 35, 50, 0, 85
400596363, 2015-01-03, Murray State, (11-4; 1-0 OVC), 31, 35, 0, 66, Morehead State, (5-11; 0-1 OVC), 26, 31, 0, 57
400586397, 2015-01-03, S Illinois, (7-8; 0-2 MVC), 19, 25, 0, 44, Bradley, (6-9; 1-1 MVC), 33, 30, 0, 63
400587290, 2015-01-03, Pacific, (9-7; 1-3 WCC), 19, 42, 0, 61, Pepperdine, (9-5; 2-1 WCC), 30, 41, 0, 71
400591425, 2015-01-03, LA Tech, (10-4; 1-0 C-USA), 45, 38, 0, 83, Southern Miss, (5-7; 0-1 C-USA), 29, 41, 0, 70
400593245, 2015-01-03, Oregon State, (9-4; 0-1 Pac-12), 27, 32, 0, 59, Oregon, (11-3; 1-0 Pac-12), 29, 42, 0, 71
400595630, 2015-01-03, Northwestern St, (6-6; 1-0 Southland), 54, 45, 0, 99, Houston Baptist, (5-6; 0-1 Southland), 37, 41, 0, 78
400595246, 2015-01-03, Appalachian St, (4-6; 1-0 Sun Belt), 30, 44, 0, 74, Arkansas State, (6-5; 1-1 Sun Belt), 37, 36, 0, 73
400591620, 2015-01-03, Colorado State, (14-1; 1-1 MW), 26, 27, 0, 53, New Mexico, (10-4; 2-0 MW), 35, 31, 0, 66
400587896, 2015-01-03, UNC, (11-3; 1-0 ACC), 39, 35, 0, 74, Clemson, (8-5; 0-1 ACC), 17, 33, 0, 50
400595250, 2015-01-03, South Alabama, (2-10; 0-2 Sun Belt), 34, 53, 0, 87, UT-Arlington, (8-4; 2-0 Sun Belt), 55, 44, 0, 99
400595249, 2015-01-03, Troy, (5-6; 0-2 Sun Belt), 31, 33, 0, 64, LA-Lafayette, (8-5; 2-0 Sun Belt), 39, 52, 0, 91
400598818, 2015-01-03, Miss Valley St, (2-12; 1-0 SWAC), 34, 33, 0, 67, AR-Pine Bluff, (3-12; 0-1 SWAC), 31, 32, 0, 63
400596362, 2015-01-03, SE Missouri St, (7-8; 1-1 OVC), 42, 35, 0, 77, Tennessee St, (3-13; 0-1 OVC), 30, 32, 0, 62
400586004, 2015-01-03, North Dakota, (5-8; 1-1 Big Sky), 29, 34, 0, 63, Montana, (5-7; 2-0 Big Sky), 35, 39, 0, 74
400595940, 2015-01-03, Seattle, (7-7; 1-3 away), 23, 32, 0, 55, CS Fullerton, (8-7; 5-1 home), 38, 29, 0, 67
400595941, 2015-01-03, UC Irvine, (7-7; 1-6 away), 33, 34, 0, 67, New Mexico St, (7-9; 7-2 home), 36, 34, 0, 70
400587289, 2015-01-03, Gonzaga, (14-1; 3-0 WCC), 43, 44, 0, 87, Portland, (10-5; 1-2 WCC), 28, 47, 0, 75
400586006, 2015-01-03, Weber State, (5-8; 0-2 Big Sky), 36, 48, 0, 84, Idaho, (7-6; 2-0 Big Sky), 44, 42, 0, 86
400586007, 2015-01-03, Southern Utah, (3-10; 0-2 Big Sky), 37, 38, 0, 75, Sacramento St, (8-5; 2-0 Big Sky), 52, 38, 0, 90
400587292, 2015-01-03, San Diego, (8-8; 1-3 WCC), 29, 27, 0, 56, Santa Clara, (7-8; 2-2 WCC), 29, 30, 0, 59
400591621, 2015-01-03, Wyoming, (13-2; 2-0 MW), 23, 41, 0, 64, San Jose State, (2-12; 0-2 MW), 31, 28, 0, 59
400591622, 2015-01-03, San Diego State, (11-4; 1-1 MW), 19, 38, 0, 57, Fresno State, (6-9; 1-1 MW), 34, 25, 0, 59
400595942, 2015-01-03, Non D-I School, NA, 15, 26, 0, 41, UC Davis, (10-3; 6-0 home), 42, 36, 0, 78
400586008, 2015-01-03, N Arizona, (6-9; 1-1 Big Sky), 34, 39, 0, 73, Portland State, (7-5; 1-1 Big Sky), 27, 33, 0, 60
400587288, 2015-01-03, BYU, (13-4; 3-1 WCC), 57, 42, 0, 99, San Francisco, (7-9; 1-3 WCC), 29, 39, 0, 68
400595627, 2015-01-03, Cent Arkansas, (2-27; 2-16 Southland),  ,  , 0, 0, Abil Christian, (10-21; 4-14 Southland),  ,  , 0, 0
400586770, 2015-01-04, UCF, (7-6; 0-2 American), 26, 52, 0, 78, Temple, (11-4; 2-0 American), 38, 46, 0, 84
400591159, 2015-01-04, VCU, (11-3; 1-0 A 10), 37, 38, 0, 75, Fordham, (5-7; 0-1 A 10), 30, 28, 0, 58
400591426, 2015-01-04, Old Dominion, (12-1; 1-0 C-USA), 29, 32, 0, 61, Charlotte, (6-7; 0-1 C-USA), 18, 36, 0, 54
400597753, 2015-01-04, Milwaukee, (5-11; 0-2 Horizon), 27, 40, 0, 67, Detroit, (7-9; 1-1 Horizon), 37, 46, 0, 83
400586398, 2015-01-04, Evansville, (11-3; 1-1 MVC), 30, 40, 5, 75, Indiana State, (6-8; 2-0 MVC), 31, 39, 9, 79
400586219, 2015-01-04, Manhattan, (5-8; 2-2 MAAC), 34, 29, 0, 63, Canisius, (7-6; 2-2 MAAC), 31, 29, 0, 60
400586220, 2015-01-04, Iona, (9-5; 2-1 MAAC), 45, 41, 0, 86, Siena, (5-8; 2-2 MAAC), 35, 37, 0, 72
400586251, 2015-01-04, Monmouth, (7-7; 4-0 MAAC), 29, 37, 0, 66, Niagara, (3-9; 2-2 MAAC), 23, 27, 0, 50
400586769, 2015-01-04, Houston, (7-6; 0-2 American), 28, 26, 0, 54, Tulsa, (9-5; 2-0 American), 37, 35, 0, 72
400586958, 2015-01-04, Omaha, (7-7; 1-1 Summit), 33, 45, 0, 78, W Illinois, (7-6; 2-0 Summit), 30, 50, 0, 80
400591427, 2015-01-04, FIU, (8-6; 1-0 C-USA), 28, 34, 0, 62, FAU, (7-5; 0-1 C-USA), 25, 35, 0, 60
400593246, 2015-01-04, USC, (8-6; 0-2 Pac-12), 27, 38, 0, 65, Colorado, (9-5; 2-0 Pac-12), 43, 43, 0, 86
400597821, 2015-01-04, Youngstown St, (9-8; 0-2 Horizon), 35, 29, 0, 64, Valparaiso, (14-3; 1-1 Horizon), 40, 39, 0, 79
400586221, 2015-01-04, Marist, (1-13; 0-4 MAAC), 32, 35, 0, 67, St Peter's, (8-7; 2-2 MAAC), 44, 35, 0, 79
400586955, 2015-01-04, South Dakota, (7-9; 1-1 Summit), 29, 45, 0, 74, Denver, (7-8; 1-1 Summit), 34, 35, 0, 69
400591428, 2015-01-04, Marshall, (4-10; 0-1 C-USA), 29, 33, 0, 62, W Kentucky, (8-5; 1-0 C-USA), 39, 42, 0, 81
400591429, 2015-01-04, UAB, (5-9; 1-0 C-USA), 28, 26, 0, 54, Mid Tennessee, (7-7; 0-1 C-USA), 25, 24, 0, 49
400591430, 2015-01-04, UTSA, (6-6; 1-1 C-USA), 29, 42, 0, 71, North Texas, (6-8; 0-2 C-USA), 32, 29, 0, 61
400586399, 2015-01-04, Loyola (CHI), (11-3; 1-1 MVC), 28, 30, 0, 58, Northern Iowa, (12-2; 1-1 MVC), 32, 35, 0, 67
400591431, 2015-01-04, UTEP, (10-4; 2-0 C-USA), 30, 36, 0, 66, Rice, (4-9; 1-1 C-USA), 21, 36, 0, 57
400593247, 2015-01-04, UCLA, (8-7; 0-2 Pac-12), 15, 24, 0, 39, Utah, (12-2; 2-0 Pac-12), 32, 39, 0, 71
400597733, 2015-01-04, Cleveland State, (8-8; 2-0 Horizon), 37, 37, 0, 74, UIC, (5-12; 1-1 Horizon), 28, 41, 0, 69
400751535, 2015-01-04, Cent Arkansas, (0-12; 0-1 Southland), 34, 36, 0, 70, Abil Christian, (7-7; 1-0 Southland), 41, 46, 0, 87
400585782, 2015-01-04, UNLV, (9-5; 0-1 MW), 33, 28, 0, 61, Kansas, (11-2; 6-0 home), 29, 47, 0, 76
400586957, 2015-01-04, South Dakota St, (9-7; 0-2 Summit), 24, 45, 0, 69, North Dakota St, (10-5; 2-0 Summit), 40, 32, 0, 72
400586400, 2015-01-04, Illinois State, (8-6; 0-2 MVC), 23, 39, 0, 62, Wichita State, (12-2; 2-0 MVC), 29, 41, 0, 70
400590784, 2015-01-04, UC Riverside, (7-7; 1-6 away), 28, 41, 0, 69, Grand Canyon, (9-8; 8-5 home), 32, 39, 0, 71
400593248, 2015-01-04, Washington St, (7-7; 1-1 Pac-12), 24, 45, 0, 69, Cal, (11-4; 1-1 Pac-12), 20, 46, 0, 66
400593249, 2015-01-04, Arizona State, (8-6; 0-1 Pac-12), 25, 24, 0, 49, Arizona, (13-1; 1-0 Pac-12), 45, 28, 0, 73
400586956, 2015-01-04, IUPUI, (5-10; 1-0 Summit), 34, 29, 0, 63, IPFW, (7-8; 0-2 Summit), 25, 33, 0, 58
400587899, 2015-01-04, Louisville, (13-1; 1-0 ACC), 46, 39, 0, 85, Wake Forest, (8-7; 0-2 ACC), 35, 41, 0, 76
400595445, 2015-01-04, Wisconsin, (14-1; 2-0 Big Ten), 43, 38, 0, 81, Northwestern, (10-5; 1-1 Big Ten), 21, 37, 0, 58
400593250, 2015-01-04, Washington, (11-3; 0-2 Pac-12), 28, 28, 4, 60, Stanford, (10-3; 2-0 Pac-12), 28, 28, 12, 68
400591715, 2015-01-05, Bryant, (4-7; 1-1 NEC), 20, 27, 0, 47, St Francis (BKN), (8-7; 2-0 NEC), 34, 29, 0, 63
400587900, 2015-01-05, Notre Dame, (15-1; 3-0 ACC), 38, 33, 0, 71, UNC, (11-4; 1-1 ACC), 34, 36, 0, 70
400585783, 2015-01-05, West Virginia, (14-1; 2-0 Big 12), 32, 46, 0, 78, Texas Tech, (10-5; 0-2 Big 12), 29, 38, 0, 67
400586222, 2015-01-05, Rider, (9-6; 3-1 MAAC), 24, 38, 0, 62, Fairfield, (4-10; 2-2 MAAC), 13, 33, 0, 46
400589157, 2015-01-05, The Citadel, (6-8; 1-2 Southern), 32, 45, 8, 85, UNC Greensboro, (5-11; 1-2 Southern), 25, 52, 6, 83
400589159, 2015-01-05, Mercer, (8-8; 3-0 Southern), 30, 55, 0, 85, VMI, (5-10; 1-3 Southern), 34, 41, 0, 75
400591221, 2015-01-05, UMass Lowell, (7-7; 1-0 Am. East), 19, 30, 0, 49, Brown, (8-7; 5-2 home), 29, 29, 0, 58
400591795, 2015-01-05, Mt St Mary's, (4-9; 0-2 NEC), 31, 36, 16, 83, Wagner, (3-10; 1-1 NEC), 26, 41, 18, 85
400595446, 2015-01-05, Indiana, (11-4; 1-1 Big Ten), 17, 33, 0, 50, Michigan State, (10-5; 1-1 Big Ten), 36, 34, 0, 70
400597855, 2015-01-05, Delaware, (1-12; 0-2 CAA), 22, 36, 0, 58, Hofstra, (11-4; 2-0 CAA), 27, 44, 0, 71
400597872, 2015-01-05, William & Mary, (8-5; 2-0 CAA), 34, 39, 0, 73, Drexel, (2-11; 0-2 CAA), 29, 18, 0, 47
400597888, 2015-01-05, Elon, (9-6; 1-1 CAA), 22, 31, 0, 53, Towson, (8-7; 1-1 CAA), 28, 29, 0, 57
400597923, 2015-01-05, UNC-Wilmington, (6-7; 1-1 CAA), 34, 41, 0, 75, Northeastern, (9-5; 1-1 CAA), 31, 37, 0, 68
400598584, 2015-01-05, Non D-I School, NA, 35, 33, 0, 68, Delaware State, (6-8; 2-1 home), 50, 40, 0, 90
400598585, 2015-01-05, Non D-I School, NA, 39, 32, 0, 71, Bethune-Cookman, (4-11; 0-1 MEAC), 41, 56, 0, 97
400607107, 2015-01-05, St Rose,  , 21, 17, 0, 38, Harvard, (9-3; 7-0 home), 43, 41, 0, 84
400589160, 2015-01-05, Furman, (3-10; 1-2 Southern), 25, 28, 0, 53, W Carolina, (7-8; 2-1 Southern), 43, 29, 0, 72
400589346, 2015-01-05, Campbell, (7-8; 1-1 Big South), 34, 37, 0, 71, Charleston So, (7-6; 1-1 Big South), 34, 40, 0, 74
400591739, 2015-01-05, Cent Conn St, (2-13; 0-2 NEC), 23, 43, 0, 66, Sacred Heart, (7-8; 1-1 NEC), 38, 37, 0, 75
400591758, 2015-01-05, Fair Dickinson, (7-6; 2-0 NEC), 40, 35, 0, 75, LIU Brooklyn, (4-9; 0-2 NEC), 30, 39, 0, 69
400591813, 2015-01-05, Robert Morris, (5-9; 1-1 NEC), 26, 33, 0, 59, St Francis (PA), (8-5; 2-0 NEC), 31, 35, 0, 66
400595251, 2015-01-05, LA-Lafayette, (9-5; 3-0 Sun Belt), 38, 42, 0, 80, Appalachian St, (4-7; 1-1 Sun Belt), 24, 40, 0, 64
400595252, 2015-01-05, Texas State, (8-4; 2-1 Sun Belt), 17, 40, 20, 77, Georgia State, (9-5; 2-1 Sun Belt), 19, 38, 17, 74
400597836, 2015-01-05, JMU, (9-6; 2-0 CAA), 25, 36, 0, 61, Charleston, (5-10; 0-2 CAA), 26, 24, 0, 50
400589156, 2015-01-05, Wofford, (11-4; 2-0 Southern), 20, 48, 0, 68, Chattanooga, (9-7; 2-1 Southern), 30, 34, 0, 64
400589158, 2015-01-05, East Tenn St, (8-4; 3-1 Southern), 32, 44, 0, 76, Samford, (7-10; 0-4 Southern), 34, 40, 0, 74
400597770, 2015-01-05, Wright State, (9-7; 1-1 Horizon), 27, 28, 0, 55, Green Bay, (12-3; 1-0 Horizon), 34, 45, 0, 79
400588721, 2015-01-05, Rhodes,  , 28, 25, 0, 53, Lipscomb, (6-9; 5-1 home), 44, 46, 0, 90
400595253, 2015-01-05, UT-Arlington, (8-5; 2-1 Sun Belt), 36, 30, 0, 66, Troy, (6-6; 1-2 Sun Belt), 34, 37, 0, 71
400595255, 2015-01-05, Arkansas State, (6-6; 1-2 Sun Belt), 24, 37, 0, 61, UL Monroe, (7-6; 1-1 Sun Belt), 30, 40, 0, 70
400595633, 2015-01-05, Lamar, (7-7; 1-1 Southland), 18, 49, 0, 67, New Orleans, (5-5; 1-0 Southland), 28, 44, 0, 72
400585784, 2015-01-05, Oklahoma, (11-3; 2-0 Big 12), 33, 37, 0, 70, Texas, (12-3; 1-1 Big 12), 14, 35, 0, 49
400591019, 2015-01-05, Texas Southern, (5-10; 2-0 SWAC), 26, 33, 0, 59, Southern, (4-12; 1-1 SWAC), 26, 32, 0, 58
400591045, 2015-01-05, Jackson State, (3-12; 1-1 SWAC), 18, 34, 0, 52, Alabama State, (6-5; 2-0 SWAC), 28, 44, 0, 72
400591069, 2015-01-05, PV A&M, (2-13; 0-2 SWAC), 29, 33, 0, 62, Alcorn State, (2-12; 1-1 SWAC), 23, 45, 0, 68
400595254, 2015-01-05, South Alabama, (3-10; 1-2 Sun Belt), 37, 35, 0, 72, AR-Little Rock, (5-8; 0-3 Sun Belt), 33, 36, 0, 69
400595447, 2015-01-05, Nebraska, (8-6; 0-2 Big Ten), 28, 31, 0, 59, Iowa, (11-4; 2-0 Big Ten), 35, 35, 0, 70
400595631, 2015-01-05, Northwestern St, (6-7; 1-1 Southland), 26, 38, 0, 64, Sam Houston, (10-4; 2-0 Southland), 32, 43, 0, 75
400595632, 2015-01-05, Houston Baptist, (6-6; 1-1 Southland), 28, 40, 0, 68, McNeese State, (6-7; 0-2 Southland), 20, 36, 0, 56
400598806, 2015-01-05, Grambling St, (2-10; 0-2 SWAC), 14, 32, 0, 46, Alabama A&M, (2-10; 1-1 SWAC), 33, 34, 0, 67
400595634, 2015-01-05, SE Louisiana, (3-11; 0-1 Southland), 26, 40, 0, 66, SF Austin, (12-3; 2-0 Southland), 39, 42, 0, 81
400588722, 2015-01-05, FGCU, (10-6; 0-4 away), 19, 31, 0, 50, UCSB, (7-7; 5-1 home), 30, 33, 0, 63
400597317, 2015-01-06, Ole Miss, (9-5; 0-1 SEC), 38, 39, 9, 86, Kentucky, (14-0; 1-0 SEC), 36, 41, 12, 89
400597316, 2015-01-06, Arkansas, (12-2; 1-0 SEC), 37, 42, 0, 79, Georgia, (9-4; 0-1 SEC), 44, 31, 0, 75
400586223, 2015-01-06, Quinnipiac, (6-7; 0-4 MAAC), 30, 43, 0, 73, Iona, (10-5; 3-1 MAAC), 36, 45, 0, 81
400586771, 2015-01-06, ECU, (7-9; 0-3 American), 22, 26, 0, 48, Cincinnati, (11-3; 2-0 American), 38, 31, 0, 69
400586772, 2015-01-06, UCF, (8-6; 1-2 American), 42, 33, 4, 79, Houston, (7-7; 0-3 American), 30, 45, 3, 78
400587487, 2015-01-06, Cent Michigan, (11-1; 1-0 MAC), 29, 36, 0, 65, Toledo, (8-6; 0-1 MAC), 31, 31, 0, 62
400587488, 2015-01-06, W Michigan, (9-5; 0-1 MAC), 30, 22, 0, 52, Akron, (10-4; 1-0 MAC), 40, 32, 0, 72
400587901, 2015-01-06, VT, (8-7; 0-2 ACC), 45, 30, 0, 75, FSU, (9-6; 1-1 ACC), 53, 33, 0, 86
400588404, 2015-01-06, Marquette, (9-6; 1-2 Big East), 27, 32, 0, 59, Georgetown, (10-4; 2-1 Big East), 32, 33, 0, 65
400588723, 2015-01-06, Jacksonville, (6-11; 1-8 away), 34, 45, 0, 79, Florida A&M, (0-14; 0-1 MEAC), 26, 30, 0, 56
400591244, 2015-01-06, Stony Brook, (10-6; 1-0 Am. East), 32, 38, 0, 70, Columbia, (7-6; 6-2 home), 29, 32, 0, 61
400591317, 2015-01-06, Norfolk State, (9-8; 2-0 MEAC), 27, 34, 0, 61, Princeton, (6-9; 5-1 home), 31, 40, 0, 71
400595448, 2015-01-06, Michigan, (9-6; 2-1 Big Ten), 36, 37, 0, 73, Penn State, (12-4; 0-3 Big Ten), 29, 35, 0, 64
400596457, 2015-01-06, Albany, (7-7; 2-0 Am. East), 34, 30, 0, 64, UNH, (6-8; 0-2 Am. East), 29, 33, 0, 62
400599463, 2015-01-06, UConn, (8-5; 1-1 American), 28, 30, 0, 58, USF, (7-9; 1-2 American), 24, 20, 0, 44
400599614, 2015-01-06, Saint Louis, (8-7; 0-2 A 10), 40, 32, 0, 72, G Washington, (12-3; 2-0 A 10), 32, 43, 0, 75
400588724, 2015-01-06, Non D-I School, NA, 33, 27, 0, 60, North Florida, (8-9; 3-1 home), 61, 45, 0, 106
400588725, 2015-01-06, USC Upstate, (12-4; 3-3 away), 29, 32, 0, 61, UMKC, (5-12; 3-3 home), 27, 22, 0, 49
400601528, 2015-01-06, Non D-I School, NA, 25, 24, 0, 49, Savannah State, (4-10; 4-0 home), 34, 33, 0, 67
400588406, 2015-01-06, Villanova, (14-1; 2-1 Big East), 34, 56, 0, 90, St John's, (11-4; 0-3 Big East), 35, 37, 0, 72
400585785, 2015-01-06, Oklahoma State, (11-3; 1-1 Big 12), 21, 40, 0, 61, Iowa State, (11-2; 1-0 Big 12), 26, 37, 0, 63
400595449, 2015-01-06, OSU, (13-3; 2-1 Big Ten), 41, 25, 8, 74, Minnesota, (11-5; 0-3 Big Ten), 29, 37, 6, 72
400587902, 2015-01-06, Pitt, (11-4; 1-1 ACC), 22, 31, 8, 61, Boston College, (7-6; 0-2 ACC), 27, 26, 7, 60
400588405, 2015-01-06, Providence, (12-4; 2-1 Big East), 29, 37, 0, 66, Butler, (11-5; 1-2 Big East), 36, 26, 0, 62
400595635, 2015-01-06, Texas A&M-CC, (6-7; 1-0 Southland), 43, 34, 0, 77, Cent Arkansas, (0-13; 0-2 Southland), 27, 43, 0, 70
400596111, 2015-01-06, Auburn, (8-6; 0-1 SEC), 19, 33, 0, 52, Vanderbilt, (11-3; 1-0 SEC), 33, 31, 0, 64
400597318, 2015-01-06, Texas A&M, (9-4; 0-1 SEC), 24, 20, 0, 44, Alabama, (11-3; 1-0 SEC), 27, 38, 0, 65
400600651, 2015-01-06, NM Highlands,  , 37, 30, 0, 67, New Mexico St, (8-9; 8-2 home), 37, 38, 0, 75
400598586, 2015-01-06, Morgan State, (2-14; 0-2 MEAC), 25, 27, 0, 52, Saint Mary's, (12-3; 4-0 WCC), 36, 42, 0, 78
400591623, 2015-01-06, New Mexico, (10-5; 2-1 MW), 18, 24, 0, 42, San Diego State, (12-4; 2-1 MW), 22, 34, 0, 56
400587904, 2015-01-07, NC State, (11-5; 2-1 ACC), 31, 20, 0, 51, UVA, (14-0; 2-0 ACC), 32, 29, 0, 61
400595450, 2015-01-07, Purdue, (10-6; 2-1 Big Ten), 27, 28, 0, 55, Wisconsin, (15-1; 3-0 Big Ten), 28, 34, 0, 62
400588408, 2015-01-07, Seton Hall, (12-3; 2-1 Big East), 28, 30, 0, 58, Xavier, (11-4; 2-1 Big East), 33, 36, 0, 69
400591160, 2015-01-07, Davidson, (10-3; 1-1 A 10), 34, 31, 0, 65, VCU, (12-3; 2-0 A 10), 38, 33, 0, 71
400586224, 2015-01-07, St Peter's, (8-8; 2-3 MAAC), 22, 41, 0, 63, Manhattan, (6-8; 3-2 MAAC), 41, 27, 0, 68
400586773, 2015-01-07, Temple, (12-4; 3-0 American), 25, 39, 0, 64, Tulane, (11-4; 2-1 American), 27, 29, 0, 56
400587131, 2015-01-07, Holy Cross, (5-8; 0-3 Patriot), 32, 28, 0, 60, Colgate, (6-10; 3-0 Patriot), 35, 39, 0, 74
400587132, 2015-01-07, Lafayette, (9-5; 1-2 Patriot), 26, 43, 0, 69, Bucknell, (7-9; 2-1 Patriot), 32, 47, 0, 79
400587133, 2015-01-07, Lehigh, (7-7; 1-2 Patriot), 28, 43, 0, 71, Army, (10-4; 1-2 Patriot), 28, 32, 0, 60
400587489, 2015-01-07, N Illinois, (7-5; 1-0 MAC), 32, 38, 0, 70, Ohio, (5-7; 0-1 MAC), 32, 28, 0, 60
400587490, 2015-01-07, Ball State, (6-6; 1-0 MAC), 22, 28, 10, 60, E Michigan, (11-3; 0-1 MAC), 20, 30, 9, 59
400587491, 2015-01-07, Bowling Green, (9-3; 1-0 MAC), 26, 40, 0, 66, Kent State, (9-5; 0-1 MAC), 35, 29, 0, 64
400587492, 2015-01-07, Buffalo, (10-3; 1-0 MAC), 42, 37, 0, 79, Miami (OH), (5-9; 0-1 MAC), 26, 46, 0, 72
400587903, 2015-01-07, Syracuse, (11-4; 2-0 ACC), 28, 18, 0, 46, Georgia Tech, (9-5; 0-2 ACC), 27, 18, 0, 45
400591161, 2015-01-07, Fordham, (5-8; 0-2 A 10), 31, 34, 0, 65, URI, (10-3; 2-0 A 10), 35, 33, 0, 68
400591162, 2015-01-07, Saint Joe's, (6-7; 0-2 A 10), 36, 32, 0, 68, Duquesne, (6-7; 1-1 A 10), 34, 37, 0, 71
400596473, 2015-01-07, Binghamton, (1-16; 0-2 Am. East), 24, 35, 0, 59, Hartford, (8-7; 1-1 Am. East), 28, 41, 0, 69
400596502, 2015-01-07, UVM, (6-8; 2-0 Am. East), 28, 40, 0, 68, Maine, (1-13; 0-2 Am. East), 26, 28, 0, 54
400596536, 2015-01-07, UMass Lowell, (8-7; 2-0 Am. East), 36, 24, 13, 73, UMBC, (2-12; 0-1 Am. East), 34, 26, 1, 61
400597319, 2015-01-07, Florida, (8-6; 1-0 SEC), 31, 41, 0, 72, South Carolina, (9-4; 0-1 SEC), 34, 34, 0, 68
400598587, 2015-01-07, MD-E Shore, (8-9; 1-1 MEAC), 24, 36, 0, 60, NJIT, (8-9; 4-1 home), 31, 38, 0, 69
400599726, 2015-01-07, UMass, (8-7; 1-1 A 10), 34, 37, 0, 71, La Salle, (8-7; 0-2 A 10), 32, 33, 0, 65
400586403, 2015-01-07, Missouri State, (8-7; 2-1 MVC), 28, 28, 0, 56, Indiana State, (7-8; 3-0 MVC), 39, 32, 0, 71
400587134, 2015-01-07, American U, (8-7; 1-2 Patriot), 18, 29, 6, 53, Loyola (MD), (5-9; 1-2 Patriot), 22, 25, 9, 56
400586401, 2015-01-07, Bradley, (6-10; 1-2 MVC), 28, 15, 0, 43, Wichita State, (13-2; 3-0 MVC), 27, 36, 0, 63
400586404, 2015-01-07, S Illinois, (7-9; 0-3 MVC), 18, 21, 0, 39, Northern Iowa, (13-2; 2-1 MVC), 25, 30, 0, 55
400586405, 2015-01-07, Drake, (3-12; 0-3 MVC), 23, 22, 0, 45, Illinois State, (9-6; 1-2 MVC), 45, 36, 0, 81
400586959, 2015-01-07, IUPUI, (5-11; 1-1 Summit), 23, 33, 5, 61, Oral Roberts, (7-8; 1-1 Summit), 23, 33, 13, 69
400586960, 2015-01-07, W Illinois, (7-7; 2-1 Summit), 20, 24, 0, 44, South Dakota St, (10-7; 1-2 Summit), 34, 41, 0, 75
400587130, 2015-01-07, Boston U, (7-7; 3-0 Patriot), 30, 40, 0, 70, Navy, (6-9; 2-1 Patriot), 25, 39, 0, 64
400600652, 2015-01-07, Non D-I School, NA, 41, 37, 0, 78, UT Pan American, (6-9; 4-0 home), 40, 47, 0, 87
400586402, 2015-01-07, Loyola (CHI), (12-3; 2-1 MVC), 39, 32, 0, 71, Evansville, (11-4; 1-2 MVC), 36, 34, 0, 70
400596365, 2015-01-07, E Illinois, (9-6; 3-0 OVC), 23, 41, 0, 64, Tennessee St, (3-14; 0-2 OVC), 28, 29, 0, 57
400587906, 2015-01-07, Duke, (14-0; 2-0 ACC), 32, 41, 0, 73, Wake Forest, (8-8; 0-3 ACC), 27, 38, 0, 65
400587905, 2015-01-07, Clemson, (8-6; 0-2 ACC), 22, 30, 0, 52, Louisville, (14-1; 2-0 ACC), 18, 40, 0, 58
400593251, 2015-01-07, Colorado, (9-6; 2-1 Pac-12), 21, 28, 0, 49, Utah, (13-2; 3-0 Pac-12), 31, 43, 0, 74
400595451, 2015-01-07, Maryland, (14-2; 2-1 Big Ten), 28, 29, 0, 57, Illinois, (11-5; 1-2 Big Ten), 26, 38, 0, 64
400585786, 2015-01-07, Kansas, (12-2; 1-0 Big 12), 18, 38, 0, 56, Baylor, (11-3; 0-2 Big 12), 22, 33, 0, 55
400585787, 2015-01-07, TCU, (13-2; 0-2 Big 12), 19, 34, 0, 53, Kansas State, (8-7; 1-1 Big 12), 22, 36, 0, 58
400588407, 2015-01-07, DePaul, (9-7; 3-0 Big East), 39, 31, 0, 70, Creighton, (9-7; 0-3 Big East), 25, 35, 0, 60
400591624, 2015-01-07, San Jose State, (2-13; 0-3 MW), 26, 30, 0, 56, Air Force, (8-6; 1-2 MW), 37, 41, 0, 78
400591625, 2015-01-07, Wyoming, (14-2; 3-0 MW), 31, 29, 0, 60, Colorado State, (14-2; 1-2 MW), 26, 28, 0, 54
400596366, 2015-01-07, SIU-ED, (6-8; 2-1 OVC), 38, 31, 0, 69, Belmont, (10-5; 2-0 OVC), 36, 37, 0, 73
400597320, 2015-01-07, Tennessee, (9-4; 1-0 SEC), 26, 35, 0, 61, Miss St, (7-7; 0-1 SEC), 23, 24, 0, 47
400595943, 2015-01-07, CS Northridge, (4-12; 0-1 Big West), 31, 30, 0, 61, UC Davis, (11-3; 1-0 Big West), 44, 27, 0, 71
400591626, 2015-01-07, Utah State, (9-6; 2-1 MW), 26, 26, 0, 52, Fresno State, (7-9; 2-1 MW), 35, 26, 0, 61
400591627, 2015-01-07, Nevada, (6-8; 2-0 MW), 35, 29, 0, 64, UNLV, (9-6; 0-2 MW), 30, 32, 0, 62
400593252, 2015-01-07, Cal, (11-5; 1-2 Pac-12), 29, 28, 0, 57, USC, (9-6; 1-2 Pac-12), 38, 33, 0, 71
400595944, 2015-01-07, Cal Poly, (8-5; 1-0 Big West), 30, 21, 10, 61, Hawaii, (12-5; 0-1 Big West), 23, 28, 6, 57
400591436, 2015-01-08, Old Dominion, (13-1; 2-0 C-USA), 35, 37, 0, 72, Marshall, (4-11; 0-2 C-USA), 25, 26, 0, 51
400586226, 2015-01-08, Canisius, (8-6; 3-2 MAAC), 30, 37, 0, 67, Marist, (1-14; 0-5 MAAC), 29, 23, 0, 52
400586244, 2015-01-08, Niagara, (3-10; 2-3 MAAC), 22, 47, 0, 69, Siena, (6-8; 3-2 MAAC), 39, 40, 0, 79
400586961, 2015-01-08, Denver, (7-9; 1-2 Summit), 27, 26, 0, 53, IPFW, (8-8; 1-2 Summit), 34, 35, 0, 69
400589161, 2015-01-08, W Carolina, (7-9; 2-2 Southern), 24, 36, 0, 60, Chattanooga, (10-7; 3-1 Southern), 33, 33, 0, 66
400589162, 2015-01-08, Samford, (7-11; 0-5 Southern), 34, 33, 0, 67, The Citadel, (7-8; 2-2 Southern), 38, 39, 0, 77
400589163, 2015-01-08, Mercer, (8-9; 3-1 Southern), 36, 34, 0, 70, East Tenn St, (9-4; 4-1 Southern), 34, 37, 0, 71
400589164, 2015-01-08, UNC Greensboro, (5-12; 1-3 Southern), 34, 30, 0, 64, Furman, (4-10; 2-2 Southern), 25, 46, 0, 71
400589165, 2015-01-08, VMI, (5-11; 1-4 Southern), 37, 33, 0, 70, Wofford, (12-4; 3-0 Southern), 41, 34, 0, 75
400589347, 2015-01-08, Charleston So, (7-7; 1-2 Big South), 32, 29, 0, 61, High Point, (11-4; 2-1 Big South), 40, 32, 0, 72
400589348, 2015-01-08, Radford, (9-7; 0-3 Big South), 36, 28, 21, 85, Gardner-Webb, (10-6; 2-1 Big South), 27, 37, 24, 88
400589349, 2015-01-08, Liberty, (6-10; 0-3 Big South), 22, 32, 0, 54, UNC Asheville, (7-7; 3-0 Big South), 29, 42, 0, 71
400591163, 2015-01-08, Dayton, (12-2; 2-0 A 10), 39, 39, 0, 78, St Bonaventure, (8-5; 1-1 A 10), 31, 30, 0, 61
400591222, 2015-01-08, Brown, (8-8; 2-5 away), 27, 34, 0, 61, UNH, (7-8; 0-2 Am. East), 34, 34, 0, 68
400591261, 2015-01-08, Howard, (7-9; 1-1 MEAC), 27, 33, 0, 60, Cornell, (7-8; 4-1 home), 27, 43, 0, 70
400591716, 2015-01-08, St Francis (PA), (8-6; 2-1 NEC), 32, 22, 0, 54, Bryant, (5-7; 2-1 NEC), 37, 43, 0, 80
400591740, 2015-01-08, Cent Conn St, (2-14; 0-3 NEC), 23, 28, 0, 51, Mt St Mary's, (5-9; 1-2 NEC), 42, 40, 0, 82
400591759, 2015-01-08, St Francis (BKN), (9-7; 3-0 NEC), 47, 31, 0, 78, Fair Dickinson, (7-7; 2-1 NEC), 32, 37, 0, 69
400591778, 2015-01-08, Sacred Heart, (7-9; 1-2 NEC), 30, 40, 11, 81, LIU Brooklyn, (5-9; 1-2 NEC), 32, 38, 12, 82
400595452, 2015-01-08, Michigan State, (11-5; 2-1 Big Ten), 28, 47, 0, 75, Iowa, (11-5; 2-1 Big Ten), 39, 22, 0, 61
400597321, 2015-01-08, LSU, (11-3; 0-1 SEC), 30, 35, 2, 67, Missouri, (7-7; 1-0 SEC), 27, 38, 9, 74
400597827, 2015-01-08, Wright State, (10-7; 2-1 Horizon), 25, 45, 0, 70, Youngstown St, (9-9; 0-3 Horizon), 34, 27, 0, 61
400597856, 2015-01-08, Delaware, (1-13; 0-3 CAA), 36, 31, 6, 73, UNC-Wilmington, (7-7; 2-1 CAA), 29, 38, 7, 74
400597873, 2015-01-08, Drexel, (3-11; 1-2 CAA), 22, 33, 0, 55, Towson, (8-8; 1-2 CAA), 22, 19, 0, 41
400597915, 2015-01-08, Northeastern, (10-5; 2-1 CAA), 21, 44, 0, 65, JMU, (9-7; 2-1 CAA), 30, 29, 0, 59
400599601, 2015-01-08, George Mason, (6-8; 1-1 A 10), 23, 42, 0, 65, Richmond, (8-7; 1-1 A 10), 42, 33, 0, 75
400589350, 2015-01-08, Longwood, (5-11; 1-2 Big South), 26, 44, 0, 70, Coast Carolina, (12-3; 3-0 Big South), 34, 42, 0, 76
400589351, 2015-01-08, Winthrop, (7-7; 2-1 Big South), 29, 28, 0, 57, Presbyterian, (5-11; 1-2 Big South), 26, 30, 0, 56
400597734, 2015-01-08, Oakland, (5-11; 1-1 Horizon), 30, 31, 0, 61, Cleveland State, (9-8; 3-0 Horizon), 34, 31, 0, 65
400597837, 2015-01-08, Hofstra, (12-4; 3-0 CAA), 28, 43, 0, 71, Charleston, (5-11; 0-3 CAA), 24, 42, 0, 66
400586962, 2015-01-08, North Dakota St, (11-5; 3-0 Summit), 34, 41, 0, 75, Omaha, (7-8; 1-2 Summit), 27, 45, 0, 72
400591432, 2015-01-08, Charlotte, (6-8; 0-2 C-USA), 40, 26, 0, 66, W Kentucky, (9-5; 2-0 C-USA), 40, 34, 0, 74
400591433, 2015-01-08, FIU, (8-7; 1-1 C-USA), 22, 30, 0, 52, Mid Tennessee, (8-7; 1-1 C-USA), 35, 30, 0, 65
400591434, 2015-01-08, FAU, (7-6; 0-2 C-USA), 30, 27, 0, 57, UAB, (6-9; 2-0 C-USA), 32, 34, 0, 66
400591437, 2015-01-08, Southern Miss, (5-8; 0-2 C-USA), 32, 25, 0, 57, UTSA, (7-6; 2-1 C-USA), 44, 33, 0, 77
400597889, 2015-01-08, William & Mary, (8-6; 2-1 CAA), 35, 44, 0, 79, Elon, (10-6; 2-1 CAA), 38, 47, 0, 85
400586010, 2015-01-08, Sacramento St, (9-5; 3-0 Big Sky), 34, 29, 0, 63, North Dakota, (5-9; 1-2 Big Sky), 30, 31, 0, 61
400597786, 2015-01-08, UIC, (5-13; 1-2 Horizon), 32, 24, 0, 56, Valparaiso, (15-3; 2-1 Horizon), 47, 38, 0, 85
400595259, 2015-01-08, Georgia State, (9-6; 2-2 Sun Belt), 41, 39, 0, 80, LA-Lafayette, (10-5; 4-0 Sun Belt), 40, 44, 0, 84
400595260, 2015-01-08, UL Monroe, (8-6; 2-1 Sun Belt), 20, 47, 9, 76, UT-Arlington, (8-6; 2-2 Sun Belt), 28, 39, 6, 73
400595256, 2015-01-08, Ga Southern, (9-3; 2-1 Sun Belt), 41, 32, 0, 73, Arkansas State, (6-7; 1-3 Sun Belt), 26, 35, 0, 61
400595257, 2015-01-08, Appalachian St, (4-8; 1-2 Sun Belt), 33, 62, 0, 95, South Alabama, (4-10; 2-2 Sun Belt), 48, 56, 0, 104
400596367, 2015-01-08, Morehead State, (6-11; 1-1 OVC), 30, 40, 0, 70, SE Missouri St, (7-9; 1-2 OVC), 28, 29, 0, 57
400596368, 2015-01-08, E Kentucky, (9-5; 1-0 OVC), 29, 37, 0, 66, UT Martin, (8-6; 0-1 OVC), 31, 27, 0, 58
400595258, 2015-01-08, AR-Little Rock, (5-9; 0-4 Sun Belt), 20, 36, 18, 74, Texas State, (9-4; 3-1 Sun Belt), 27, 29, 21, 77
400596370, 2015-01-08, Murray State, (12-4; 2-0 OVC), 45, 38, 0, 83, Tenn Tech, (8-8; 0-3 OVC), 32, 35, 0, 67
400587295, 2015-01-08, San Francisco, (7-10; 1-4 WCC), 27, 30, 0, 57, Gonzaga, (15-1; 4-0 WCC), 37, 51, 0, 88
400586011, 2015-01-08, Montana, (5-8; 2-1 Big Sky), 23, 37, 0, 60, Weber State, (6-8; 1-2 Big Sky), 30, 38, 0, 68
400586013, 2015-01-08, Portland State, (7-6; 1-2 Big Sky), 35, 50, 0, 85, N Colorado, (7-7; 2-1 Big Sky), 40, 50, 0, 90
400586774, 2015-01-08, Memphis, (8-6; 1-2 American), 21, 38, 0, 59, SMU, (11-4; 2-1 American), 34, 39, 0, 73
400591435, 2015-01-08, LA Tech, (11-4; 2-0 C-USA), 33, 25, 0, 58, UTEP, (10-5; 2-1 C-USA), 33, 12, 0, 45
400591814, 2015-01-08, Robert Morris, (6-9; 2-1 NEC), 43, 34, 0, 77, Wagner, (3-11; 1-2 NEC), 36, 37, 0, 73
400593253, 2015-01-08, Arizona State, (8-7; 0-2 Pac-12), 20, 27, 0, 47, Oregon State, (10-4; 1-1 Pac-12), 29, 26, 0, 55
400593254, 2015-01-08, Stanford, (10-4; 2-1 Pac-12), 37, 29, 15, 81, UCLA, (9-7; 1-2 Pac-12), 32, 34, 20, 86
400595453, 2015-01-08, Rutgers, (9-7; 1-2 Big Ten), 23, 26, 0, 49, Nebraska, (9-6; 1-2 Big Ten), 26, 39, 0, 65
400596369, 2015-01-08, Austin Peay, (5-10; 0-1 OVC), 28, 31, 0, 59, Jacksonville St, (8-9; 1-2 OVC), 41, 30, 0, 71
400586012, 2015-01-08, Montana State, (3-12; 0-3 Big Sky), 40, 21, 0, 61, Idaho State, (4-11; 1-2 Big Sky), 28, 42, 0, 70
400587296, 2015-01-08, Santa Clara, (7-9; 2-3 WCC), 25, 36, 0, 61, Portland, (11-5; 2-2 WCC), 30, 48, 0, 78
400595945, 2015-01-08, CS Fullerton, (8-8; 0-1 Big West), 33, 34, 11, 78, UC Riverside, (8-7; 1-0 Big West), 46, 21, 17, 84
400593255, 2015-01-08, Arizona, (14-1; 2-0 Pac-12), 39, 41, 0, 80, Oregon, (11-4; 1-1 Pac-12), 34, 28, 0, 62
400595946, 2015-01-08, LBSU, (7-10; 1-0 Big West), 38, 50, 0, 88, UC Irvine, (7-8; 0-1 Big West), 40, 42, 0, 82
400587293, 2015-01-08, Pepperdine, (10-5; 3-1 WCC), 39, 28, 0, 67, BYU, (13-5; 3-2 WCC), 29, 32, 0, 61
400587294, 2015-01-08, Loyola Mary, (4-12; 0-4 WCC), 20, 30, 0, 50, San Diego, (9-8; 2-3 WCC), 23, 36, 0, 59
400586270, 2015-01-09, Quinnipiac, (7-7; 1-4 MAAC), 27, 41, 0, 68, Monmouth, (7-8; 4-1 MAAC), 29, 35, 0, 64
400587493, 2015-01-09, Akron, (10-5; 1-1 MAC), 34, 33, 0, 67, Toledo, (9-6; 1-1 MAC), 37, 47, 0, 84
400591330, 2015-01-09, Yale, (10-6; 5-5 away), 38, 33, 0, 71, NJIT, (9-9; 5-1 home), 33, 45, 0, 78
400597771, 2015-01-09, Green Bay, (13-3; 2-0 Horizon), 47, 32, 0, 79, Milwaukee, (5-12; 0-3 Horizon), 27, 36, 0, 63
400586775, 2015-01-10, Cincinnati, (11-4; 2-1 American), 34, 22, 0, 56, UConn, (9-5; 2-1 American), 30, 32, 0, 62
400595454, 2015-01-10, OSU, (13-4; 2-2 Big Ten), 26, 40, 0, 66, Indiana, (12-4; 2-1 Big Ten), 32, 37, 0, 69
400587135, 2015-01-10, Navy, (7-9; 3-1 Patriot), 33, 42, 0, 75, Army, (10-5; 1-3 Patriot), 24, 42, 0, 66
400587910, 2015-01-10, Georgia Tech, (9-6; 0-3 ACC), 29, 40, 0, 69, Wake Forest, (9-8; 1-3 ACC), 34, 42, 0, 76
400587911, 2015-01-10, Clemson, (9-6; 1-2 ACC), 36, 35, 0, 71, Pitt, (11-5; 1-2 ACC), 31, 31, 0, 62
400588409, 2015-01-10, Georgetown, (10-5; 2-2 Big East), 21, 29, 7, 57, Providence, (13-4; 3-1 Big East), 23, 27, 10, 60
400596114, 2015-01-10, Stony Brook, (10-7; 1-1 Am. East), 24, 33, 0, 57, UVM, (7-8; 3-0 Am. East), 28, 43, 0, 71
400599615, 2015-01-10, G Washington, (12-4; 2-1 A 10), 19, 31, 0, 50, La Salle, (9-7; 1-2 A 10), 33, 30, 0, 63
400597322, 2015-01-10, Kentucky, (15-0; 2-0 SEC), 25, 28, 17, 70, Texas A&M, (9-5; 0-2 SEC), 28, 25, 11, 64
400586964, 2015-01-10, Denver, (7-10; 1-3 Summit), 13, 36, 0, 49, IUPUI, (6-11; 2-1 Summit), 20, 32, 0, 52
400587139, 2015-01-10, Lafayette, (10-5; 2-2 Patriot), 28, 35, 0, 63, Boston U, (7-8; 3-1 Patriot), 34, 28, 0, 62
400587497, 2015-01-10, Buffalo, (10-4; 1-1 MAC), 29, 39, 0, 68, W Michigan, (10-5; 1-1 MAC), 37, 41, 0, 78
400591164, 2015-01-10, URI, (11-3; 3-0 A 10), 19, 42, 0, 61, Duquesne, (6-8; 1-2 A 10), 27, 33, 0, 60
400595455, 2015-01-10, Minnesota, (11-6; 0-4 Big Ten), 27, 30, 0, 57, Michigan, (10-6; 3-1 Big Ten), 25, 37, 0, 62
400587907, 2015-01-10, Louisville, (14-2; 2-1 ACC), 34, 37, 0, 71, UNC, (12-4; 2-1 ACC), 34, 38, 0, 72
400599907, 2015-01-10, Saint Joe's, (6-8; 0-3 A 10), 30, 44, 0, 74, VCU, (13-3; 3-0 A 10), 46, 43, 0, 89
400586230, 2015-01-10, Canisius, (8-7; 3-3 MAAC), 43, 33, 0, 76, Iona, (11-5; 4-1 MAAC), 43, 36, 0, 79
400586258, 2015-01-10, St Peter's, (8-9; 2-4 MAAC), 25, 30, 0, 55, Rider, (10-6; 4-1 MAAC), 39, 29, 0, 68
400586407, 2015-01-10, Evansville, (12-4; 2-2 MVC), 36, 30, 0, 66, Bradley, (6-11; 1-3 MVC), 32, 24, 0, 56
400587137, 2015-01-10, Loyola (MD), (6-9; 2-2 Patriot), 33, 32, 0, 65, Lehigh, (7-8; 1-3 Patriot), 23, 37, 0, 60
400588728, 2015-01-10, Kennesaw St, (5-12; 0-1 A-Sun), 26, 39, 0, 65, USC Upstate, (13-4; 1-0 A-Sun), 29, 39, 0, 68
400591262, 2015-01-10, Non D-I School, NA, 17, 12, 0, 29, Cornell, (8-8; 5-1 home), 53, 54, 0, 107
400591628, 2015-01-10, Colorado State, (15-2; 2-2 MW), 48, 44, 0, 92, Air Force, (8-7; 1-3 MW), 28, 59, 0, 87
400591796, 2015-01-10, St Francis (BKN), (9-8; 3-1 NEC), 30, 31, 0, 61, Mt St Mary's, (6-9; 2-2 NEC), 36, 35, 0, 71
400595261, 2015-01-10, Troy, (6-7; 1-3 Sun Belt), 34, 38, 0, 72, Georgia State, (10-6; 3-2 Sun Belt), 32, 45, 0, 77
400596458, 2015-01-10, Albany, (8-7; 3-0 Am. East), 33, 31, 0, 64, UMass Lowell, (8-8; 2-1 Am. East), 22, 29, 0, 51
400597323, 2015-01-10, Alabama, (12-3; 2-0 SEC), 29, 27, 0, 56, Tennessee, (9-5; 1-1 SEC), 24, 14, 0, 38
400597932, 2015-01-10, Northeastern, (11-5; 3-1 CAA), 32, 20, 0, 52, Towson, (8-9; 1-3 CAA), 26, 23, 0, 49
400587138, 2015-01-10, Bucknell, (7-10; 2-2 Patriot), 23, 31, 8, 62, Holy Cross, (6-8; 1-3 Patriot), 32, 22, 11, 65
400588410, 2015-01-10, Seton Hall, (13-3; 3-1 Big East), 30, 38, 0, 68, Creighton, (9-8; 0-4 Big East), 32, 35, 0, 67
400596474, 2015-01-10, Maine, (1-14; 0-3 Am. East), 30, 16, 0, 46, Binghamton, (2-16; 1-2 Am. East), 29, 36, 0, 65
400595456, 2015-01-10, Maryland, (15-2; 3-1 Big Ten), 26, 43, 0, 69, Purdue, (10-7; 2-2 Big Ten), 26, 34, 0, 60
400585788, 2015-01-10, Texas Tech, (10-6; 0-3 Big 12), 25, 29, 0, 54, Kansas, (13-2; 2-0 Big 12), 42, 44, 0, 86
400586014, 2015-01-10, Portland State, (8-6; 2-2 Big Sky), 31, 51, 0, 82, North Dakota, (5-10; 1-3 Big Sky), 22, 53, 0, 75
400586776, 2015-01-10, Tulsa, (10-5; 3-0 American), 17, 46, 0, 63, Temple, (12-5; 3-1 American), 23, 33, 0, 56
400588726, 2015-01-10, North Florida, (9-9; 1-0 A-Sun), 35, 51, 0, 86, Jacksonville, (6-12; 0-1 A-Sun), 31, 32, 0, 63
400591439, 2015-01-10, FIU, (8-8; 1-2 C-USA), 31, 22, 0, 53, UAB, (7-9; 3-0 C-USA), 28, 42, 0, 70
400591441, 2015-01-10, LA Tech, (12-4; 3-0 C-USA), 33, 51, 0, 84, UTSA, (7-7; 2-2 C-USA), 34, 38, 0, 72
400591442, 2015-01-10, North Texas, (7-8; 1-2 C-USA), 32, 34, 0, 66, Rice, (4-10; 1-2 C-USA), 29, 34, 0, 63
400593256, 2015-01-10, Washington St, (8-7; 2-1 Pac-12), 37, 43, 0, 80, Washington, (11-4; 0-3 Pac-12), 37, 40, 0, 77
400597754, 2015-01-10, Oakland, (5-12; 1-2 Horizon), 23, 31, 0, 54, Detroit, (8-9; 2-1 Horizon), 38, 36, 0, 74
400591741, 2015-01-10, Robert Morris, (7-9; 3-1 NEC), 33, 39, 0, 72, Cent Conn St, (2-15; 0-4 NEC), 27, 33, 0, 60
400596023, 2015-01-10, St Francis (PA), (9-6; 3-1 NEC), 31, 46, 0, 77, Sacred Heart, (7-10; 1-3 NEC), 29, 39, 0, 68
400588412, 2015-01-10, DePaul, (9-8; 3-1 Big East), 24, 40, 0, 64, Villanova, (15-1; 3-1 Big East), 45, 36, 0, 81
400585789, 2015-01-10, Baylor, (12-3; 1-2 Big 12), 28, 25, 13, 66, TCU, (13-3; 0-3 Big 12), 28, 25, 6, 59
400586018, 2015-01-10, Southern Utah, (3-11; 0-3 Big Sky), 21, 46, 0, 67, N Arizona, (7-9; 2-1 Big Sky), 34, 36, 0, 70
400586408, 2015-01-10, Northern Iowa, (14-2; 3-1 MVC), 31, 33, 0, 64, Drake, (3-13; 0-4 MVC), 29, 11, 0, 40
400587300, 2015-01-10, San Francisco, (8-10; 2-4 WCC), 40, 49, 0, 89, Portland, (11-6; 2-3 WCC), 36, 41, 0, 77
400587495, 2015-01-10, Ohio, (5-8; 0-2 MAC), 29, 25, 0, 54, Bowling Green, (10-3; 2-0 MAC), 34, 35, 0, 69
400587909, 2015-01-10, Boston College, (7-7; 0-3 ACC), 21, 35, 0, 56, Miami (FL), (11-4; 1-1 ACC), 29, 31, 0, 60
400589166, 2015-01-10, Chattanooga, (11-7; 4-1 Southern), 31, 32, 11, 74, East Tenn St, (9-5; 4-2 Southern), 30, 33, 8, 71
400589167, 2015-01-10, VMI, (6-11; 2-4 Southern), 44, 39, 0, 83, Furman, (4-11; 2-3 Southern), 43, 30, 0, 73
400589168, 2015-01-10, The Citadel, (7-9; 2-3 Southern), 31, 20, 0, 51, Mercer, (9-9; 4-1 Southern), 40, 34, 0, 74
400589353, 2015-01-10, Presbyterian, (5-12; 1-3 Big South), 38, 44, 0, 82, Radford, (10-7; 1-3 Big South), 45, 50, 0, 95
400591717, 2015-01-10, Fair Dickinson, (7-8; 2-2 NEC), 23, 37, 0, 60, Bryant, (6-7; 3-1 NEC), 40, 33, 0, 73
400591779, 2015-01-10, LIU Brooklyn, (5-10; 1-3 NEC), 41, 41, 0, 82, Wagner, (4-11; 2-2 NEC), 36, 51, 0, 87
400595636, 2015-01-10, Incarnate Word, (8-4; 0-2 Southland), 43, 58, 0, 101, Northwestern St, (7-7; 2-1 Southland), 49, 54, 0, 103
400597916, 2015-01-10, JMU, (9-8; 2-2 CAA), 31, 42, 0, 73, William & Mary, (9-6; 3-1 CAA), 32, 49, 0, 81
400598588, 2015-01-10, Morgan State, (3-14; 1-2 MEAC), 28, 45, 0, 73, Delaware State, (6-9; 0-1 MEAC), 30, 39, 0, 69
400598591, 2015-01-10, Hampton, (7-8; 3-0 MEAC), 23, 35, 0, 58, Bethune-Cookman, (4-12; 0-2 MEAC), 18, 38, 0, 56
400586406, 2015-01-10, Indiana State, (8-8; 4-0 MVC), 20, 39, 0, 59, S Illinois, (7-10; 0-4 MVC), 31, 25, 0, 56
400596371, 2015-01-10, Belmont, (10-6; 2-1 OVC), 26, 47, 0, 73, E Illinois, (10-6; 4-0 OVC), 39, 45, 0, 84
400598648, 2015-01-10, Coppin State, (1-15; 0-3 MEAC), 29, 40, 0, 69, Howard, (8-9; 2-1 MEAC), 35, 36, 0, 71
400597324, 2015-01-10, Vanderbilt, (11-4; 1-1 SEC), 28, 42, 0, 70, Arkansas, (13-2; 2-0 SEC), 36, 46, 0, 82
400587136, 2015-01-10, Colgate, (6-11; 3-1 Patriot), 27, 27, 15, 69, American U, (9-7; 2-2 Patriot), 32, 22, 17, 71
400587494, 2015-01-10, Cent Michigan, (11-2; 1-1 MAC), 36, 29, 0, 65, Ball State, (7-6; 2-0 MAC), 43, 40, 0, 83
400588411, 2015-01-10, Xavier, (11-5; 2-2 Big East), 31, 45, 0, 76, Butler, (12-5; 2-2 Big East), 34, 54, 0, 88
400589169, 2015-01-10, UNC Greensboro, (5-13; 1-4 Southern), 27, 45, 0, 72, W Carolina, (8-9; 3-2 Southern), 38, 44, 0, 82
400598589, 2015-01-10, S Carolina St, (4-13; 2-1 MEAC), 21, 24, 0, 45, NC Central, (11-5; 3-0 MEAC), 38, 38, 0, 76
400585790, 2015-01-10, Texas, (12-4; 1-2 Big 12), 28, 30, 0, 58, Oklahoma State, (12-3; 2-1 Big 12), 28, 41, 0, 69
400591307, 2015-01-10, Penn, (3-8; 0-1 Ivy), 41, 33, 0, 74, Princeton, (7-9; 1-0 Ivy), 36, 42, 0, 78
400593257, 2015-01-10, Arizona State, (8-8; 0-3 Pac-12), 23, 33, 0, 56, Oregon, (12-4; 2-1 Pac-12), 25, 34, 0, 59
400595637, 2015-01-10, Nicholls State, (3-9; 0-2 Southland), 28, 26, 0, 54, Abil Christian, (8-7; 2-0 Southland), 31, 40, 0, 71
400597325, 2015-01-10, South Carolina, (9-5; 0-2 SEC), 27, 22, 0, 49, Ole Miss, (10-5; 1-1 SEC), 33, 32, 0, 65
400595262, 2015-01-10, Ga Southern, (10-3; 3-1 Sun Belt), 31, 50, 0, 81, South Alabama, (4-11; 2-3 Sun Belt), 34, 39, 0, 73
400591443, 2015-01-10, Old Dominion, (13-2; 2-1 C-USA), 29, 36, 0, 65, W Kentucky, (10-5; 3-0 C-USA), 36, 36, 0, 72
400586965, 2015-01-10, South Dakota St, (11-7; 2-2 Summit), 41, 46, 0, 87, Omaha, (7-9; 1-3 Summit), 32, 36, 0, 68
400587496, 2015-01-10, E Michigan, (11-4; 0-2 MAC), 49, 29, 3, 81, Miami (OH), (6-9; 1-1 MAC), 30, 48, 4, 82
400589354, 2015-01-10, Longwood, (5-12; 1-3 Big South), 29, 25, 0, 54, Charleston So, (8-7; 2-2 Big South), 48, 20, 0, 68
400595263, 2015-01-10, UL Monroe, (9-6; 3-1 Sun Belt), 31, 31, 0, 62, Texas State, (9-5; 3-2 Sun Belt), 21, 38, 0, 59
400587908, 2015-01-10, UVA, (15-0; 3-0 ACC), 24, 38, 0, 62, Notre Dame, (15-2; 3-1 ACC), 27, 29, 0, 56
400587298, 2015-01-10, Pepperdine, (11-5; 4-1 WCC), 31, 28, 0, 59, San Diego, (9-9; 2-4 WCC), 21, 26, 0, 47
400591020, 2015-01-10, Southern, (5-12; 2-1 SWAC), 30, 29, 0, 59, Grambling St, (2-11; 0-3 SWAC), 20, 33, 0, 53
400591629, 2015-01-10, Fresno State, (8-9; 3-1 MW), 36, 33, 0, 69, Nevada, (6-9; 2-1 MW), 28, 38, 0, 66
400591630, 2015-01-10, Boise State, (10-6; 0-3 MW), 31, 23, 0, 54, Wyoming, (15-2; 4-0 MW), 30, 35, 0, 65
400595264, 2015-01-10, Appalachian St, (4-9; 1-3 Sun Belt), 24, 22, 0, 46, AR-Little Rock, (6-9; 1-4 Sun Belt), 36, 28, 0, 64
400597838, 2015-01-10, Delaware, (2-13; 1-3 CAA), 29, 35, 0, 64, Charleston, (5-12; 0-4 CAA), 25, 33, 0, 58
400598592, 2015-01-10, Savannah State, (4-11; 0-1 MEAC), 16, 31, 0, 47, NC A&T, (4-13; 1-2 MEAC), 26, 42, 0, 68
400598593, 2015-01-10, Norfolk State, (10-8; 3-0 MEAC), 38, 37, 0, 75, Florida A&M, (0-15; 0-2 MEAC), 13, 38, 0, 51
400598819, 2015-01-10, Alabama A&M, (3-10; 2-1 SWAC), 42, 44, 0, 86, Miss Valley St, (2-13; 1-1 SWAC), 37, 36, 0, 73
400591046, 2015-01-10, Alcorn State, (2-13; 1-2 SWAC), 23, 31, 0, 54, Jackson State, (4-12; 2-1 SWAC), 25, 39, 0, 64
400585791, 2015-01-10, Kansas State, (9-7; 2-1 Big 12), 31, 24, 11, 66, Oklahoma, (11-4; 2-1 Big 12), 30, 25, 8, 63
400586228, 2015-01-10, Niagara, (3-11; 2-4 MAAC), 38, 37, 0, 75, Manhattan, (7-8; 4-2 MAAC), 41, 43, 0, 84
400586963, 2015-01-10, South Dakota, (8-9; 2-1 Summit), 33, 31, 0, 64, IPFW, (8-9; 1-3 Summit), 32, 30, 0, 62
400588729, 2015-01-10, Stetson, (5-11; 0-1 A-Sun), 25, 25, 0, 50, FGCU, (11-6; 1-0 A-Sun), 35, 37, 0, 72
400589170, 2015-01-10, Samford, (7-12; 0-6 Southern), 32, 30, 0, 62, Wofford, (13-4; 4-0 Southern), 31, 41, 0, 72
400589352, 2015-01-10, Winthrop, (7-8; 2-2 Big South), 37, 27, 0, 64, Gardner-Webb, (11-6; 3-1 Big South), 21, 44, 0, 65
400589355, 2015-01-10, Campbell, (7-9; 1-2 Big South), 31, 31, 0, 62, High Point, (12-4; 3-1 Big South), 33, 36, 0, 69
400589356, 2015-01-10, Coast Carolina, (13-3; 4-0 Big South), 35, 34, 0, 69, Liberty, (6-11; 0-4 Big South), 24, 30, 0, 54
400591165, 2015-01-10, Dayton, (13-2; 3-0 A 10), 25, 51, 0, 76, Fordham, (5-9; 0-3 A 10), 25, 33, 0, 58
400591166, 2015-01-10, Saint Louis, (8-8; 0-3 A 10), 25, 29, 0, 54, Davidson, (11-3; 2-1 A 10), 39, 50, 0, 89
400591245, 2015-01-10, Non D-I School, NA, 25, 38, 0, 63, Columbia, (8-6; 7-2 home), 57, 55, 0, 112
400591280, 2015-01-10, Harvard, (10-3; 1-0 Ivy), 27, 30, 0, 57, Dartmouth, (6-7; 0-1 Ivy), 20, 26, 0, 46
400591331, 2015-01-10, Non D-I School, NA, 28, 19, 0, 47, Yale, (11-6; 4-1 home), 47, 55, 0, 102
400591438, 2015-01-10, Charlotte, (7-8; 1-2 C-USA), 41, 36, 0, 77, Marshall, (4-12; 0-3 C-USA), 36, 36, 0, 72
400595638, 2015-01-10, Cent Arkansas, (0-14; 0-3 Southland), 29, 36, 0, 65, Lamar, (8-7; 2-1 Southland), 52, 32, 0, 84
400596372, 2015-01-10, Morehead State, (6-12; 1-2 OVC), 35, 29, 8, 72, UT Martin, (9-6; 1-1 OVC), 35, 29, 11, 75
400596373, 2015-01-10, E Kentucky, (10-5; 2-0 OVC), 37, 31, 0, 68, SE Missouri St, (7-10; 1-3 OVC), 31, 24, 0, 55
400597326, 2015-01-10, Missouri, (7-8; 1-1 SEC), 40, 39, 0, 79, Auburn, (9-6; 1-1 SEC), 41, 44, 0, 85
400597327, 2015-01-10, Miss St, (7-8; 0-2 SEC), 19, 28, 0, 47, Florida, (9-6; 2-0 SEC), 39, 33, 0, 72
400597874, 2015-01-10, Drexel, (3-12; 1-3 CAA), 26, 31, 0, 57, UNC-Wilmington, (8-7; 3-1 CAA), 31, 33, 0, 64
400595639, 2015-01-10, Sam Houston, (11-4; 3-0 Southland), 34, 34, 0, 68, New Orleans, (5-6; 1-1 Southland), 21, 41, 0, 62
400588727, 2015-01-10, N Kentucky, (6-10; 0-1 A-Sun), 22, 39, 0, 61, Lipscomb, (7-9; 1-0 A-Sun), 32, 48, 0, 80
400587301, 2015-01-10, Santa Clara, (7-10; 2-4 WCC), 31, 26, 0, 57, Gonzaga, (16-1; 5-0 WCC), 44, 35, 0, 79
400585792, 2015-01-10, Iowa State, (12-2; 2-0 Big 12), 32, 42, 0, 74, West Virginia, (14-2; 2-1 Big 12), 32, 40, 0, 72
400586966, 2015-01-10, Oral Roberts, (8-8; 2-1 Summit), 33, 33, 0, 66, W Illinois, (7-8; 2-2 Summit), 27, 30, 0, 57
400587498, 2015-01-10, Kent State, (10-5; 1-1 MAC), 29, 38, 0, 67, N Illinois, (7-6; 1-1 MAC), 29, 36, 0, 65
400590789, 2015-01-10, Chicago State, (4-14; 0-1 WAC), 29, 30, 0, 59, UT Pan American, (7-9; 1-0 WAC), 29, 35, 0, 64
400591440, 2015-01-10, FAU, (7-7; 0-3 C-USA), 34, 24, 0, 58, Mid Tennessee, (9-7; 2-1 C-USA), 42, 40, 0, 82
400595640, 2015-01-10, Houston Baptist, (6-7; 1-2 Southland), 29, 38, 0, 67, SE Louisiana, (4-11; 1-1 Southland), 45, 42, 0, 87
400595641, 2015-01-10, McNeese State, (6-8; 0-3 Southland), 25, 36, 0, 61, Texas A&M-CC, (7-7; 2-0 Southland), 26, 45, 0, 71
400596374, 2015-01-10, Tennessee St, (3-15; 0-3 OVC), 21, 17, 0, 38, SIU-ED, (7-8; 3-1 OVC), 15, 30, 0, 45
400597890, 2015-01-10, Hofstra, (13-4; 4-0 CAA), 39, 40, 0, 79, Elon, (10-7; 2-2 CAA), 25, 36, 0, 61
400597735, 2015-01-10, Cleveland State, (9-9; 3-1 Horizon), 25, 31, 0, 56, Valparaiso, (16-3; 3-1 Horizon), 26, 32, 0, 58
400595265, 2015-01-10, Arkansas State, (6-8; 1-4 Sun Belt), 19, 31, 0, 50, UT-Arlington, (9-6; 3-2 Sun Belt), 39, 38, 0, 77
400596375, 2015-01-10, Austin Peay, (5-11; 0-2 OVC), 30, 26, 0, 56, Tenn Tech, (9-8; 1-3 OVC), 35, 37, 0, 72
400598792, 2015-01-10, Alabama State, (7-5; 3-0 SWAC), 29, 45, 0, 74, AR-Pine Bluff, (3-13; 0-2 SWAC), 36, 35, 0, 71
400598827, 2015-01-10, Texas Southern, (6-10; 3-0 SWAC), 36, 45, 0, 81, PV A&M, (2-14; 0-3 SWAC), 29, 48, 0, 77
400586015, 2015-01-10, Montana State, (3-13; 0-4 Big Sky), 29, 33, 0, 62, Weber State, (7-8; 2-2 Big Sky), 32, 33, 0, 65
400586017, 2015-01-10, Sacramento St, (9-6; 3-1 Big Sky), 39, 34, 0, 73, N Colorado, (8-7; 3-1 Big Sky), 36, 48, 0, 84
400587297, 2015-01-10, Loyola Mary, (4-13; 0-5 WCC), 36, 36, 0, 72, BYU, (14-5; 4-2 WCC), 47, 38, 0, 85
400590787, 2015-01-10, CSU Bakersfield, (4-12; 0-1 WAC), 32, 33, 0, 65, Grand Canyon, (10-8; 1-0 WAC), 35, 38, 0, 73
400590788, 2015-01-10, UMKC, (5-13; 0-1 WAC), 14, 31, 0, 45, New Mexico St, (9-9; 1-0 WAC), 33, 30, 0, 63
400591444, 2015-01-10, Southern Miss, (5-9; 0-3 C-USA), 15, 25, 0, 40, UTEP, (11-5; 3-1 C-USA), 40, 34, 0, 74
400591631, 2015-01-10, New Mexico, (11-5; 3-1 MW), 34, 32, 0, 66, Utah State, (9-7; 2-2 MW), 31, 29, 0, 60
400596116, 2015-01-10, Georgia, (9-5; 0-2 SEC), 36, 31, 17, 84, LSU, (12-3; 1-1 SEC), 42, 25, 20, 87
400586019, 2015-01-10, Montana, (6-8; 3-1 Big Sky), 56, 34, 0, 90, Idaho State, (4-12; 1-3 Big Sky), 36, 28, 0, 64
400590786, 2015-01-10, Seattle, (7-8; 0-1 WAC), 14, 38, 0, 52, Utah Valley, (6-9; 1-0 WAC), 38, 32, 0, 70
400586016, 2015-01-10, E Washington, (12-4; 3-0 Big Sky), 41, 48, 0, 89, Idaho, (7-7; 2-1 Big Sky), 42, 44, 0, 86
400591632, 2015-01-10, San Jose State, (2-14; 0-4 MW), 20, 20, 0, 40, UNLV, (10-6; 1-2 MW), 35, 39, 0, 74
400595948, 2015-01-10, UC Riverside, (8-8; 1-1 Big West), 17, 38, 0, 55, UC Irvine, (8-8; 1-1 Big West), 29, 40, 0, 69
400595949, 2015-01-10, UCSB, (8-7; 1-0 Big West), 20, 30, 0, 50, Cal Poly, (8-6; 1-1 Big West), 23, 22, 0, 45
400587299, 2015-01-10, Saint Mary's, (13-3; 5-0 WCC), 24, 30, 0, 54, Pacific, (9-8; 1-4 WCC), 15, 32, 0, 47
400595947, 2015-01-10, LBSU, (7-11; 1-1 Big West), 32, 27, 8, 67, UC Davis, (12-3; 2-0 Big West), 34, 25, 14, 73
400595950, 2015-01-10, CS Northridge, (4-13; 0-2 Big West), 37, 31, 0, 68, Hawaii, (13-5; 1-1 Big West), 39, 44, 0, 83
400595458, 2015-01-11, Northwestern, (10-6; 1-2 Big Ten), 40, 32, 5, 77, Michigan State, (12-5; 3-1 Big Ten), 40, 32, 12, 84
400586231, 2015-01-11, Marist, (1-15; 0-6 MAAC), 19, 35, 0, 54, Quinnipiac, (8-7; 2-4 MAAC), 35, 31, 0, 66
400597711, 2015-01-11, UNH, (8-8; 1-2 Am. East), 22, 41, 0, 63, UMBC, (2-13; 0-2 Am. East), 23, 37, 0, 60
400599602, 2015-01-11, UMass, (9-7; 2-1 A 10), 33, 33, 0, 66, George Mason, (6-9; 1-2 A 10), 35, 27, 0, 62
400587912, 2015-01-11, Duke, (14-1; 2-1 ACC), 33, 42, 0, 75, NC State, (12-5; 3-1 ACC), 37, 50, 0, 87
400586232, 2015-01-11, Fairfield, (5-10; 3-2 MAAC), 37, 42, 0, 79, Siena, (6-9; 3-3 MAAC), 32, 35, 0, 67
400586779, 2015-01-11, SMU, (12-4; 3-1 American), 30, 40, 0, 70, UCF, (8-7; 1-3 American), 26, 35, 0, 61
400586409, 2015-01-11, Illinois State, (10-6; 2-2 MVC), 49, 20, 0, 69, Missouri State, (8-8; 2-2 MVC), 27, 28, 0, 55
400586778, 2015-01-11, USF, (7-10; 1-3 American), 17, 29, 5, 51, Tulane, (12-4; 3-1 American), 22, 24, 10, 56
400599793, 2015-01-11, St Bonaventure, (8-6; 1-2 A 10), 23, 18, 0, 41, Richmond, (9-7; 2-1 A 10), 25, 35, 0, 60
400586777, 2015-01-11, Memphis, (9-6; 2-2 American), 27, 35, 0, 62, Houston, (7-8; 0-4 American), 21, 23, 0, 44
400586410, 2015-01-11, Wichita State, (14-2; 4-0 MVC), 23, 44, 0, 67, Loyola (CHI), (12-4; 2-2 MVC), 28, 25, 0, 53
400595459, 2015-01-11, Wisconsin, (15-2; 3-1 Big Ten), 35, 27, 0, 62, Rutgers, (10-7; 2-2 Big Ten), 23, 44, 0, 67
400596376, 2015-01-11, Murray State, (13-4; 3-0 OVC), 43, 41, 0, 84, Jacksonville St, (8-10; 1-3 OVC), 30, 27, 0, 57
400593258, 2015-01-11, Cal, (11-6; 1-3 Pac-12), 26, 28, 0, 54, UCLA, (10-7; 2-2 Pac-12), 31, 42, 0, 73
400587913, 2015-01-11, FSU, (9-7; 1-2 ACC), 22, 35, 0, 57, Syracuse, (12-4; 3-0 ACC), 35, 35, 0, 70
400597772, 2015-01-11, Youngstown St, (9-10; 0-4 Horizon), 29, 38, 0, 67, Green Bay, (14-3; 3-0 Horizon), 34, 48, 0, 82
400595457, 2015-01-11, Illinois, (11-6; 1-3 Big Ten), 22, 21, 0, 43, Nebraska, (10-6; 2-2 Big Ten), 28, 25, 0, 53
400593259, 2015-01-11, Arizona, (14-2; 2-1 Pac-12), 21, 35, 0, 56, Oregon State, (11-4; 2-1 Pac-12), 20, 38, 0, 58
400593260, 2015-01-11, Stanford, (11-4; 3-1 Pac-12), 49, 29, 0, 78, USC, (9-7; 1-3 Pac-12), 43, 33, 0, 76
400591223, 2015-01-12, Non D-I School, NA, 19, 23, 0, 42, Brown, (9-8; 6-2 home), 44, 44, 0, 88
400595643, 2015-01-12, Lamar, (9-7; 3-1 Southland), 29, 37, 0, 66, Texas A&M-CC, (7-8; 2-1 Southland), 32, 32, 0, 64
400601253, 2015-01-12, Monmouth, (8-8; 5-1 MAAC), 26, 29, 0, 55, Rider, (10-7; 4-2 MAAC), 33, 21, 0, 54
400598595, 2015-01-12, Delaware State, (7-9; 1-1 MEAC), 36, 43, 0, 79, Howard, (8-10; 2-2 MEAC), 34, 42, 0, 76
400598596, 2015-01-12, MD-E Shore, (9-9; 2-1 MEAC), 36, 42, 0, 78, Morgan State, (3-15; 1-3 MEAC), 22, 31, 0, 53
400598598, 2015-01-12, S Carolina St, (5-13; 3-1 MEAC), 24, 28, 0, 52, NC A&T, (4-14; 1-3 MEAC), 23, 27, 0, 50
400598597, 2015-01-12, Norfolk State, (11-8; 4-0 MEAC), 41, 38, 0, 79, Bethune-Cookman, (4-13; 0-3 MEAC), 30, 25, 0, 55
400598594, 2015-01-12, Savannah State, (4-12; 0-2 MEAC), 16, 24, 0, 40, NC Central, (12-5; 4-0 MEAC), 27, 31, 0, 58
400589357, 2015-01-12, Coast Carolina, (14-3; 5-0 Big South), 27, 43, 0, 70, Campbell, (7-10; 1-3 Big South), 33, 34, 0, 67
400591445, 2015-01-12, UTSA, (8-7; 2-2 C-USA), 29, 39, 0, 68, UT Pan American, (7-10; 1-0 WAC), 23, 20, 0, 43
400595642, 2015-01-12, New Orleans, (5-7; 1-2 Southland), 33, 33, 0, 66, Incarnate Word, (9-4; 1-2 Southland), 61, 36, 0, 97
400595644, 2015-01-12, Sam Houston, (12-4; 4-0 Southland), 31, 41, 0, 72, SE Louisiana, (4-12; 1-2 Southland), 31, 28, 0, 59
400598599, 2015-01-12, Hampton, (8-8; 4-0 MEAC), 42, 36, 0, 78, Florida A&M, (0-16; 0-3 MEAC), 28, 35, 0, 63
400591070, 2015-01-12, Alcorn State, (3-13; 2-2 SWAC), 32, 40, 0, 72, Grambling St, (2-12; 0-4 SWAC), 29, 41, 0, 70
400598793, 2015-01-12, Alabama State, (8-5; 4-0 SWAC), 37, 51, 0, 88, Miss Valley St, (2-14; 1-2 SWAC), 30, 46, 0, 76
400591021, 2015-01-12, Southern, (6-12; 3-1 SWAC), 24, 36, 0, 60, Jackson State, (4-13; 2-2 SWAC), 20, 32, 0, 52
400601531, 2015-01-12, Alabama A&M, (4-10; 3-1 SWAC), 19, 32, 0, 51, AR-Pine Bluff, (3-14; 0-3 SWAC), 20, 28, 0, 48
400587914, 2015-01-13, VT, (8-8; 0-3 ACC), 24, 39, 0, 63, Louisville, (15-2; 3-1 ACC), 43, 35, 0, 78
400585793, 2015-01-13, Oklahoma State, (12-4; 2-2 Big 12), 28, 29, 0, 57, Kansas, (14-2; 3-0 Big 12), 32, 35, 0, 67
400585794, 2015-01-13, Oklahoma, (11-5; 2-2 Big 12), 32, 33, 0, 65, West Virginia, (15-2; 3-1 Big 12), 45, 41, 0, 86
400596117, 2015-01-13, Arkansas, (13-3; 2-1 SEC), 31, 38, 0, 69, Tennessee, (10-5; 2-1 SEC), 33, 41, 0, 74
400588413, 2015-01-13, Butler, (13-5; 3-2 Big East), 28, 39, 12, 79, Seton Hall, (13-4; 3-2 Big East), 32, 35, 8, 75
400586234, 2015-01-13, Fairfield, (5-11; 3-3 MAAC), 37, 21, 0, 58, Iona, (12-5; 5-1 MAAC), 36, 38, 0, 74
400586235, 2015-01-13, Penn, (4-8; 0-1 Ivy), 22, 45, 0, 67, Niagara, (3-12; 2-4 MAAC), 24, 32, 0, 56
400595460, 2015-01-13, Penn State, (12-5; 0-4 Big Ten), 34, 39, 0, 73, Indiana, (13-4; 3-1 Big Ten), 39, 37, 0, 76
400595461, 2015-01-13, Michigan, (10-7; 3-2 Big Ten), 24, 28, 0, 52, OSU, (14-4; 3-2 Big Ten), 39, 32, 0, 71
400596503, 2015-01-13, UMass Lowell, (9-8; 3-1 Am. East), 34, 28, 0, 62, Maine, (1-15; 0-4 Am. East), 34, 25, 0, 59
400599786, 2015-01-13, VCU, (14-3; 4-0 A 10), 28, 37, 0, 65, URI, (11-4; 3-1 A 10), 35, 25, 0, 60
400588730, 2015-01-13, USC Upstate, (13-5; 1-1 A-Sun), 32, 26, 0, 58, Lipscomb, (8-9; 2-0 A-Sun), 32, 28, 0, 60
400595645, 2015-01-13, Abil Christian, (9-7; 3-0 Southland), 46, 49, 0, 95, Northwestern St, (7-8; 2-2 Southland), 37, 44, 0, 81
400595646, 2015-01-13, Houston Baptist, (6-8; 1-3 Southland), 27, 30, 0, 57, Nicholls State, (4-9; 1-2 Southland), 33, 28, 0, 61
400587915, 2015-01-13, Clemson, (9-7; 1-3 ACC), 19, 23, 0, 42, UVA, (16-0; 4-0 ACC), 25, 40, 0, 65
400586411, 2015-01-13, Northern Iowa, (15-2; 4-1 MVC), 35, 28, 0, 63, Bradley, (6-12; 1-4 MVC), 18, 34, 0, 52
400587916, 2015-01-13, Wake Forest, (9-9; 1-4 ACC), 37, 34, 12, 83, Syracuse, (13-4; 4-0 ACC), 36, 35, 15, 86
400595647, 2015-01-13, SF Austin, (13-3; 3-0 Southland), 58, 51, 0, 109, Cent Arkansas, (0-15; 0-4 Southland), 30, 28, 0, 58
400597329, 2015-01-13, Missouri, (7-9; 1-2 SEC), 18, 19, 0, 37, Kentucky, (16-0; 3-0 SEC), 44, 42, 0, 86
400587917, 2015-01-13, Miami (FL), (12-4; 2-1 ACC), 34, 56, 0, 90, Duke, (14-2; 2-2 ACC), 35, 39, 0, 74
400588414, 2015-01-13, Georgetown, (11-5; 3-2 Big East), 44, 34, 0, 78, DePaul, (9-9; 3-2 Big East), 39, 33, 0, 72
400595462, 2015-01-13, Iowa, (12-5; 3-1 Big Ten), 38, 39, 0, 77, Minnesota, (11-7; 0-5 Big Ten), 27, 48, 0, 75
400597328, 2015-01-13, Alabama, (12-4; 2-1 SEC), 25, 41, 0, 66, South Carolina, (10-5; 1-2 SEC), 30, 38, 0, 68
400597330, 2015-01-13, Miss St, (7-9; 0-3 SEC), 28, 42, 0, 70, Texas A&M, (10-5; 1-2 SEC), 27, 47, 0, 74
400606911, 2015-01-13, Non D-I School, NA, 23, 21, 0, 44, Montana, (7-8; 3-1 Big Sky), 41, 45, 0, 86
400586780, 2015-01-13, UConn, (9-6; 2-2 American), 24, 34, 0, 58, Tulsa, (11-5; 4-0 American), 30, 36, 0, 66
400599890, 2015-01-13, Non D-I School, NA, 23, 40, 0, 63, Santa Clara, (8-10; 2-4 WCC), 33, 44, 0, 77
400591633, 2015-01-13, UNLV, (10-7; 1-3 MW), 30, 38, 5, 73, Boise State, (11-6; 1-3 MW), 38, 30, 14, 82
400587918, 2015-01-14, Notre Dame, (16-2; 4-1 ACC), 30, 32, 0, 62, Georgia Tech, (9-7; 0-4 ACC), 38, 21, 0, 59
400595463, 2015-01-14, Rutgers, (10-8; 2-3 Big Ten), 31, 34, 0, 65, Maryland, (16-2; 4-1 Big Ten), 38, 35, 0, 73
400587919, 2015-01-14, UNC, (13-4; 3-1 ACC), 32, 49, 0, 81, NC State, (12-6; 3-2 ACC), 26, 53, 0, 79
400586781, 2015-01-14, Houston, (7-9; 0-5 American), 21, 40, 0, 61, ECU, (8-9; 1-3 American), 30, 36, 0, 66
400586782, 2015-01-14, SMU, (13-4; 4-1 American), 26, 34, 0, 60, Temple, (12-6; 3-2 American), 33, 22, 0, 55
400586783, 2015-01-14, Tulane, (12-5; 3-2 American), 38, 35, 27, 100, UCF, (9-7; 2-3 American), 38, 35, 30, 103
400587141, 2015-01-14, Boston U, (7-9; 3-2 Patriot), 29, 24, 0, 53, Colgate, (7-11; 4-1 Patriot), 26, 36, 0, 62
400587142, 2015-01-14, Loyola (MD), (6-10; 2-3 Patriot), 37, 28, 0, 65, Lafayette, (11-5; 3-2 Patriot), 37, 32, 0, 69
400587143, 2015-01-14, Navy, (7-10; 3-2 Patriot), 27, 36, 0, 63, Bucknell, (8-10; 3-2 Patriot), 29, 36, 0, 65
400587499, 2015-01-14, Miami (OH), (6-10; 1-2 MAC), 34, 43, 0, 77, Cent Michigan, (12-2; 2-1 MAC), 62, 43, 0, 105
400587500, 2015-01-14, N Illinois, (7-7; 1-2 MAC), 21, 42, 0, 63, Buffalo, (11-4; 2-1 MAC), 42, 40, 0, 82
400587501, 2015-01-14, Toledo, (10-6; 2-1 MAC), 41, 39, 0, 80, Ohio, (5-9; 0-3 MAC), 35, 38, 0, 73
400587502, 2015-01-14, Ball State, (7-7; 2-1 MAC), 39, 37, 17, 93, W Michigan, (11-5; 2-1 MAC), 32, 44, 19, 95
400587503, 2015-01-14, Bowling Green, (10-4; 2-1 MAC), 22, 28, 0, 50, Akron, (11-5; 2-1 MAC), 38, 29, 0, 67
400587504, 2015-01-14, E Michigan, (11-5; 0-3 MAC), 37, 22, 0, 59, Kent State, (11-5; 2-1 MAC), 27, 38, 0, 65
400587920, 2015-01-14, Harvard, (10-4; 1-0 Ivy), 19, 28, 10, 57, Boston College, (8-7; 0-3 ACC), 30, 17, 17, 64
400588415, 2015-01-14, St John's, (12-4; 1-3 Big East), 42, 41, 0, 83, Providence, (13-5; 3-2 Big East), 30, 40, 0, 70
400588731, 2015-01-14, Stetson, (5-12; 0-2 A-Sun), 33, 36, 0, 69, Jacksonville, (7-12; 1-1 A-Sun), 36, 35, 0, 71
400588732, 2015-01-14, FGCU, (11-7; 1-1 A-Sun), 37, 27, 0, 64, North Florida, (10-9; 2-0 A-Sun), 39, 41, 0, 80
400588733, 2015-01-14, Kennesaw St, (5-13; 0-2 A-Sun), 34, 38, 0, 72, N Kentucky, (7-10; 1-1 A-Sun), 41, 35, 0, 76
400589171, 2015-01-14, VMI, (6-12; 2-5 Southern), 32, 31, 0, 63, UNC Greensboro, (6-13; 2-4 Southern), 38, 37, 0, 75
400589358, 2015-01-14, High Point, (13-4; 4-1 Big South), 32, 52, 0, 84, Gardner-Webb, (11-7; 3-2 Big South), 27, 45, 0, 72
400589359, 2015-01-14, Presbyterian, (6-12; 2-3 Big South), 34, 37, 0, 71, Longwood, (5-13; 1-4 Big South), 33, 34, 0, 67
400589360, 2015-01-14, Winthrop, (8-8; 3-2 Big South), 38, 46, 0, 84, UNC Asheville, (7-8; 3-1 Big South), 21, 48, 0, 69
400591169, 2015-01-14, La Salle, (9-8; 1-3 A 10), 25, 25, 0, 50, Dayton, (14-2; 4-0 A 10), 23, 38, 0, 61
400591170, 2015-01-14, Fordham, (5-10; 0-4 A 10), 21, 34, 0, 55, Saint Joe's, (7-8; 1-3 A 10), 25, 41, 0, 66
400591171, 2015-01-14, Davidson, (12-3; 3-1 A 10), 30, 41, 0, 71, UMass, (9-8; 2-2 A 10), 28, 35, 0, 63
400591281, 2015-01-14, Dartmouth, (6-8; 0-1 Ivy), 23, 29, 0, 52, UVM, (8-8; 3-0 Am. East), 29, 26, 0, 55
400596119, 2015-01-14, Binghamton, (2-17; 1-3 Am. East), 18, 40, 0, 58, Albany, (9-7; 4-0 Am. East), 34, 39, 0, 73
400596490, 2015-01-14, Hartford, (9-7; 2-1 Am. East), 29, 39, 0, 68, UNH, (8-9; 1-3 Am. East), 31, 36, 0, 67
400597331, 2015-01-14, LSU, (13-3; 2-1 SEC), 32, 43, 0, 75, Ole Miss, (10-6; 1-2 SEC), 28, 43, 0, 71
400597691, 2015-01-14, UMBC, (2-14; 0-3 Am. East), 24, 30, 0, 54, Stony Brook, (11-7; 2-1 Am. East), 32, 32, 0, 64
400597736, 2015-01-14, Cleveland State, (10-9; 4-1 Horizon), 28, 27, 0, 55, Wright State, (10-8; 2-2 Horizon), 26, 24, 0, 50
400597839, 2015-01-14, Charleston, (6-12; 1-4 CAA), 31, 35, 0, 66, Elon, (10-8; 2-3 CAA), 27, 23, 0, 50
400597857, 2015-01-14, Towson, (8-10; 1-4 CAA), 27, 30, 7, 64, Delaware, (3-13; 2-3 CAA), 25, 32, 10, 67
400597903, 2015-01-14, Hofstra, (13-5; 4-1 CAA), 43, 40, 0, 83, Northeastern, (12-5; 4-1 CAA), 43, 48, 0, 91
400597924, 2015-01-14, UNC-Wilmington, (8-8; 3-2 CAA), 44, 28, 0, 72, William & Mary, (10-6; 4-1 CAA), 24, 52, 0, 76
400599603, 2015-01-14, George Mason, (6-10; 1-3 A 10), 22, 33, 0, 55, St Bonaventure, (9-6; 2-2 A 10), 38, 37, 0, 75
400600087, 2015-01-14, St Joseph's BKN,  , 32, 28, 0, 60, NJIT, (10-9; 6-1 home), 38, 41, 0, 79
400601254, 2015-01-14, St Peter's, (9-9; 3-4 MAAC), 23, 29, 10, 62, Monmouth, (8-9; 5-2 MAAC), 22, 30, 9, 61
400586412, 2015-01-14, Illinois State, (10-7; 2-3 MVC), 30, 32, 8, 70, Indiana State, (9-8; 5-0 MVC), 31, 31, 9, 71
400587144, 2015-01-14, Lehigh, (7-9; 1-4 Patriot), 35, 24, 0, 59, American U, (10-7; 3-2 Patriot), 35, 27, 0, 62
400589361, 2015-01-14, Liberty, (6-12; 0-5 Big South), 26, 32, 0, 58, Charleston So, (9-7; 3-2 Big South), 34, 46, 0, 80
400586414, 2015-01-14, S Illinois, (7-11; 0-5 MVC), 22, 33, 0, 55, Wichita State, (15-2; 5-0 MVC), 38, 29, 0, 67
400585795, 2015-01-14, Texas Tech, (10-7; 0-4 Big 12), 20, 31, 0, 51, Kansas State, (10-7; 3-1 Big 12), 28, 30, 0, 58
400586415, 2015-01-14, Drake, (3-14; 0-5 MVC), 30, 17, 0, 47, Loyola (CHI), (13-4; 3-2 MVC), 30, 20, 0, 50
400586968, 2015-01-14, Omaha, (7-10; 1-4 Summit), 43, 43, 0, 86, Oral Roberts, (9-8; 3-1 Summit), 53, 49, 0, 102
400586969, 2015-01-14, North Dakota St, (11-6; 3-1 Summit), 26, 41, 0, 67, South Dakota, (9-9; 3-1 Summit), 30, 41, 0, 71
400586970, 2015-01-14, IUPUI, (6-12; 2-2 Summit), 20, 33, 0, 53, South Dakota St, (12-7; 3-2 Summit), 30, 38, 0, 68
400591168, 2015-01-14, Duquesne, (6-9; 1-3 A 10), 29, 40, 0, 69, Saint Louis, (9-8; 1-3 A 10), 42, 36, 0, 78
400597755, 2015-01-14, Detroit, (9-9; 3-1 Horizon), 33, 36, 0, 69, UIC, (5-14; 1-3 Horizon), 40, 28, 0, 68
400586413, 2015-01-14, Evansville, (13-4; 3-2 MVC), 31, 25, 0, 56, Missouri State, (8-9; 2-3 MVC), 25, 29, 0, 54
400587140, 2015-01-14, Army, (11-5; 2-3 Patriot), 32, 27, 13, 72, Holy Cross, (6-9; 1-4 Patriot), 25, 34, 11, 70
400597799, 2015-01-14, Youngstown St, (9-11; 0-5 Horizon), 25, 37, 0, 62, Milwaukee, (6-12; 1-3 Horizon), 34, 43, 0, 77
400588417, 2015-01-14, Xavier, (11-6; 2-3 Big East), 27, 48, 0, 75, Villanova, (16-1; 4-1 Big East), 45, 43, 0, 88
400585796, 2015-01-14, Iowa State, (12-3; 2-1 Big 12), 34, 39, 0, 73, Baylor, (13-3; 2-2 Big 12), 46, 28, 0, 74
400586967, 2015-01-14, W Illinois, (7-9; 2-3 Summit), 31, 23, 0, 54, Denver, (8-10; 2-3 Summit), 31, 37, 0, 68
400587921, 2015-01-14, FSU, (9-8; 1-3 ACC), 32, 32, 0, 64, Pitt, (12-5; 2-2 ACC), 33, 40, 0, 73
400588416, 2015-01-14, Creighton, (9-9; 0-5 Big East), 21, 31, 0, 52, Marquette, (10-6; 2-2 Big East), 28, 25, 0, 53
400591634, 2015-01-14, Air Force, (8-8; 1-4 MW), 20, 28, 0, 48, New Mexico, (12-5; 4-1 MW), 22, 38, 0, 60
400591635, 2015-01-14, Nevada, (6-10; 2-2 MW), 12, 30, 0, 42, Colorado State, (16-2; 3-2 MW), 55, 43, 0, 98
400593261, 2015-01-14, UCLA, (11-7; 3-2 Pac-12), 36, 47, 0, 83, USC, (9-8; 1-4 Pac-12), 31, 35, 0, 66
400595464, 2015-01-14, Illinois, (12-6; 2-3 Big Ten), 37, 35, 0, 72, Northwestern, (10-7; 1-3 Big Ten), 33, 34, 0, 67
400596377, 2015-01-14, SE Missouri St, (8-10; 2-3 OVC), 29, 40, 0, 69, Jacksonville St, (8-11; 1-4 OVC), 22, 30, 0, 52
400597332, 2015-01-14, Georgia, (10-5; 1-2 SEC), 31, 39, 0, 70, Vanderbilt, (11-5; 1-2 SEC), 22, 45, 0, 67
400591636, 2015-01-14, Fresno State, (9-9; 4-1 MW), 32, 41, 0, 73, San Jose State, (2-15; 0-5 MW), 30, 32, 0, 62
400591637, 2015-01-14, San Diego State, (13-4; 3-1 MW), 26, 34, 0, 60, Wyoming, (15-3; 4-1 MW), 24, 28, 0, 52
400593262, 2015-01-14, Stanford, (12-4; 4-1 Pac-12), 26, 43, 0, 69, Cal, (11-7; 1-4 Pac-12), 31, 28, 0, 59
400589172, 2015-01-15, Wofford, (13-5; 4-1 Southern), 37, 29, 0, 66, The Citadel, (8-9; 3-3 Southern), 28, 41, 0, 69
400586784, 2015-01-15, Cincinnati, (11-5; 2-2 American), 24, 26, 0, 50, Memphis, (10-6; 3-2 American), 32, 31, 0, 63
400589173, 2015-01-15, Furman, (4-12; 2-4 Southern), 29, 35, 0, 64, Mercer, (10-9; 5-1 Southern), 36, 31, 0, 67
400589175, 2015-01-15, East Tenn St, (10-5; 5-2 Southern), 37, 46, 0, 83, W Carolina, (8-10; 3-3 Southern), 26, 50, 0, 76
400589362, 2015-01-15, Radford, (11-7; 2-3 Big South), 32, 40, 0, 72, Campbell, (7-11; 1-4 Big South), 19, 36, 0, 55
400591446, 2015-01-15, North Texas, (7-9; 1-3 C-USA), 24, 33, 0, 57, Charlotte, (8-8; 2-2 C-USA), 20, 53, 0, 73
400591448, 2015-01-15, W Kentucky, (11-5; 4-0 C-USA), 31, 40, 17, 88, FAU, (7-8; 0-4 C-USA), 31, 40, 14, 85
400591451, 2015-01-15, Rice, (4-11; 1-3 C-USA), 21, 32, 0, 53, Old Dominion, (14-2; 3-1 C-USA), 27, 36, 0, 63
400591718, 2015-01-15, Wagner, (4-12; 2-3 NEC), 30, 43, 0, 73, Bryant, (7-7; 4-1 NEC), 36, 45, 0, 81
400591742, 2015-01-15, LIU Brooklyn, (6-10; 2-3 NEC), 34, 37, 0, 71, Cent Conn St, (2-16; 0-5 NEC), 29, 37, 0, 66
400591760, 2015-01-15, Mt St Mary's, (7-9; 3-2 NEC), 33, 38, 0, 71, Fair Dickinson, (7-9; 2-3 NEC), 15, 36, 0, 51
400596121, 2015-01-15, Richmond, (9-8; 2-2 A 10), 17, 33, 20, 70, G Washington, (13-4; 3-1 A 10), 24, 26, 23, 73
400597333, 2015-01-15, Auburn, (9-7; 1-2 SEC), 20, 35, 0, 55, Florida, (10-6; 3-0 SEC), 37, 38, 0, 75
400597773, 2015-01-15, Green Bay, (14-4; 3-1 Horizon), 35, 31, 0, 66, Oakland, (6-12; 2-2 Horizon), 40, 29, 0, 69
400597875, 2015-01-15, JMU, (10-8; 3-2 CAA), 17, 37, 0, 54, Drexel, (3-13; 1-4 CAA), 12, 23, 0, 35
400595268, 2015-01-15, UT-Arlington, (9-7; 3-3 Sun Belt), 32, 30, 0, 62, Georgia State, (11-6; 4-2 Sun Belt), 36, 47, 0, 83
400591447, 2015-01-15, Marshall, (4-13; 0-4 C-USA), 36, 23, 3, 62, FIU, (9-8; 2-2 C-USA), 21, 38, 7, 66
400595266, 2015-01-15, Arkansas State, (7-8; 2-4 Sun Belt), 29, 30, 0, 59, Appalachian St, (4-10; 1-4 Sun Belt), 27, 23, 0, 50
400595267, 2015-01-15, LA-Lafayette, (10-6; 4-1 Sun Belt), 27, 43, 0, 70, Ga Southern, (11-3; 4-1 Sun Belt), 35, 43, 0, 78
400596380, 2015-01-15, SIU-ED, (7-9; 3-2 OVC), 28, 35, 0, 63, Morehead State, (7-12; 2-2 OVC), 47, 44, 0, 91
400596378, 2015-01-15, E Illinois, (11-6; 5-0 OVC), 41, 31, 0, 72, E Kentucky, (10-6; 2-1 OVC), 29, 36, 0, 65
400586237, 2015-01-15, Rider, (11-7; 5-2 MAAC), 24, 32, 0, 56, Quinnipiac, (8-8; 2-5 MAAC), 22, 31, 0, 53
400589174, 2015-01-15, Chattanooga, (12-7; 5-1 Southern), 30, 52, 0, 82, Samford, (7-13; 0-7 Southern), 33, 43, 0, 76
400591449, 2015-01-15, UAB, (7-10; 3-1 C-USA), 38, 33, 0, 71, LA Tech, (13-4; 4-0 C-USA), 35, 39, 0, 74
400591450, 2015-01-15, Mid Tennessee, (10-7; 3-1 C-USA), 33, 29, 0, 62, Southern Miss, (5-10; 0-4 C-USA), 33, 28, 0, 61
400586020, 2015-01-15, Weber State, (8-8; 3-2 Big Sky), 30, 44, 0, 74, N Arizona, (7-10; 2-2 Big Sky), 23, 42, 0, 65
400595269, 2015-01-15, South Alabama, (4-12; 2-4 Sun Belt), 34, 37, 0, 71, Texas State, (10-5; 4-2 Sun Belt), 38, 44, 0, 82
400596379, 2015-01-15, Tennessee St, (3-16; 0-4 OVC), 26, 42, 0, 68, Austin Peay, (6-11; 1-2 OVC), 31, 38, 0, 69
400596381, 2015-01-15, UT Martin, (10-6; 2-1 OVC), 34, 29, 0, 63, Tenn Tech, (9-9; 1-4 OVC), 32, 28, 0, 60
400595270, 2015-01-15, Troy, (6-8; 1-4 Sun Belt), 25, 29, 0, 54, UL Monroe, (10-6; 4-1 Sun Belt), 29, 34, 0, 63
400595465, 2015-01-15, Nebraska, (10-7; 2-3 Big Ten), 27, 28, 0, 55, Wisconsin, (16-2; 4-1 Big Ten), 37, 33, 0, 70
400593263, 2015-01-15, Colorado, (9-7; 2-2 Pac-12), 25, 29, 0, 54, Arizona, (15-2; 3-1 Pac-12), 35, 33, 0, 68
400586023, 2015-01-15, Idaho State, (4-13; 1-4 Big Sky), 31, 36, 0, 67, Southern Utah, (4-11; 1-3 Big Sky), 33, 38, 0, 71
400593264, 2015-01-15, Oregon State, (11-5; 2-2 Pac-12), 15, 28, 0, 43, Washington, (12-4; 1-3 Pac-12), 19, 37, 0, 56
400596122, 2015-01-15, Belmont, (10-7; 2-2 OVC), 37, 40, 0, 77, Murray State, (14-4; 4-0 OVC), 46, 46, 0, 92
400590792, 2015-01-15, Grand Canyon, (11-8; 2-0 WAC), 35, 48, 0, 83, Utah Valley, (6-10; 1-1 WAC), 35, 39, 0, 74
400593265, 2015-01-15, Utah, (14-2; 4-0 Pac-12), 40, 36, 0, 76, Arizona State, (8-9; 0-4 Pac-12), 23, 36, 0, 59
400587304, 2015-01-15, Portland, (11-7; 2-4 WCC), 26, 42, 0, 68, Loyola Mary, (5-13; 1-5 WCC), 36, 44, 0, 80
400590790, 2015-01-15, New Mexico St, (10-9; 2-0 WAC), 35, 35, 0, 70, CSU Bakersfield, (4-13; 0-2 WAC), 27, 27, 0, 54
400590791, 2015-01-15, UT Pan American, (7-11; 1-1 WAC), 23, 24, 0, 47, Seattle, (8-8; 1-1 WAC), 28, 42, 0, 70
400595951, 2015-01-15, Cal Poly, (8-7; 1-2 Big West), 26, 22, 0, 48, LBSU, (8-11; 2-1 Big West), 24, 26, 0, 50
400595952, 2015-01-15, CS Northridge, (5-13; 1-2 Big West), 35, 39, 0, 74, UCSB, (8-8; 1-1 Big West), 32, 31, 0, 63
400595953, 2015-01-15, UC Davis, (13-3; 3-0 Big West), 33, 41, 0, 74, UC Riverside, (8-9; 1-2 Big West), 21, 40, 0, 61
400586021, 2015-01-15, Idaho, (7-8; 2-2 Big Sky), 41, 35, 0, 76, Sacramento St, (10-6; 4-1 Big Sky), 33, 46, 0, 79
400586022, 2015-01-15, E Washington, (13-4; 4-0 Big Sky), 42, 50, 0, 92, Portland State, (8-7; 2-3 Big Sky), 29, 56, 0, 85
400595954, 2015-01-15, UC Irvine, (9-8; 2-1 Big West), 42, 21, 0, 63, CS Fullerton, (8-9; 0-2 Big West), 26, 32, 0, 58
400587302, 2015-01-15, BYU, (15-5; 5-2 WCC), 43, 50, 0, 93, Pacific, (9-9; 1-5 WCC), 34, 46, 0, 80
400587305, 2015-01-15, San Diego, (9-10; 2-5 WCC), 21, 37, 0, 58, Saint Mary's, (14-3; 6-0 WCC), 36, 34, 0, 70
400593266, 2015-01-15, Oregon, (12-5; 2-2 Pac-12), 52, 42, 5, 99, Washington St, (9-7; 3-1 Pac-12), 57, 37, 14, 108
400587303, 2015-01-15, Gonzaga, (17-1; 6-0 WCC), 40, 38, 0, 78, Pepperdine, (11-6; 4-2 WCC), 31, 45, 0, 76
400586238, 2015-01-16, Manhattan, (8-8; 5-2 MAAC), 30, 29, 13, 72, St Peter's, (9-10; 3-5 MAAC), 35, 24, 6, 65
400586239, 2015-01-16, Iona, (13-5; 6-1 MAAC), 41, 39, 0, 80, Niagara, (3-13; 2-5 MAAC), 34, 45, 0, 79
400586240, 2015-01-16, Marist, (1-16; 0-7 MAAC), 23, 31, 0, 54, Fairfield, (6-11; 4-3 MAAC), 26, 34, 0, 60
400596024, 2015-01-16, Sacred Heart, (7-11; 1-4 NEC), 32, 46, 0, 78, St Francis (PA), (10-6; 4-1 NEC), 49, 30, 0, 79
400586241, 2015-01-16, Siena, (6-10; 3-4 MAAC), 22, 27, 0, 49, Canisius, (9-7; 4-3 MAAC), 35, 48, 0, 83
400586971, 2015-01-16, W Illinois, (7-10; 2-4 Summit), 25, 23, 0, 48, North Dakota St, (12-6; 4-1 Summit), 33, 28, 0, 61
400591815, 2015-01-16, St Francis (BKN), (10-8; 4-1 NEC), 21, 47, 0, 68, Robert Morris, (7-10; 3-2 NEC), 29, 34, 0, 63
400586785, 2015-01-17, Tulsa, (12-5; 5-0 American), 32, 43, 0, 75, USF, (7-11; 1-4 American), 27, 31, 0, 58
400587922, 2015-01-17, Duke, (15-2; 3-2 ACC), 30, 33, 0, 63, Louisville, (15-3; 3-2 ACC), 20, 32, 0, 52
400587506, 2015-01-17, N Illinois, (7-8; 1-3 MAC), 24, 22, 0, 46, E Michigan, (12-5; 1-3 MAC), 27, 27, 0, 54
400588418, 2015-01-17, Marquette, (10-7; 2-3 Big East), 31, 27, 0, 58, Xavier, (12-6; 3-3 Big East), 22, 40, 0, 62
400595466, 2015-01-17, Rutgers, (10-9; 2-4 Big Ten), 37, 43, 0, 80, Minnesota, (12-7; 1-5 Big Ten), 42, 47, 0, 89
400595650, 2015-01-17, SF Austin, (14-3; 4-0 Southland), 33, 49, 0, 82, Abil Christian, (9-8; 3-1 Southland), 37, 27, 0, 64
400597334, 2015-01-17, Texas A&M, (11-5; 2-2 SEC), 32, 35, 0, 67, LSU, (13-4; 2-2 SEC), 40, 24, 0, 64
400597940, 2015-01-17, William & Mary, (11-6; 5-1 CAA), 35, 50, 0, 85, Towson, (8-11; 1-5 CAA), 35, 37, 0, 72
400599461, 2015-01-17, Tulane, (13-5; 4-2 American), 33, 35, 0, 68, Houston, (7-10; 0-6 American), 33, 32, 0, 65
400591172, 2015-01-17, Saint Louis, (9-9; 1-4 A 10), 22, 23, 0, 45, Dayton, (15-2; 5-0 A 10), 27, 34, 0, 61
400588735, 2015-01-17, North Florida, (11-9; 3-0 A-Sun), 44, 36, 0, 80, Stetson, (5-13; 0-3 A-Sun), 37, 28, 0, 65
400589176, 2015-01-17, Furman, (5-12; 3-4 Southern), 27, 47, 0, 74, The Citadel, (8-10; 3-4 Southern), 30, 32, 0, 62
400589178, 2015-01-17, East Tenn St, (10-6; 5-3 Southern), 32, 47, 0, 79, VMI, (7-12; 3-5 Southern), 32, 53, 0, 85
400589363, 2015-01-17, Radford, (12-7; 3-3 Big South), 39, 46, 0, 85, Winthrop, (8-9; 3-3 Big South), 38, 39, 0, 77
400595467, 2015-01-17, Purdue, (11-7; 3-2 Big Ten), 25, 42, 17, 84, Penn State, (12-6; 0-5 Big Ten), 34, 33, 10, 77
400597725, 2015-01-17, UVM, (9-8; 4-0 Am. East), 33, 38, 0, 71, UMBC, (2-15; 0-4 Am. East), 31, 23, 0, 54
400587923, 2015-01-17, NC State, (13-6; 4-2 ACC), 42, 30, 0, 72, FSU, (9-9; 1-4 ACC), 30, 33, 0, 63
400587925, 2015-01-17, UVA, (17-0; 5-0 ACC), 27, 39, 0, 66, Boston College, (8-8; 0-4 ACC), 24, 27, 0, 51
400587924, 2015-01-17, Miami (FL), (12-5; 2-2 ACC), 30, 40, 0, 70, Notre Dame, (17-2; 5-1 ACC), 29, 46, 0, 75
400586416, 2015-01-17, Wichita State, (16-2; 6-0 MVC), 28, 33, 0, 61, Evansville, (13-5; 3-3 MVC), 18, 23, 0, 41
400591174, 2015-01-17, VCU, (15-3; 5-0 A 10), 40, 30, 0, 70, Duquesne, (6-10; 1-4 A 10), 26, 38, 0, 64
400586789, 2015-01-17, UCF, (9-8; 2-4 American), 28, 51, 0, 79, Memphis, (11-6; 4-2 American), 39, 60, 0, 99
400587145, 2015-01-17, American U, (11-7; 4-2 Patriot), 33, 45, 0, 78, Lafayette, (11-6; 3-3 Patriot), 26, 50, 0, 76
400587146, 2015-01-17, Holy Cross, (6-10; 1-5 Patriot), 28, 36, 0, 64, Lehigh, (8-9; 2-4 Patriot), 44, 25, 0, 69
400588734, 2015-01-17, N Kentucky, (8-10; 2-1 A-Sun), 26, 40, 0, 66, USC Upstate, (13-6; 1-2 A-Sun), 34, 31, 0, 65
400588737, 2015-01-17, Lipscomb, (9-9; 3-0 A-Sun), 47, 44, 0, 91, Kennesaw St, (5-14; 0-3 A-Sun), 36, 41, 0, 77
400591173, 2015-01-17, Fordham, (5-11; 0-5 A 10), 21, 28, 0, 49, La Salle, (10-8; 2-3 A 10), 30, 30, 0, 60
400591224, 2015-01-17, Yale, (12-6; 1-0 Ivy), 47, 33, 0, 80, Brown, (9-9; 0-1 Ivy), 31, 31, 0, 62
400595468, 2015-01-17, OSU, (14-5; 3-3 Big Ten), 26, 41, 0, 67, Iowa, (13-5; 4-1 Big Ten), 37, 39, 0, 76
400596387, 2015-01-17, E Illinois, (12-6; 6-0 OVC), 25, 40, 0, 65, Morehead State, (7-13; 2-3 OVC), 19, 43, 0, 62
400596475, 2015-01-17, UNH, (9-9; 2-3 Am. East), 28, 32, 13, 73, Binghamton, (2-18; 1-4 Am. East), 29, 31, 6, 66
400596504, 2015-01-17, Stony Brook, (12-7; 3-1 Am. East), 41, 41, 0, 82, Maine, (1-16; 0-5 Am. East), 16, 23, 0, 39
400597335, 2015-01-17, Florida, (10-7; 3-1 SEC), 31, 30, 0, 61, Georgia, (11-5; 2-2 SEC), 36, 37, 0, 73
400597904, 2015-01-17, UNC-Wilmington, (9-8; 4-2 CAA), 33, 46, 0, 79, Hofstra, (13-6; 4-2 CAA), 38, 36, 0, 74
400591780, 2015-01-17, Mt St Mary's, (8-9; 4-2 NEC), 19, 42, 0, 61, LIU Brooklyn, (6-11; 2-4 NEC), 29, 25, 0, 54
400599777, 2015-01-17, URI, (11-5; 3-2 A 10), 27, 29, 0, 56, UMass, (10-8; 3-2 A 10), 28, 32, 0, 60
400585797, 2015-01-17, Baylor, (13-4; 2-3 Big 12), 33, 28, 0, 61, Kansas State, (11-7; 4-1 Big 12), 24, 39, 0, 63
400586024, 2015-01-17, N Colorado, (9-7; 4-1 Big Sky), 34, 35, 19, 88, North Dakota, (5-11; 1-4 Big Sky), 31, 38, 9, 78
400590793, 2015-01-17, Chicago State, (4-15; 0-2 WAC), 23, 39, 0, 62, UMKC, (6-13; 1-1 WAC), 37, 27, 0, 64
400591282, 2015-01-17, NJIT, (10-10; 4-9 away), 16, 37, 0, 53, Dartmouth, (7-8; 0-1 Ivy), 23, 39, 0, 62
400591458, 2015-01-17, UTEP, (12-5; 4-1 C-USA), 30, 43, 0, 73, UTSA, (8-8; 2-3 C-USA), 26, 29, 0, 55
400597756, 2015-01-17, Green Bay, (15-4; 4-1 Horizon), 27, 43, 0, 70, Detroit, (9-10; 3-2 Horizon), 30, 34, 0, 64
400586417, 2015-01-17, Indiana State, (9-9; 5-1 MVC), 39, 39, 0, 78, Drake, (4-14; 1-5 MVC), 40, 44, 0, 84
400587509, 2015-01-17, Miami (OH), (6-11; 1-3 MAC), 32, 36, 0, 68, Buffalo, (12-4; 3-1 MAC), 29, 48, 0, 77
400591719, 2015-01-17, Bryant, (8-7; 5-1 NEC), 28, 42, 0, 70, Cent Conn St, (2-17; 0-6 NEC), 27, 27, 0, 54
400595271, 2015-01-17, Georgia State, (11-7; 4-3 Sun Belt), 40, 29, 0, 69, Appalachian St, (5-10; 2-4 Sun Belt), 30, 44, 0, 74
400597336, 2015-01-17, Kentucky, (17-0; 4-0 SEC), 35, 35, 0, 70, Alabama, (12-5; 2-2 SEC), 17, 31, 0, 48
400587307, 2015-01-17, Gonzaga, (18-1; 7-0 WCC), 38, 34, 0, 72, Loyola Mary, (5-14; 1-6 WCC), 27, 28, 0, 55
400595469, 2015-01-17, Michigan State, (12-6; 3-2 Big Ten), 26, 33, 0, 59, Maryland, (17-2; 5-1 Big Ten), 40, 35, 0, 75
400585798, 2015-01-17, TCU, (14-3; 1-3 Big 12), 24, 38, 0, 62, Texas Tech, (10-8; 0-5 Big 12), 14, 28, 0, 42
400586787, 2015-01-17, ECU, (8-10; 1-4 American), 22, 32, 0, 54, SMU, (14-4; 5-1 American), 34, 43, 0, 77
400587147, 2015-01-17, Colgate, (8-11; 5-1 Patriot), 23, 42, 0, 65, Navy, (7-11; 3-3 Patriot), 36, 17, 0, 53
400587510, 2015-01-17, Ball State, (7-8; 2-2 MAC), 27, 19, 0, 46, Bowling Green, (11-4; 3-1 MAC), 23, 35, 0, 58
400587926, 2015-01-17, Georgia Tech, (9-8; 0-5 ACC), 31, 34, 0, 65, Pitt, (13-5; 3-2 ACC), 31, 39, 0, 70
400587927, 2015-01-17, Syracuse, (13-5; 4-1 ACC), 18, 35, 0, 53, Clemson, (10-7; 2-3 ACC), 39, 27, 0, 66
400589364, 2015-01-17, UNC Asheville, (8-8; 4-1 Big South), 32, 37, 0, 69, Campbell, (7-12; 1-5 Big South), 35, 30, 0, 65
400591456, 2015-01-17, Mid Tennessee, (10-8; 3-2 C-USA), 35, 33, 0, 68, LA Tech, (14-4; 5-0 C-USA), 35, 40, 0, 75
400597337, 2015-01-17, Vanderbilt, (11-6; 1-3 SEC), 26, 28, 0, 54, Miss St, (8-9; 1-3 SEC), 18, 39, 0, 57
400597858, 2015-01-17, Drexel, (4-13; 2-4 CAA), 35, 31, 0, 66, Delaware, (3-14; 2-4 CAA), 23, 39, 0, 62
400598601, 2015-01-17, Florida A&M, (0-17; 0-4 MEAC), 30, 35, 0, 65, Morgan State, (4-15; 2-3 MEAC), 42, 33, 0, 75
400598602, 2015-01-17, Bethune-Cookman, (5-13; 1-3 MEAC), 25, 33, 0, 58, Coppin State, (1-16; 0-4 MEAC), 22, 31, 0, 53
400598629, 2015-01-17, S Carolina St, (5-14; 3-2 MEAC), 31, 18, 0, 49, Delaware State, (8-9; 2-1 MEAC), 26, 34, 0, 60
400598600, 2015-01-17, Savannah State, (4-13; 0-3 MEAC), 25, 32, 0, 57, MD-E Shore, (10-9; 3-1 MEAC), 39, 48, 0, 87
400595648, 2015-01-17, Lamar, (9-8; 3-2 Southland), 39, 45, 0, 84, Northwestern St, (8-8; 3-2 Southland), 45, 51, 0, 96
400589177, 2015-01-17, Samford, (7-14; 0-8 Southern), 26, 30, 0, 56, Mercer, (11-9; 6-1 Southern), 40, 40, 0, 80
400589365, 2015-01-17, Gardner-Webb, (12-7; 4-2 Big South), 37, 45, 0, 82, Coast Carolina, (14-4; 5-1 Big South), 34, 33, 0, 67
400591246, 2015-01-17, Columbia, (9-6; 1-0 Ivy), 27, 21, 0, 48, Cornell, (8-9; 0-1 Ivy), 17, 28, 0, 45
400591761, 2015-01-17, Wagner, (5-12; 3-3 NEC), 42, 40, 0, 82, Fair Dickinson, (7-10; 2-4 NEC), 31, 37, 0, 68
400593267, 2015-01-17, Colorado, (9-8; 2-3 Pac-12), 28, 44, 0, 72, Arizona State, (9-9; 1-4 Pac-12), 29, 49, 0, 78
400595649, 2015-01-17, Texas A&M-CC, (8-8; 3-1 Southland), 32, 37, 0, 69, Nicholls State, (4-10; 1-3 Southland), 33, 33, 0, 66
400599604, 2015-01-17, George Mason, (6-11; 1-4 A 10), 20, 33, 0, 53, G Washington, (14-4; 4-1 A 10), 26, 37, 0, 63
400586418, 2015-01-17, Bradley, (6-13; 1-5 MVC), 31, 41, 0, 72, Illinois State, (11-7; 3-3 MVC), 46, 36, 0, 82
400588419, 2015-01-17, Butler, (13-6; 3-3 Big East), 31, 28, 0, 59, Georgetown, (12-5; 4-2 Big East), 27, 34, 0, 61
400589366, 2015-01-17, Liberty, (6-13; 0-6 Big South), 30, 41, 0, 71, Longwood, (6-13; 2-4 Big South), 41, 44, 0, 85
400595651, 2015-01-17, SE Louisiana, (5-12; 2-2 Southland), 40, 43, 25, 108, Incarnate Word, (9-5; 1-3 Southland), 44, 39, 15, 98
400595273, 2015-01-17, Ga Southern, (11-4; 4-2 Sun Belt), 39, 32, 0, 71, Troy, (7-8; 2-4 Sun Belt), 40, 35, 0, 75
400586973, 2015-01-17, South Dakota, (9-10; 3-2 Summit), 29, 28, 0, 57, South Dakota St, (13-7; 4-2 Summit), 31, 40, 0, 71
400591453, 2015-01-17, Marshall, (4-14; 0-5 C-USA), 34, 28, 0, 62, FAU, (8-8; 1-4 C-USA), 30, 46, 0, 76
400595275, 2015-01-17, AR-Little Rock, (6-10; 1-5 Sun Belt), 19, 33, 0, 52, UL Monroe, (11-6; 5-1 Sun Belt), 28, 36, 0, 64
400595652, 2015-01-17, McNeese State, (6-9; 0-4 Southland), 30, 30, 0, 60, Sam Houston, (13-4; 5-0 Southland), 29, 40, 0, 69
400586029, 2015-01-17, Idaho State, (4-14; 1-5 Big Sky), 37, 32, 0, 69, N Arizona, (8-10; 3-2 Big Sky), 30, 42, 0, 72
400587310, 2015-01-17, San Francisco, (8-11; 2-5 WCC), 28, 36, 0, 64, Santa Clara, (9-10; 3-4 WCC), 39, 31, 0, 70
400591175, 2015-01-17, Davidson, (12-4; 3-2 A 10), 27, 36, 0, 63, Richmond, (10-8; 3-2 A 10), 42, 47, 0, 89
400591454, 2015-01-17, W Kentucky, (12-5; 5-0 C-USA), 24, 41, 0, 65, FIU, (9-9; 2-3 C-USA), 24, 34, 0, 58
400591638, 2015-01-17, UNLV, (10-8; 1-4 MW), 24, 23, 0, 47, San Diego State, (14-4; 4-1 MW), 17, 36, 0, 53
400591639, 2015-01-17, Air Force, (8-9; 1-5 MW), 21, 38, 0, 59, Utah State, (10-7; 3-2 MW), 31, 40, 0, 71
400597338, 2015-01-17, Tennessee, (11-5; 3-1 SEC), 26, 33, 0, 59, Missouri, (7-10; 1-3 SEC), 24, 27, 0, 51
400598603, 2015-01-17, NC A&T, (5-14; 2-3 MEAC), 32, 32, 0, 64, Hampton, (8-9; 4-1 MEAC), 28, 33, 0, 61
400598604, 2015-01-17, NC Central, (13-5; 5-0 MEAC), 32, 28, 0, 60, Norfolk State, (11-9; 4-1 MEAC), 23, 33, 0, 56
400585800, 2015-01-17, West Virginia, (15-3; 3-2 Big 12), 23, 27, 0, 50, Texas, (13-4; 2-2 Big 12), 37, 40, 0, 77
400591022, 2015-01-17, AR-Pine Bluff, (3-15; 0-4 SWAC), 30, 30, 0, 60, Southern, (7-12; 4-1 SWAC), 42, 28, 0, 70
400591071, 2015-01-17, Miss Valley St, (2-15; 1-3 SWAC), 34, 33, 0, 67, Alcorn State, (4-13; 3-2 SWAC), 41, 46, 0, 87
400591047, 2015-01-17, Jackson State, (4-14; 2-3 SWAC), 23, 32, 0, 55, PV A&M, (3-14; 1-3 SWAC), 36, 34, 0, 70
400588421, 2015-01-17, Villanova, (17-1; 4-1 Big East), 23, 39, 0, 62, Penn, (4-9; 0-1 Ivy), 21, 26, 0, 47
400593268, 2015-01-17, Utah, (14-3; 4-1 Pac-12), 26, 25, 0, 51, Arizona, (16-2; 4-1 Pac-12), 31, 38, 0, 69
400585801, 2015-01-17, Oklahoma State, (12-5; 2-3 Big 12), 20, 45, 0, 65, Oklahoma, (12-5; 3-2 Big 12), 41, 41, 0, 82
400591640, 2015-01-17, Wyoming, (16-3; 5-1 MW), 26, 18, 26, 70, Fresno State, (9-10; 4-2 MW), 23, 21, 21, 65
400587148, 2015-01-17, Army, (11-6; 2-4 Patriot), 30, 45, 0, 75, Bucknell, (9-10; 4-2 Patriot), 38, 43, 0, 81
400587505, 2015-01-17, Cent Michigan, (12-3; 2-2 MAC), 24, 52, 0, 76, Akron, (12-5; 3-1 MAC), 39, 43, 0, 82
400587507, 2015-01-17, Ohio, (5-10; 0-4 MAC), 19, 40, 0, 59, Kent State, (12-5; 3-1 MAC), 30, 39, 0, 69
400587508, 2015-01-17, W Michigan, (12-5; 3-1 MAC), 38, 32, 11, 81, Toledo, (10-7; 2-2 MAC), 35, 35, 8, 78
400588736, 2015-01-17, Jacksonville, (7-13; 1-2 A-Sun), 28, 22, 0, 50, FGCU, (12-7; 2-1 A-Sun), 41, 38, 0, 79
400589179, 2015-01-17, W Carolina, (8-11; 3-4 Southern), 17, 26, 0, 43, Wofford, (14-5; 5-1 Southern), 24, 38, 0, 62
400591452, 2015-01-17, Rice, (5-11; 2-3 C-USA), 33, 26, 14, 73, Charlotte, (8-9; 2-3 C-USA), 26, 33, 9, 68
400591457, 2015-01-17, North Texas, (7-10; 1-4 C-USA), 22, 28, 0, 50, Old Dominion, (15-2; 4-1 C-USA), 32, 29, 0, 61
400595955, 2015-01-17, UCSB, (8-9; 1-2 Big West), 21, 32, 0, 53, LBSU, (9-11; 3-1 Big West), 35, 34, 0, 69
400596382, 2015-01-17, SIU-ED, (7-10; 3-3 OVC), 33, 29, 0, 62, E Kentucky, (11-6; 3-1 OVC), 32, 46, 0, 78
400596383, 2015-01-17, Jacksonville St, (8-12; 1-5 OVC), 22, 30, 0, 52, UT Martin, (11-6; 3-1 OVC), 34, 21, 0, 55
400596491, 2015-01-17, UMass Lowell, (9-9; 3-2 Am. East), 24, 30, 8, 62, Hartford, (10-7; 3-1 Am. East), 33, 21, 14, 68
400597737, 2015-01-17, Cleveland State, (11-9; 5-1 Horizon), 31, 43, 0, 74, Youngstown St, (9-12; 0-6 Horizon), 22, 39, 0, 61
400597822, 2015-01-17, Valparaiso, (17-3; 4-1 Horizon), 29, 37, 0, 66, Wright State, (10-9; 2-3 Horizon), 27, 29, 0, 56
400597840, 2015-01-17, Charleston, (6-13; 1-5 CAA), 31, 36, 0, 67, Northeastern, (13-5; 5-1 CAA), 38, 31, 0, 69
400598794, 2015-01-17, Alabama State, (9-5; 5-0 SWAC), 25, 34, 0, 59, Alabama A&M, (4-11; 3-2 SWAC), 28, 28, 0, 56
400596384, 2015-01-17, Tenn Tech, (9-10; 1-5 OVC), 30, 31, 0, 61, SE Missouri St, (9-10; 3-3 OVC), 32, 33, 0, 65
400586786, 2015-01-17, Temple, (12-7; 3-3 American), 28, 25, 0, 53, Cincinnati, (12-5; 3-2 American), 29, 55, 0, 84
400588420, 2015-01-17, Providence, (14-5; 4-2 Big East), 34, 40, 0, 74, Creighton, (9-10; 0-6 Big East), 24, 41, 0, 65
400589367, 2015-01-17, Charleston So, (10-7; 4-2 Big South), 32, 41, 0, 73, Presbyterian, (6-13; 2-4 Big South), 29, 36, 0, 65
400586972, 2015-01-17, IPFW, (8-10; 1-4 Summit), 27, 31, 0, 58, Oral Roberts, (10-8; 4-1 Summit), 23, 39, 0, 62
400587308, 2015-01-17, Portland, (11-8; 2-5 WCC), 32, 31, 0, 63, Pepperdine, (12-6; 5-2 WCC), 31, 36, 0, 67
400591455, 2015-01-17, UAB, (8-10; 4-1 C-USA), 36, 27, 0, 63, Southern Miss, (5-11; 0-5 C-USA), 31, 25, 0, 56
400595653, 2015-01-17, New Orleans, (5-8; 1-3 Southland), 40, 33, 0, 73, Houston Baptist, (7-8; 2-3 Southland), 34, 40, 0, 74
400596386, 2015-01-17, Tennessee St, (3-17; 0-5 OVC), 23, 49, 0, 72, Murray State, (15-4; 5-0 OVC), 42, 49, 0, 91
400597891, 2015-01-17, Elon, (10-9; 2-4 CAA), 30, 42, 0, 72, JMU, (11-8; 4-2 CAA), 33, 42, 0, 75
400595272, 2015-01-17, Texas State, (10-6; 4-3 Sun Belt), 33, 33, 7, 73, Arkansas State, (8-8; 3-4 Sun Belt), 26, 40, 12, 78
400595470, 2015-01-17, Northwestern, (10-8; 1-4 Big Ten), 32, 22, 0, 54, Michigan, (11-7; 4-2 Big Ten), 31, 25, 0, 56
400595274, 2015-01-17, South Alabama, (5-12; 3-4 Sun Belt), 35, 54, 0, 89, LA-Lafayette, (10-7; 4-2 Sun Belt), 44, 38, 0, 82
400596385, 2015-01-17, Belmont, (11-7; 3-2 OVC), 38, 51, 0, 89, Austin Peay, (6-12; 1-3 OVC), 37, 46, 0, 83
400597339, 2015-01-17, South Carolina, (10-6; 1-3 SEC), 29, 39, 0, 68, Auburn, (10-7; 2-2 SEC), 39, 32, 0, 71
400598807, 2015-01-17, Grambling St, (2-13; 0-5 SWAC), 17, 34, 0, 51, Texas Southern, (7-10; 4-0 SWAC), 34, 26, 0, 60
400585799, 2015-01-17, Kansas, (14-3; 3-1 Big 12), 33, 48, 0, 81, Iowa State, (13-3; 3-1 Big 12), 36, 50, 0, 86
400586025, 2015-01-17, Weber State, (8-9; 3-3 Big Sky), 33, 27, 0, 60, Southern Utah, (5-11; 2-3 Big Sky), 36, 34, 0, 70
400586026, 2015-01-17, Montana State, (3-14; 0-5 Big Sky), 19, 29, 0, 48, Montana, (8-8; 4-1 Big Sky), 29, 34, 0, 63
400586788, 2015-01-17, UConn, (9-7; 2-2 American), 29, 30, 0, 59, Stanford, (13-4; 4-1 Pac-12), 32, 40, 0, 72
400593269, 2015-01-17, Oregon State, (12-5; 3-2 Pac-12), 25, 37, 0, 62, Washington St, (9-8; 3-2 Pac-12), 16, 31, 0, 47
400595957, 2015-01-17, UC Davis, (14-3; 4-0 Big West), 43, 36, 0, 79, CS Fullerton, (8-10; 0-3 Big West), 30, 38, 0, 68
400596126, 2015-01-17, Ole Miss, (11-6; 2-2 SEC), 52, 44, 0, 96, Arkansas, (13-4; 2-2 SEC), 40, 42, 0, 82
400587309, 2015-01-17, San Diego, (9-11; 2-6 WCC), 27, 30, 0, 57, Pacific, (10-9; 2-5 WCC), 24, 35, 0, 59
400590794, 2015-01-17, UT Pan American, (7-12; 1-2 WAC), 26, 27, 0, 53, CSU Bakersfield, (5-13; 1-2 WAC), 41, 25, 0, 66
400591641, 2015-01-17, Colorado State, (17-2; 4-2 MW), 34, 36, 0, 70, San Jose State, (2-16; 0-6 MW), 22, 19, 0, 41
400595958, 2015-01-17, Cal Poly, (8-8; 1-3 Big West), 21, 27, 0, 48, CS Northridge, (6-13; 2-2 Big West), 19, 36, 0, 55
400586027, 2015-01-17, Idaho, (7-9; 2-3 Big Sky), 31, 42, 0, 73, Portland State, (9-7; 3-3 Big Sky), 37, 48, 0, 85
400586028, 2015-01-17, E Washington, (13-5; 4-1 Big Sky), 41, 36, 0, 77, Sacramento St, (11-6; 5-1 Big Sky), 41, 49, 0, 90
400590795, 2015-01-17, New Mexico St, (10-10; 2-1 WAC), 28, 24, 0, 52, Seattle, (9-8; 2-1 WAC), 28, 30, 0, 58
400587306, 2015-01-17, BYU, (15-6; 5-3 WCC), 37, 40, 0, 77, Saint Mary's, (15-3; 7-0 WCC), 45, 37, 0, 82
400595956, 2015-01-17, Hawaii, (13-6; 1-2 Big West), 31, 31, 0, 62, UC Riverside, (9-9; 2-2 Big West), 28, 38, 0, 66
400587149, 2015-01-18, Boston U, (7-10; 3-3 Patriot), 30, 44, 12, 86, Loyola (MD), (7-10; 3-3 Patriot), 30, 44, 17, 91
400591816, 2015-01-18, Sacred Heart, (7-12; 1-5 NEC), 35, 30, 0, 65, Robert Morris, (8-10; 4-2 NEC), 47, 38, 0, 85
400595471, 2015-01-18, Indiana, (14-4; 4-1 Big Ten), 38, 42, 0, 80, Illinois, (12-7; 2-4 Big Ten), 34, 40, 0, 74
400586225, 2015-01-18, Siena, (7-10; 4-4 MAAC), 39, 35, 0, 74, Niagara, (3-14; 2-6 MAAC), 35, 35, 0, 70
400586242, 2015-01-18, Rider, (12-7; 6-2 MAAC), 37, 37, 8, 82, Manhattan, (8-9; 5-3 MAAC), 36, 38, 5, 79
400586245, 2015-01-18, Iona, (13-6; 6-2 MAAC), 34, 40, 0, 74, Canisius, (10-7; 5-3 MAAC), 42, 36, 0, 78
400586974, 2015-01-18, IUPUI, (7-12; 3-2 Summit), 40, 49, 0, 89, Omaha, (7-11; 1-5 Summit), 31, 53, 0, 84
400596034, 2015-01-18, St Francis (BKN), (11-8; 5-1 NEC), 26, 34, 0, 60, St Francis (PA), (10-7; 4-2 NEC), 27, 32, 0, 59
400588422, 2015-01-18, St John's, (12-5; 1-4 Big East), 29, 32, 6, 67, DePaul, (10-9; 4-2 Big East), 19, 42, 10, 71
400599927, 2015-01-18, Saint Joe's, (7-9; 1-4 A 10), 29, 32, 0, 61, St Bonaventure, (10-6; 3-2 A 10), 28, 42, 0, 70
400586243, 2015-01-18, Quinnipiac, (9-8; 3-5 MAAC), 29, 43, 0, 72, Marist, (1-17; 0-8 MAAC), 34, 37, 0, 71
400597811, 2015-01-18, Non D-I School, NA, 33, 35, 0, 68, Oakland, (7-12; 2-2 Horizon), 47, 36, 0, 83
400586419, 2015-01-18, Missouri State, (8-10; 2-4 MVC), 20, 26, 0, 46, Northern Iowa, (16-2; 5-1 MVC), 32, 28, 0, 60
400586246, 2015-01-18, Fairfield, (6-12; 4-4 MAAC), 30, 40, 0, 70, Monmouth, (9-9; 6-2 MAAC), 26, 51, 0, 77
400591642, 2015-01-18, Boise State, (12-6; 2-3 MW), 30, 39, 0, 69, New Mexico, (12-6; 4-2 MW), 31, 28, 0, 59
400586420, 2015-01-18, Loyola (CHI), (13-5; 3-3 MVC), 20, 32, 0, 52, S Illinois, (8-11; 1-5 MVC), 23, 36, 0, 59
400587928, 2015-01-18, VT, (8-9; 0-4 ACC), 21, 32, 0, 53, UNC, (14-4; 4-1 ACC), 34, 34, 0, 68
400593270, 2015-01-18, Oregon, (12-6; 2-3 Pac-12), 42, 35, 0, 77, Washington, (13-4; 2-3 Pac-12), 32, 53, 0, 85
400596492, 2015-01-19, Hartford, (11-7; 4-1 Am. East), 33, 32, 0, 65, UMBC, (2-16; 0-5 Am. East), 26, 37, 0, 63
400596505, 2015-01-19, NJIT, (11-10; 5-9 away), 25, 40, 0, 65, Maine, (1-17; 0-5 Am. East), 24, 31, 0, 55
400597757, 2015-01-19, Detroit, (10-10; 3-2 Horizon), 26, 34, 21, 81, Northeastern, (13-6; 5-1 CAA), 26, 34, 9, 69
400596537, 2015-01-19, UMass Lowell, (9-10; 3-3 Am. East), 28, 29, 7, 64, UNH, (10-9; 3-3 Am. East), 25, 32, 10, 67
400598606, 2015-01-19, Bethune-Cookman, (6-13; 2-3 MEAC), 31, 34, 0, 65, Morgan State, (4-16; 2-4 MEAC), 26, 32, 0, 58
400587929, 2015-01-19, Pitt, (13-6; 3-3 ACC), 25, 40, 0, 65, Duke, (16-2; 4-2 ACC), 41, 38, 0, 79
400585802, 2015-01-19, Texas, (14-4; 3-2 Big 12), 33, 33, 0, 66, TCU, (14-4; 1-4 Big 12), 20, 28, 0, 48
400589368, 2015-01-19, Longwood, (6-14; 2-5 Big South), 22, 45, 0, 67, High Point, (14-4; 5-1 Big South), 38, 34, 0, 72
400596127, 2015-01-19, Albany, (10-7; 5-0 Am. East), 31, 33, 0, 64, Stony Brook, (12-8; 3-2 Am. East), 25, 22, 0, 47
400596476, 2015-01-19, Binghamton, (2-19; 1-5 Am. East), 24, 20, 0, 44, UVM, (10-8; 5-0 Am. East), 34, 30, 0, 64
400606912, 2015-01-19, Non D-I School, NA, 29, 23, 0, 52, East Tenn St, (11-6; 5-3 Southern), 42, 48, 0, 90
400589369, 2015-01-19, UNC Asheville, (8-9; 4-2 Big South), 35, 40, 0, 75, Charleston So, (11-7; 5-2 Big South), 41, 41, 0, 82
400598608, 2015-01-19, S Carolina St, (6-14; 4-2 MEAC), 33, 31, 9, 73, MD-E Shore, (10-10; 3-2 MEAC), 35, 29, 8, 72
400598607, 2015-01-19, Florida A&M, (0-18; 0-5 MEAC), 23, 52, 0, 75, Coppin State, (2-16; 1-4 MEAC), 49, 38, 0, 87
400598609, 2015-01-19, Savannah State, (4-14; 0-4 MEAC), 29, 21, 0, 50, Delaware State, (9-9; 3-1 MEAC), 21, 38, 0, 59
400595654, 2015-01-19, Cent Arkansas, (0-16; 0-5 Southland), 22, 39, 0, 61, Houston Baptist, (8-8; 3-3 Southland), 39, 45, 0, 84
400595655, 2015-01-19, SE Louisiana, (5-13; 2-3 Southland), 28, 22, 0, 50, Lamar, (10-8; 4-2 Southland), 29, 28, 0, 57
400595656, 2015-01-19, New Orleans, (5-9; 1-4 Southland), 29, 25, 0, 54, SF Austin, (15-3; 5-0 Southland), 36, 43, 0, 79
400595277, 2015-01-19, AR-Little Rock, (6-11; 1-6 Sun Belt), 32, 32, 0, 64, South Alabama, (6-12; 4-4 Sun Belt), 35, 31, 0, 66
400595280, 2015-01-19, Texas State, (10-7; 4-4 Sun Belt), 28, 27, 0, 55, UT-Arlington, (10-7; 4-3 Sun Belt), 30, 36, 0, 66
400598610, 2015-01-19, NC Central, (14-5; 6-0 MEAC), 18, 41, 0, 59, Hampton, (8-10; 4-2 MEAC), 28, 24, 0, 52
400595276, 2015-01-19, Georgia State, (12-7; 5-3 Sun Belt), 29, 31, 0, 60, Arkansas State, (8-9; 3-5 Sun Belt), 27, 27, 0, 54
400595279, 2015-01-19, UL Monroe, (12-6; 6-1 Sun Belt), 32, 25, 0, 57, LA-Lafayette, (10-8; 4-3 Sun Belt), 30, 25, 0, 55
400598611, 2015-01-19, NC A&T, (5-15; 2-4 MEAC), 34, 26, 0, 60, Norfolk State, (12-9; 5-1 MEAC), 33, 41, 0, 74
400595278, 2015-01-19, Appalachian St, (6-10; 3-4 Sun Belt), 29, 40, 0, 69, Troy, (7-9; 2-5 Sun Belt), 34, 30, 0, 64
400591072, 2015-01-19, AR-Pine Bluff, (4-15; 1-4 SWAC), 23, 31, 0, 54, Alcorn State, (4-14; 3-3 SWAC), 25, 24, 0, 49
400591048, 2015-01-19, Jackson State, (4-15; 2-4 SWAC), 21, 33, 0, 54, Texas Southern, (8-10; 5-0 SWAC), 38, 29, 0, 67
400588423, 2015-01-19, Villanova, (17-2; 4-2 Big East), 20, 38, 0, 58, Georgetown, (13-5; 5-2 Big East), 42, 36, 0, 78
400585803, 2015-01-19, Oklahoma, (12-6; 3-3 Big 12), 32, 46, 0, 78, Kansas, (15-3; 4-1 Big 12), 51, 34, 0, 85
400587930, 2015-01-19, FSU, (10-9; 2-4 ACC), 28, 31, 0, 59, Clemson, (10-8; 2-4 ACC), 22, 33, 0, 55
400591023, 2015-01-19, Miss Valley St, (2-16; 1-4 SWAC), 30, 25, 0, 55, Southern, (8-12; 5-1 SWAC), 43, 36, 0, 79
400598808, 2015-01-19, Grambling St, (2-14; 0-6 SWAC), 21, 39, 0, 60, PV A&M, (4-14; 2-3 SWAC), 36, 38, 0, 74
400591296, 2015-01-20, Harvard, (11-4; 1-0 Ivy), 27, 39, 0, 66, Bryant, (8-8; 5-1 NEC), 21, 36, 0, 57
400595472, 2015-01-20, Michigan, (12-7; 5-2 Big Ten), 24, 30, 0, 54, Rutgers, (10-10; 2-5 Big Ten), 22, 28, 0, 50
400585804, 2015-01-20, Kansas State, (11-8; 4-2 Big 12), 38, 33, 0, 71, Iowa State, (14-3; 4-1 Big 12), 39, 38, 0, 77
400587931, 2015-01-20, Boston College, (8-9; 0-5 ACC), 17, 44, 0, 61, Syracuse, (14-5; 5-1 ACC), 35, 34, 0, 69
400597340, 2015-01-20, LSU, (14-4; 3-2 SEC), 37, 42, 0, 79, Florida, (10-8; 3-2 SEC), 32, 29, 0, 61
400597341, 2015-01-20, Ole Miss, (11-7; 2-3 SEC), 31, 33, 0, 64, Georgia, (12-5; 3-2 SEC), 25, 44, 0, 69
400597823, 2015-01-20, Valparaiso, (18-3; 5-1 Horizon), 34, 43, 0, 77, Youngstown St, (9-13; 0-7 Horizon), 25, 37, 0, 62
400591176, 2015-01-20, Dayton, (15-3; 5-1 A 10), 33, 27, 0, 60, Davidson, (13-4; 4-2 A 10), 45, 32, 0, 77
400595657, 2015-01-20, Sam Houston, (14-4; 6-0 Southland), 39, 23, 0, 62, Nicholls State, (4-11; 1-4 Southland), 12, 27, 0, 39
400595658, 2015-01-20, Abil Christian, (9-9; 3-2 Southland), 19, 37, 0, 56, McNeese State, (7-9; 1-4 Southland), 27, 36, 0, 63
400595659, 2015-01-20, Northwestern St, (8-9; 3-3 Southland), 38, 38, 0, 76, Texas A&M-CC, (9-8; 4-1 Southland), 52, 36, 0, 88
400597774, 2015-01-20, UIC, (5-15; 1-4 Horizon), 28, 27, 0, 55, Green Bay, (16-4; 5-1 Horizon), 41, 37, 0, 78
400597800, 2015-01-20, Wright State, (10-10; 2-4 Horizon), 15, 26, 0, 41, Milwaukee, (7-12; 2-3 Horizon), 34, 33, 0, 67
400586421, 2015-01-20, Illinois State, (12-7; 4-3 MVC), 29, 35, 0, 64, Drake, (4-15; 1-6 MVC), 27, 29, 0, 56
400595473, 2015-01-20, Minnesota, (12-8; 1-6 Big Ten), 25, 24, 0, 49, Nebraska, (11-7; 3-3 Big Ten), 24, 28, 0, 52
400597343, 2015-01-20, Vanderbilt, (11-7; 1-4 SEC), 26, 31, 0, 57, Kentucky, (18-0; 5-0 SEC), 33, 32, 0, 65
400595474, 2015-01-20, Iowa, (13-6; 4-2 Big Ten), 17, 33, 0, 50, Wisconsin, (17-2; 5-1 Big Ten), 35, 47, 0, 82
400597342, 2015-01-20, Tennessee, (12-5; 4-1 SEC), 31, 35, 0, 66, South Carolina, (10-7; 1-4 SEC), 26, 36, 0, 62
400591644, 2015-01-20, San Diego State, (15-4; 5-1 MW), 41, 36, 0, 77, Air Force, (8-10; 1-6 MW), 18, 27, 0, 45
400591643, 2015-01-20, Utah State, (11-7; 4-2 MW), 29, 41, 0, 70, Nevada, (6-11; 2-3 MW), 19, 35, 0, 54
400587932, 2015-01-21, UNC, (15-4; 5-1 ACC), 40, 47, 0, 87, Wake Forest, (9-10; 1-5 ACC), 34, 37, 0, 71
400586214, 2015-01-21, Quinnipiac, (10-8; 4-5 MAAC), 24, 39, 0, 63, St Peter's, (9-11; 3-6 MAAC), 24, 31, 0, 55
400586790, 2015-01-21, Houston, (7-11; 0-7 American), 28, 26, 0, 54, Cincinnati, (13-5; 4-2 American), 24, 43, 0, 67
400586791, 2015-01-21, Memphis, (11-7; 4-3 American), 23, 32, 0, 55, Tulsa, (13-5; 6-0 American), 30, 43, 0, 73
400587150, 2015-01-21, Colgate, (8-12; 5-2 Patriot), 29, 35, 0, 64, Army, (12-6; 3-4 Patriot), 38, 27, 0, 65
400587151, 2015-01-21, Navy, (7-12; 3-4 Patriot), 28, 19, 0, 47, Lehigh, (9-9; 3-4 Patriot), 29, 32, 0, 61
400587152, 2015-01-21, American U, (11-8; 4-3 Patriot), 24, 30, 0, 54, Boston U, (8-10; 4-3 Patriot), 27, 32, 0, 59
400587511, 2015-01-21, E Michigan, (12-6; 1-4 MAC), 26, 32, 0, 58, Bowling Green, (12-4; 4-1 MAC), 37, 37, 0, 74
400587512, 2015-01-21, W Michigan, (13-5; 4-1 MAC), 21, 48, 0, 69, Miami (OH), (6-12; 1-4 MAC), 23, 35, 0, 58
400587513, 2015-01-21, Toledo, (10-8; 2-3 MAC), 24, 36, 0, 60, Kent State, (13-5; 4-1 MAC), 27, 40, 0, 67
400587514, 2015-01-21, Ohio, (6-10; 1-4 MAC), 40, 42, 0, 82, Ball State, (7-9; 2-3 MAC), 32, 41, 0, 73
400587515, 2015-01-21, Buffalo, (12-5; 3-2 MAC), 45, 28, 0, 73, Cent Michigan, (13-3; 3-2 MAC), 38, 46, 0, 84
400588424, 2015-01-21, Marquette, (10-8; 2-4 Big East), 24, 33, 0, 57, St John's, (13-5; 2-4 Big East), 26, 34, 0, 60
400595475, 2015-01-21, Penn State, (12-7; 0-6 Big Ten), 28, 32, 0, 60, Michigan State, (13-6; 4-2 Big Ten), 30, 36, 0, 66
400597344, 2015-01-21, Missouri, (7-11; 1-4 SEC), 31, 19, 0, 50, Texas A&M, (12-5; 3-2 SEC), 24, 38, 0, 62
400597859, 2015-01-21, William & Mary, (11-7; 5-2 CAA), 44, 36, 0, 80, Delaware, (4-14; 3-4 CAA), 32, 52, 0, 84
400597876, 2015-01-21, Drexel, (4-14; 2-5 CAA), 31, 27, 0, 58, Hofstra, (14-6; 5-2 CAA), 39, 47, 0, 86
400599778, 2015-01-21, UMass, (10-9; 3-3 A 10), 27, 29, 0, 56, Saint Joe's, (8-9; 2-4 A 10), 27, 35, 0, 62
400587154, 2015-01-21, Lafayette, (11-7; 3-4 Patriot), 42, 31, 0, 73, Holy Cross, (7-10; 2-5 Patriot), 45, 29, 0, 74
400597841, 2015-01-21, UNC-Wilmington, (10-8; 5-2 CAA), 20, 32, 6, 58, Charleston, (6-14; 1-6 CAA), 27, 25, 4, 56
400586423, 2015-01-21, Indiana State, (9-10; 5-2 MVC), 23, 37, 0, 60, Northern Iowa, (17-2; 6-1 MVC), 31, 35, 0, 66
400585806, 2015-01-21, Non D-I School, NA, 36, 25, 0, 61, Baylor, (14-4; 2-3 Big 12), 37, 44, 0, 81
400586424, 2015-01-21, Bradley, (6-14; 1-6 MVC), 33, 26, 0, 59, S Illinois, (9-11; 2-5 MVC), 34, 36, 0, 70
400586425, 2015-01-21, Evansville, (14-5; 4-3 MVC), 24, 41, 0, 65, Loyola (CHI), (13-6; 3-4 MVC), 23, 33, 0, 56
400586975, 2015-01-21, Oral Roberts, (10-9; 4-2 Summit), 38, 28, 0, 66, Denver, (9-10; 3-3 Summit), 32, 41, 0, 73
400586976, 2015-01-21, IPFW, (8-11; 1-5 Summit), 18, 35, 0, 53, South Dakota St, (14-7; 5-2 Summit), 42, 40, 0, 82
400587153, 2015-01-21, Bucknell, (10-10; 5-2 Patriot), 36, 39, 0, 75, Loyola (MD), (7-11; 3-4 Patriot), 28, 33, 0, 61
400587516, 2015-01-21, Akron, (12-6; 3-2 MAC), 26, 35, 0, 61, N Illinois, (8-8; 2-3 MAC), 33, 31, 0, 64
400591308, 2015-01-21, Monmouth, (10-9; 6-2 MAAC), 42, 29, 0, 71, Penn, (4-10; 0-1 Ivy), 23, 33, 0, 56
400586422, 2015-01-21, Wichita State, (17-2; 7-0 MVC), 39, 37, 0, 76, Missouri State, (8-11; 2-5 MVC), 33, 20, 0, 53
400593271, 2015-01-21, Washington St, (9-9; 3-3 Pac-12), 27, 37, 0, 64, Utah, (15-3; 5-1 Pac-12), 46, 40, 0, 86
400585805, 2015-01-21, Texas Tech, (10-9; 0-6 Big 12), 25, 18, 0, 43, Oklahoma State, (13-5; 3-3 Big 12), 30, 33, 0, 63
400586792, 2015-01-21, SMU, (15-4; 6-1 American), 33, 33, 0, 66, Tulane, (13-6; 4-3 American), 30, 22, 0, 52
400588425, 2015-01-21, Creighton, (9-11; 0-7 Big East), 27, 34, 0, 61, Butler, (14-6; 4-3 Big East), 35, 29, 0, 64
400595476, 2015-01-21, Purdue, (11-8; 3-3 Big Ten), 30, 27, 0, 57, Illinois, (13-7; 3-4 Big Ten), 32, 34, 0, 66
400597345, 2015-01-21, Miss St, (9-9; 2-3 SEC), 31, 47, 0, 78, Auburn, (10-8; 2-3 SEC), 22, 49, 0, 71
400591743, 2015-01-21, Cent Conn St, (2-18; 0-7 NEC), 34, 17, 0, 51, St Francis (BKN), (12-8; 6-1 NEC), 30, 33, 0, 63
400591645, 2015-01-21, San Jose State, (2-17; 0-7 MW), 17, 19, 0, 36, Boise State, (13-6; 3-3 MW), 45, 41, 0, 86
400591646, 2015-01-21, New Mexico, (13-6; 5-2 MW), 33, 38, 0, 71, UNLV, (10-9; 1-5 MW), 35, 34, 0, 69
400596538, 2015-01-22, Stony Brook, (13-8; 4-2 Am. East), 37, 28, 0, 65, UMass Lowell, (9-11; 3-4 Am. East), 16, 29, 0, 45
400586793, 2015-01-22, USF, (7-12; 1-5 American), 20, 28, 0, 48, Temple, (13-7; 4-3 American), 39, 34, 0, 73
400587933, 2015-01-22, Notre Dame, (18-2; 6-1 ACC), 38, 47, 0, 85, VT, (8-10; 0-5 ACC), 28, 32, 0, 60
400588426, 2015-01-22, DePaul, (11-9; 5-2 Big East), 36, 28, 0, 64, Seton Hall, (13-5; 3-3 Big East), 33, 27, 0, 60
400586249, 2015-01-22, Iona, (14-6; 7-2 MAAC), 41, 37, 0, 78, Rider, (12-8; 6-3 MAAC), 33, 35, 0, 68
400586794, 2015-01-22, UCF, (9-9; 2-5 American), 33, 27, 0, 60, UConn, (10-7; 3-2 American), 39, 28, 0, 67
400588427, 2015-01-22, Xavier, (12-7; 3-4 Big East), 20, 40, 6, 66, Providence, (15-5; 5-2 Big East), 32, 28, 9, 69
400588739, 2015-01-22, FGCU, (13-7; 3-1 A-Sun), 37, 34, 0, 71, USC Upstate, (13-7; 1-3 A-Sun), 28, 40, 0, 68
400588740, 2015-01-22, North Florida, (12-9; 4-0 A-Sun), 33, 41, 0, 74, N Kentucky, (8-11; 2-2 A-Sun), 27, 39, 0, 66
400588741, 2015-01-22, Stetson, (5-14; 0-4 A-Sun), 37, 45, 0, 82, Kennesaw St, (6-14; 1-3 A-Sun), 34, 54, 0, 88
400589180, 2015-01-22, VMI, (7-13; 3-6 Southern), 29, 35, 0, 64, Chattanooga, (13-7; 6-1 Southern), 41, 45, 0, 86
400589181, 2015-01-22, The Citadel, (8-11; 3-5 Southern), 30, 29, 0, 59, East Tenn St, (12-6; 6-3 Southern), 39, 31, 0, 70
400589183, 2015-01-22, Mercer, (11-10; 6-2 Southern), 27, 25, 0, 52, W Carolina, (9-11; 4-4 Southern), 23, 37, 0, 60
400589184, 2015-01-22, Furman, (5-13; 3-5 Southern), 20, 29, 0, 49, Wofford, (15-5; 6-1 Southern), 38, 36, 0, 74
400589370, 2015-01-22, Longwood, (6-15; 2-6 Big South), 30, 37, 0, 67, Gardner-Webb, (13-7; 5-2 Big South), 37, 42, 0, 79
400589371, 2015-01-22, Campbell, (7-13; 1-6 Big South), 33, 37, 0, 70, Presbyterian, (7-13; 3-4 Big South), 38, 34, 0, 72
400589372, 2015-01-22, Coast Carolina, (14-5; 5-2 Big South), 26, 39, 0, 65, UNC Asheville, (9-9; 5-2 Big South), 40, 35, 0, 75
400589373, 2015-01-22, High Point, (14-5; 5-2 Big South), 36, 30, 0, 66, Radford, (13-7; 4-3 Big South), 35, 38, 0, 73
400589374, 2015-01-22, Winthrop, (9-9; 4-3 Big South), 29, 42, 0, 71, Liberty, (6-14; 0-7 Big South), 15, 41, 0, 56
400591177, 2015-01-22, G Washington, (15-4; 5-1 A 10), 41, 38, 0, 79, Fordham, (5-12; 0-6 A 10), 27, 32, 0, 59
400591178, 2015-01-22, St Bonaventure, (11-6; 4-2 A 10), 39, 51, 10, 100, Duquesne, (6-11; 1-5 A 10), 51, 39, 7, 97
400591460, 2015-01-22, UTSA, (9-8; 3-3 C-USA), 39, 43, 0, 82, Marshall, (4-15; 0-6 C-USA), 23, 45, 0, 68
400591720, 2015-01-22, LIU Brooklyn, (6-12; 2-5 NEC), 32, 37, 0, 69, Bryant, (9-8; 6-1 NEC), 25, 49, 0, 74
400591762, 2015-01-22, Fair Dickinson, (7-11; 2-5 NEC), 31, 40, 6, 77, Sacred Heart, (8-12; 2-5 NEC), 28, 43, 7, 78
400591797, 2015-01-22, Robert Morris, (9-10; 5-2 NEC), 29, 30, 4, 63, Mt St Mary's, (8-10; 4-3 NEC), 25, 34, 0, 59
400595477, 2015-01-22, OSU, (15-5; 4-3 Big Ten), 38, 31, 0, 69, Northwestern, (10-9; 1-5 Big Ten), 34, 33, 0, 67
400596045, 2015-01-22, St Francis (PA), (10-8; 4-3 NEC), 24, 34, 0, 58, Wagner, (6-12; 4-3 NEC), 26, 37, 0, 63
400596130, 2015-01-22, Albany, (11-7; 6-0 Am. East), 27, 35, 0, 62, Hartford, (11-8; 4-2 Am. East), 20, 33, 0, 53
400596392, 2015-01-22, Morehead State, (8-13; 3-3 OVC), 40, 38, 0, 78, Tenn Tech, (9-11; 1-6 OVC), 42, 32, 0, 74
400597346, 2015-01-22, Alabama, (12-6; 2-3 SEC), 30, 48, 13, 91, Arkansas, (14-4; 3-2 SEC), 34, 44, 15, 93
400597712, 2015-01-22, UVM, (10-9; 5-1 Am. East), 32, 36, 0, 68, UNH, (11-9; 4-3 Am. East), 36, 37, 0, 73
400597801, 2015-01-22, Milwaukee, (7-13; 2-4 Horizon), 29, 24, 0, 53, Oakland, (8-12; 3-2 Horizon), 28, 38, 0, 66
400597892, 2015-01-22, Towson, (9-11; 2-5 CAA), 22, 31, 0, 53, Elon, (10-10; 2-5 CAA), 17, 34, 0, 51
400597917, 2015-01-22, JMU, (11-9; 4-3 CAA), 32, 27, 0, 59, Northeastern, (14-6; 6-1 CAA), 49, 33, 0, 82
400599767, 2015-01-22, La Salle, (10-9; 2-4 A 10), 17, 30, 0, 47, URI, (12-5; 4-2 A 10), 28, 31, 0, 59
400588738, 2015-01-22, Jacksonville, (7-14; 1-3 A-Sun), 35, 23, 19, 77, Lipscomb, (10-9; 4-0 A-Sun), 21, 37, 22, 80
400595281, 2015-01-22, South Alabama, (6-13; 4-5 Sun Belt), 28, 25, 0, 53, Appalachian St, (7-10; 4-4 Sun Belt), 30, 34, 0, 64
400587934, 2015-01-22, Georgia Tech, (9-9; 0-6 ACC), 16, 12, 0, 28, UVA, (18-0; 6-0 ACC), 28, 29, 0, 57
400586248, 2015-01-22, Canisius, (11-7; 6-3 MAAC), 30, 34, 0, 64, Fairfield, (6-13; 4-5 MAAC), 23, 27, 0, 50
400586977, 2015-01-22, North Dakota St, (13-6; 5-1 Summit), 25, 28, 16, 69, IUPUI, (7-13; 3-3 Summit), 23, 30, 8, 61
400586978, 2015-01-22, South Dakota, (10-10; 4-2 Summit), 25, 43, 0, 68, W Illinois, (7-11; 2-5 Summit), 33, 25, 0, 58
400587935, 2015-01-22, NC State, (13-7; 4-3 ACC), 33, 27, 0, 60, Miami (FL), (13-5; 3-2 ACC), 26, 39, 0, 65
400589182, 2015-01-22, UNC Greensboro, (6-14; 2-5 Southern), 35, 43, 0, 78, Samford, (8-14; 1-8 Southern), 43, 46, 0, 89
400590799, 2015-01-22, Utah Valley, (7-10; 2-1 WAC), 39, 33, 0, 72, UT Pan American, (7-13; 1-3 WAC), 20, 34, 0, 54
400591459, 2015-01-22, Charlotte, (8-10; 2-4 C-USA), 33, 32, 11, 76, UAB, (9-10; 5-1 C-USA), 29, 36, 16, 81
400591461, 2015-01-22, Old Dominion, (15-3; 4-2 C-USA), 30, 24, 4, 58, Mid Tennessee, (11-8; 4-2 C-USA), 33, 21, 14, 68
400591462, 2015-01-22, LA Tech, (14-5; 5-1 C-USA), 28, 38, 0, 66, North Texas, (8-10; 2-4 C-USA), 49, 24, 0, 73
400591463, 2015-01-22, Southern Miss, (5-12; 0-6 C-USA), 30, 26, 0, 56, Rice, (6-11; 3-3 C-USA), 31, 27, 0, 58
400596388, 2015-01-22, Austin Peay, (6-13; 1-4 OVC), 37, 28, 0, 65, SIU-ED, (8-10; 4-3 OVC), 40, 29, 0, 69
400596389, 2015-01-22, E Kentucky, (11-7; 3-2 OVC), 33, 34, 0, 67, Jacksonville St, (9-12; 2-5 OVC), 32, 39, 0, 71
400596390, 2015-01-22, UT Martin, (11-7; 3-2 OVC), 32, 35, 0, 67, Belmont, (12-7; 4-2 OVC), 23, 49, 0, 72
400596506, 2015-01-22, UMBC, (3-16; 1-5 Am. East), 28, 48, 0, 76, Maine, (1-18; 0-6 Am. East), 23, 36, 0, 59
400590797, 2015-01-22, Seattle, (10-8; 3-1 WAC), 44, 31, 0, 75, Chicago State, (4-16; 0-3 WAC), 36, 31, 0, 67
400590798, 2015-01-22, CSU Bakersfield, (5-14; 1-3 WAC), 32, 31, 0, 63, UMKC, (7-13; 2-1 WAC), 26, 40, 0, 66
400595284, 2015-01-22, Arkansas State, (8-10; 3-6 Sun Belt), 28, 31, 0, 59, LA-Lafayette, (11-8; 5-3 Sun Belt), 51, 45, 0, 96
400595285, 2015-01-22, UT-Arlington, (11-7; 5-3 Sun Belt), 34, 27, 0, 61, UL Monroe, (12-7; 6-2 Sun Belt), 24, 33, 0, 57
400595282, 2015-01-22, Ga Southern, (12-4; 5-2 Sun Belt), 22, 23, 0, 45, Texas State, (10-8; 4-5 Sun Belt), 19, 24, 0, 43
400595283, 2015-01-22, Troy, (7-10; 2-6 Sun Belt), 34, 31, 0, 65, AR-Little Rock, (7-11; 2-6 Sun Belt), 25, 48, 0, 73
400593272, 2015-01-22, Arizona, (17-2; 5-1 Pac-12), 39, 50, 0, 89, Stanford, (13-5; 4-2 Pac-12), 41, 41, 0, 82
400595478, 2015-01-22, Maryland, (17-3; 5-2 Big Ten), 35, 35, 0, 70, Indiana, (15-4; 5-1 Big Ten), 38, 51, 0, 89
400586031, 2015-01-22, Portland State, (10-7; 4-3 Big Sky), 31, 38, 0, 69, Weber State, (8-10; 3-4 Big Sky), 24, 39, 0, 63
400586034, 2015-01-22, N Arizona, (8-11; 3-3 Big Sky), 31, 26, 0, 57, Montana, (9-8; 5-1 Big Sky), 24, 40, 0, 64
400590796, 2015-01-22, Grand Canyon, (11-9; 2-1 WAC), 27, 36, 0, 63, New Mexico St, (11-10; 3-1 WAC), 41, 44, 0, 85
400591464, 2015-01-22, UTEP, (12-6; 4-2 C-USA), 35, 24, 7, 66, W Kentucky, (13-5; 6-0 C-USA), 28, 31, 12, 71
400593273, 2015-01-22, UCLA, (11-8; 3-3 Pac-12), 19, 36, 0, 55, Oregon State, (13-5; 4-2 Pac-12), 29, 37, 0, 66
400596391, 2015-01-22, Murray State, (16-4; 6-0 OVC), 39, 38, 0, 77, E Illinois, (12-7; 6-1 OVC), 26, 36, 0, 62
400586032, 2015-01-22, Southern Utah, (5-12; 2-4 Big Sky), 41, 24, 0, 65, Montana State, (4-14; 1-5 Big Sky), 35, 44, 0, 79
400586033, 2015-01-22, Sacramento St, (12-6; 6-1 Big Sky), 30, 32, 0, 62, Idaho State, (4-15; 1-6 Big Sky), 26, 33, 0, 59
400586035, 2015-01-22, N Colorado, (9-8; 4-2 Big Sky), 27, 58, 0, 85, E Washington, (14-5; 5-1 Big Sky), 50, 45, 0, 95
400593274, 2015-01-22, Washington, (14-4; 3-3 Pac-12), 19, 33, 0, 52, Colorado, (9-9; 2-4 Pac-12), 24, 26, 0, 50
400586030, 2015-01-22, North Dakota, (6-11; 2-4 Big Sky), 25, 46, 0, 71, Idaho, (7-10; 2-4 Big Sky), 32, 31, 0, 63
400587313, 2015-01-22, Pacific, (10-10; 2-6 WCC), 26, 43, 0, 69, Portland, (12-8; 3-5 WCC), 31, 41, 0, 72
400587314, 2015-01-22, Pepperdine, (12-7; 5-3 WCC), 28, 31, 0, 59, San Francisco, (9-11; 3-5 WCC), 31, 40, 0, 71
400595959, 2015-01-22, CS Fullerton, (8-11; 0-4 Big West), 22, 33, 0, 55, Cal Poly, (9-8; 2-3 Big West), 26, 40, 0, 66
400595960, 2015-01-22, UC Irvine, (10-8; 3-1 Big West), 39, 41, 0, 80, CS Northridge, (6-14; 2-3 Big West), 18, 31, 0, 49
400595961, 2015-01-22, UC Riverside, (9-10; 2-3 Big West), 40, 35, 0, 75, UCSB, (9-9; 2-2 Big West), 40, 43, 0, 83
400587311, 2015-01-22, Saint Mary's, (15-4; 7-1 WCC), 21, 26, 0, 47, Gonzaga, (19-1; 8-0 WCC), 27, 41, 0, 68
400587312, 2015-01-22, Loyola Mary, (5-15; 1-7 WCC), 33, 29, 0, 62, Santa Clara, (10-10; 4-4 WCC), 38, 27, 0, 65
400593275, 2015-01-22, USC, (9-9; 1-5 Pac-12), 31, 36, 0, 67, Oregon, (13-6; 3-3 Pac-12), 44, 31, 0, 75
400593276, 2015-01-22, Arizona State, (10-9; 2-4 Pac-12), 34, 45, 0, 79, Cal, (11-8; 1-5 Pac-12), 13, 31, 0, 44
400595962, 2015-01-22, UC Davis, (14-4; 4-1 Big West), 37, 39, 0, 76, Hawaii, (14-6; 2-2 Big West), 48, 36, 0, 84
400599947, 2015-01-23, VCU, (16-3; 6-0 A 10), 34, 29, 0, 63, Saint Louis, (9-10; 1-5 A 10), 34, 27, 0, 61
400586218, 2015-01-23, Niagara, (3-15; 2-7 MAAC), 20, 38, 0, 58, Monmouth, (11-9; 7-2 MAAC), 40, 29, 0, 69
400586250, 2015-01-23, Manhattan, (8-10; 5-4 MAAC), 22, 37, 0, 59, Quinnipiac, (11-8; 5-5 MAAC), 32, 41, 0, 73
400586252, 2015-01-23, Marist, (1-18; 0-9 MAAC), 28, 32, 0, 60, Siena, (8-10; 5-4 MAAC), 28, 41, 0, 69
400597738, 2015-01-23, Detroit, (10-11; 3-3 Horizon), 28, 38, 0, 66, Cleveland State, (12-9; 6-1 Horizon), 30, 40, 0, 70
400597775, 2015-01-23, Valparaiso, (18-4; 5-2 Horizon), 34, 16, 0, 50, Green Bay, (17-4; 6-1 Horizon), 32, 19, 0, 51
400597347, 2015-01-24, Kentucky, (19-0; 6-0 SEC), 34, 24, 0, 58, South Carolina, (10-8; 1-5 SEC), 24, 19, 0, 43
400595480, 2015-01-24, Iowa, (13-7; 4-3 Big Ten), 24, 39, 0, 63, Purdue, (12-8; 4-3 Big Ten), 34, 33, 0, 67
400585807, 2015-01-24, Oklahoma State, (13-6; 3-4 Big 12), 21, 32, 0, 53, Kansas State, (12-8; 5-2 Big 12), 31, 32, 0, 63
400586795, 2015-01-24, Tulsa, (14-5; 7-0 American), 29, 37, 0, 66, ECU, (8-11; 1-5 American), 35, 29, 0, 64
400587936, 2015-01-24, Wake Forest, (9-11; 1-6 ACC), 33, 24, 0, 57, Clemson, (11-8; 3-4 ACC), 27, 32, 0, 59
400588428, 2015-01-24, DePaul, (11-10; 5-3 Big East), 50, 26, 0, 76, Xavier, (13-7; 4-4 Big East), 42, 47, 0, 89
400596131, 2015-01-24, Rutgers, (10-11; 2-6 Big Ten), 28, 23, 0, 51, Penn State, (13-7; 1-6 Big Ten), 41, 38, 0, 79
400597842, 2015-01-24, Charleston, (6-15; 1-7 CAA), 28, 23, 0, 51, Drexel, (5-14; 3-5 CAA), 22, 31, 0, 53
400587158, 2015-01-24, Navy, (7-13; 3-5 Patriot), 31, 34, 0, 65, Holy Cross, (8-10; 3-5 Patriot), 38, 38, 0, 76
400586980, 2015-01-24, South Dakota, (10-11; 4-3 Summit), 15, 35, 0, 50, IUPUI, (8-13; 4-3 Summit), 36, 29, 0, 65
400587155, 2015-01-24, Bucknell, (11-10; 6-2 Patriot), 42, 50, 0, 92, Boston U, (8-11; 4-4 Patriot), 40, 37, 0, 77
400588744, 2015-01-24, Jacksonville, (7-15; 1-4 A-Sun), 32, 27, 0, 59, N Kentucky, (9-11; 3-2 A-Sun), 43, 38, 0, 81
400589187, 2015-01-24, The Citadel, (8-12; 3-6 Southern), 31, 44, 0, 75, VMI, (8-13; 4-6 Southern), 35, 50, 0, 85
400589189, 2015-01-24, Non D-I School, NA, 22, 24, 0, 46, Furman, (6-13; 3-5 Southern), 45, 37, 0, 82
400597348, 2015-01-24, Texas A&M, (13-5; 4-2 SEC), 25, 42, 0, 67, Tennessee, (12-6; 4-2 SEC), 23, 38, 0, 61
400586427, 2015-01-24, Loyola (CHI), (13-7; 3-5 MVC), 25, 36, 0, 61, Indiana State, (10-10; 6-2 MVC), 38, 34, 0, 72
400587937, 2015-01-24, FSU, (10-10; 2-5 ACC), 31, 43, 0, 74, UNC, (16-4; 6-1 ACC), 35, 43, 0, 78
400585809, 2015-01-24, TCU, (14-5; 1-5 Big 12), 35, 37, 13, 85, West Virginia, (16-3; 4-2 Big 12), 36, 36, 14, 86
400586981, 2015-01-24, Denver, (9-11; 3-4 Summit), 32, 37, 0, 69, Omaha, (8-11; 2-5 Summit), 35, 45, 0, 80
400587156, 2015-01-24, Lehigh, (10-9; 4-4 Patriot), 35, 40, 0, 75, Lafayette, (11-8; 3-5 Patriot), 30, 41, 0, 71
400587157, 2015-01-24, Loyola (MD), (7-12; 3-5 Patriot), 26, 32, 0, 58, Colgate, (9-12; 6-2 Patriot), 33, 26, 0, 59
400587520, 2015-01-24, Akron, (13-6; 4-2 MAC), 37, 34, 0, 71, W Michigan, (13-6; 4-2 MAC), 35, 34, 0, 69
400587521, 2015-01-24, Kent State, (14-5; 5-1 MAC), 32, 31, 0, 63, Ball State, (7-10; 2-4 MAC), 23, 29, 0, 52
400587522, 2015-01-24, Buffalo, (12-6; 3-3 MAC), 31, 30, 0, 61, Ohio, (7-10; 2-4 MAC), 32, 31, 0, 63
400588743, 2015-01-24, Stetson, (5-15; 0-5 A-Sun), 37, 30, 0, 67, USC Upstate, (14-7; 2-3 A-Sun), 46, 45, 0, 91
400588745, 2015-01-24, FGCU, (14-7; 4-1 A-Sun), 20, 34, 0, 54, Kennesaw St, (6-15; 1-4 A-Sun), 19, 29, 0, 48
400591180, 2015-01-24, Duquesne, (6-12; 1-6 A 10), 18, 41, 0, 59, G Washington, (16-4; 6-1 A 10), 40, 34, 0, 74
400591225, 2015-01-24, Brown, (9-10; 0-2 Ivy), 31, 34, 0, 65, Yale, (13-6; 2-0 Ivy), 25, 44, 0, 69
400591283, 2015-01-24, Dartmouth, (8-8; 1-1 Ivy), 25, 45, 0, 70, Harvard, (11-5; 1-1 Ivy), 28, 33, 0, 61
400591647, 2015-01-24, Boise State, (14-6; 4-3 MW), 30, 47, 0, 77, Air Force, (8-11; 1-7 MW), 31, 37, 0, 68
400597349, 2015-01-24, Arkansas, (15-4; 4-2 SEC), 30, 31, 0, 61, Missouri, (7-12; 1-5 SEC), 34, 26, 0, 60
400597933, 2015-01-24, Northeastern, (14-7; 6-2 CAA), 27, 35, 0, 62, William & Mary, (12-7; 6-2 CAA), 38, 40, 0, 78
400585808, 2015-01-24, Kansas, (16-3; 5-1 Big 12), 32, 43, 0, 75, Texas, (14-5; 3-3 Big 12), 30, 32, 0, 62
400595481, 2015-01-24, Illinois, (13-8; 3-5 Big Ten), 30, 41, 0, 71, Minnesota, (13-8; 2-6 Big Ten), 33, 46, 0, 79
400588429, 2015-01-24, Georgetown, (14-5; 6-2 Big East), 45, 36, 14, 95, Marquette, (10-9; 2-5 Big East), 39, 42, 4, 85
400591798, 2015-01-24, St Francis (PA), (10-9; 4-4 NEC), 22, 18, 0, 40, Mt St Mary's, (9-10; 5-3 NEC), 23, 29, 0, 52
400595286, 2015-01-24, LA-Lafayette, (11-9; 5-4 Sun Belt), 18, 46, 0, 64, Georgia State, (13-7; 6-3 Sun Belt), 32, 43, 0, 75
400590801, 2015-01-24, CSU Bakersfield, (6-14; 2-3 WAC), 24, 33, 0, 57, Chicago State, (4-17; 0-4 WAC), 17, 24, 0, 41
400591468, 2015-01-24, UTEP, (12-7; 4-3 C-USA), 39, 32, 0, 71, Marshall, (5-15; 1-6 C-USA), 42, 36, 0, 78
400591471, 2015-01-24, UTSA, (9-9; 3-4 C-USA), 34, 40, 0, 74, W Kentucky, (14-5; 7-0 C-USA), 45, 38, 0, 83
400597350, 2015-01-24, Georgia, (13-5; 4-2 SEC), 36, 36, 0, 72, Miss St, (9-10; 2-4 SEC), 31, 35, 0, 66
400585810, 2015-01-24, Iowa State, (14-4; 4-2 Big 12), 25, 48, 0, 73, Texas Tech, (11-9; 1-6 Big 12), 36, 42, 0, 78
400586426, 2015-01-24, S Illinois, (9-12; 2-6 MVC), 24, 42, 0, 66, Evansville, (15-5; 5-3 MVC), 39, 36, 0, 75
400587315, 2015-01-24, BYU, (15-7; 5-4 WCC), 38, 36, 0, 74, San Diego, (10-11; 3-6 WCC), 33, 44, 0, 77
400587518, 2015-01-24, Miami (OH), (7-12; 2-4 MAC), 29, 31, 0, 60, N Illinois, (8-9; 2-4 MAC), 27, 28, 0, 55
400587938, 2015-01-24, Miami (FL), (14-5; 4-2 ACC), 26, 40, 0, 66, Syracuse, (14-6; 5-2 ACC), 26, 36, 0, 62
400589375, 2015-01-24, Campbell, (7-14; 1-7 Big South), 33, 30, 0, 63, Winthrop, (10-9; 5-3 Big South), 30, 41, 0, 71
400589376, 2015-01-24, Presbyterian, (7-14; 3-5 Big South), 20, 32, 0, 52, Coast Carolina, (15-5; 6-2 Big South), 26, 37, 0, 63
400591651, 2015-01-24, New Mexico, (13-7; 5-3 MW), 20, 34, 8, 62, Wyoming, (17-3; 6-1 MW), 21, 33, 9, 63
400591721, 2015-01-24, Sacred Heart, (9-12; 3-5 NEC), 41, 42, 0, 83, Bryant, (9-9; 6-2 NEC), 28, 38, 0, 66
400591817, 2015-01-24, Robert Morris, (10-10; 6-2 NEC), 35, 32, 0, 67, St Francis (BKN), (12-9; 6-2 NEC), 31, 34, 0, 65
400593277, 2015-01-24, UCLA, (11-9; 3-4 Pac-12), 31, 33, 0, 64, Oregon, (14-6; 4-3 Pac-12), 46, 36, 0, 82
400595483, 2015-01-24, Michigan State, (13-7; 4-3 Big Ten), 25, 52, 0, 77, Nebraska, (12-7; 4-3 Big Ten), 39, 40, 0, 79
400597905, 2015-01-24, JMU, (12-9; 5-3 CAA), 33, 36, 0, 69, Hofstra, (14-7; 5-3 CAA), 45, 18, 0, 63
400598614, 2015-01-24, MD-E Shore, (11-10; 4-2 MEAC), 41, 33, 0, 74, Bethune-Cookman, (6-14; 2-4 MEAC), 31, 39, 0, 70
400596393, 2015-01-24, Austin Peay, (7-13; 2-4 OVC), 20, 36, 0, 56, E Illinois, (12-8; 6-2 OVC), 29, 23, 0, 52
400587519, 2015-01-24, E Michigan, (12-7; 1-5 MAC), 23, 28, 0, 51, Cent Michigan, (14-3; 4-2 MAC), 36, 29, 0, 65
400589377, 2015-01-24, Liberty, (6-15; 0-8 Big South), 36, 40, 0, 76, Radford, (14-7; 5-3 Big South), 44, 40, 0, 84
400591763, 2015-01-24, LIU Brooklyn, (7-12; 3-5 NEC), 37, 43, 0, 80, Fair Dickinson, (7-12; 2-6 NEC), 35, 41, 0, 76
400595660, 2015-01-24, McNeese State, (7-10; 1-5 Southland), 35, 32, 0, 67, Northwestern St, (9-9; 4-3 Southland), 49, 44, 0, 93
400598612, 2015-01-24, Coppin State, (2-17; 1-5 MEAC), 41, 36, 0, 77, NC Central, (15-5; 7-0 MEAC), 38, 41, 0, 79
400586038, 2015-01-24, N Arizona, (9-11; 4-3 Big Sky), 28, 43, 0, 71, Montana State, (4-15; 1-6 Big Sky), 26, 38, 0, 64
400588742, 2015-01-24, North Florida, (13-9; 5-0 A-Sun), 19, 56, 0, 75, Lipscomb, (10-10; 4-1 A-Sun), 29, 37, 0, 66
400586036, 2015-01-24, North Dakota, (6-12; 2-5 Big Sky), 41, 39, 0, 80, E Washington, (15-5; 6-1 Big Sky), 35, 67, 0, 102
400595288, 2015-01-24, Arkansas State, (9-10; 4-6 Sun Belt), 25, 39, 0, 64, Troy, (7-11; 2-7 Sun Belt), 30, 25, 0, 55
400589378, 2015-01-24, Gardner-Webb, (13-8; 5-3 Big South), 44, 36, 0, 80, Charleston So, (12-7; 6-2 Big South), 58, 35, 0, 93
400591470, 2015-01-24, Old Dominion, (15-4; 4-3 C-USA), 32, 36, 0, 68, UAB, (10-10; 6-1 C-USA), 40, 41, 0, 81
400595287, 2015-01-24, Appalachian St, (8-10; 5-4 Sun Belt), 28, 36, 0, 64, Texas State, (10-9; 4-6 Sun Belt), 26, 32, 0, 58
400595661, 2015-01-24, Incarnate Word, (10-5; 2-3 Southland), 42, 35, 0, 77, Abil Christian, (9-10; 3-3 Southland), 34, 27, 0, 61
400595663, 2015-01-24, SF Austin, (16-3; 6-0 Southland), 39, 40, 0, 79, Sam Houston, (14-5; 6-1 Southland), 29, 39, 0, 68
400596394, 2015-01-24, Morehead State, (9-13; 4-3 OVC), 38, 28, 0, 66, Jacksonville St, (9-13; 2-6 OVC), 30, 33, 0, 63
400595290, 2015-01-24, Ga Southern, (13-4; 6-2 Sun Belt), 29, 28, 0, 57, UL Monroe, (12-8; 6-3 Sun Belt), 27, 26, 0, 53
400595662, 2015-01-24, Nicholls State, (5-11; 2-4 Southland), 32, 39, 0, 71, Cent Arkansas, (0-17; 0-6 Southland), 32, 29, 0, 61
400585811, 2015-01-24, Oklahoma, (12-7; 3-4 Big 12), 24, 34, 0, 58, Baylor, (15-4; 3-3 Big 12), 30, 39, 0, 69
400586797, 2015-01-24, Houston, (7-12; 0-8 American), 29, 30, 0, 59, SMU, (16-4; 7-1 American), 37, 43, 0, 80
400589185, 2015-01-24, UNC Greensboro, (6-15; 2-6 Southern), 37, 35, 0, 72, Chattanooga, (14-7; 7-1 Southern), 44, 37, 0, 81
400591465, 2015-01-24, Charlotte, (8-11; 2-5 C-USA), 37, 32, 0, 69, Mid Tennessee, (12-8; 5-2 C-USA), 27, 45, 0, 72
400593278, 2015-01-24, USC, (9-10; 1-6 Pac-12), 27, 28, 0, 55, Oregon State, (14-5; 5-2 Pac-12), 29, 30, 0, 59
400597351, 2015-01-24, LSU, (15-4; 4-2 SEC), 30, 39, 10, 79, Vanderbilt, (11-8; 1-5 SEC), 35, 34, 6, 75
400597352, 2015-01-24, Florida, (10-9; 3-3 SEC), 36, 35, 0, 71, Ole Miss, (12-7; 3-3 SEC), 30, 42, 0, 72
400598617, 2015-01-24, Howard, (9-10; 3-2 MEAC), 34, 25, 0, 59, Florida A&M, (0-19; 0-6 MEAC), 22, 28, 0, 50
400598820, 2015-01-24, PV A&M, (5-14; 3-3 SWAC), 38, 34, 0, 72, Miss Valley St, (2-17; 1-5 SWAC), 31, 34, 0, 65
400598616, 2015-01-24, Norfolk State, (13-9; 6-1 MEAC), 35, 41, 0, 76, S Carolina St, (6-15; 4-3 MEAC), 32, 31, 0, 63
400598615, 2015-01-24, Hampton, (8-11; 4-3 MEAC), 31, 35, 0, 66, Savannah State, (5-14; 1-4 MEAC), 28, 40, 0, 68
400591049, 2015-01-24, Jackson State, (5-15; 3-4 SWAC), 36, 38, 0, 74, Grambling St, (2-15; 0-7 SWAC), 22, 41, 0, 63
400591073, 2015-01-24, Alcorn State, (4-15; 3-4 SWAC), 26, 34, 0, 60, Alabama State, (10-5; 6-0 SWAC), 43, 41, 0, 84
400595289, 2015-01-24, UT-Arlington, (12-7; 6-3 Sun Belt), 28, 47, 0, 75, AR-Little Rock, (7-12; 2-7 Sun Belt), 39, 29, 0, 68
400598621, 2015-01-24, Delaware State, (10-9; 4-1 MEAC), 26, 41, 0, 67, NC A&T, (5-16; 2-5 MEAC), 23, 29, 0, 52
400595482, 2015-01-24, Wisconsin, (18-2; 6-1 Big Ten), 30, 27, 12, 69, Michigan, (12-8; 5-3 Big Ten), 23, 34, 7, 64
400591182, 2015-01-24, Richmond, (10-9; 3-3 A 10), 27, 33, 0, 60, Dayton, (16-3; 6-1 A 10), 37, 26, 0, 63
400586253, 2015-01-24, Canisius, (11-8; 6-4 MAAC), 16, 30, 0, 46, Rider, (13-8; 7-3 MAAC), 22, 37, 0, 59
400586979, 2015-01-24, North Dakota St, (13-7; 5-2 Summit), 29, 42, 0, 71, IPFW, (9-11; 2-5 Summit), 35, 42, 0, 77
400587517, 2015-01-24, Bowling Green, (12-5; 4-2 MAC), 34, 33, 0, 67, Toledo, (11-8; 3-3 MAC), 32, 39, 0, 71
400589186, 2015-01-24, W Carolina, (9-12; 4-5 Southern), 30, 42, 0, 72, Samford, (9-14; 2-8 Southern), 35, 43, 0, 78
400589188, 2015-01-24, East Tenn St, (12-7; 6-4 Southern), 23, 41, 0, 64, Wofford, (16-5; 7-1 Southern), 30, 42, 0, 72
400589379, 2015-01-24, UNC Asheville, (9-10; 5-3 Big South), 24, 27, 0, 51, High Point, (15-5; 6-2 Big South), 36, 36, 0, 72
400590802, 2015-01-24, Seattle, (10-9; 3-2 WAC), 25, 30, 0, 55, UMKC, (8-13; 3-1 WAC), 24, 51, 0, 75
400591179, 2015-01-24, Davidson, (14-4; 5-2 A 10), 38, 27, 15, 80, George Mason, (6-12; 1-5 A 10), 31, 34, 8, 73
400591181, 2015-01-24, Penn, (5-10; 0-1 Ivy), 20, 36, 0, 56, Saint Joe's, (8-10; 2-4 A 10), 17, 35, 0, 52
400591247, 2015-01-24, Cornell, (9-9; 1-1 Ivy), 27, 30, 0, 57, Columbia, (9-7; 1-1 Ivy), 25, 22, 0, 47
400591648, 2015-01-24, Nevada, (6-12; 2-4 MW), 29, 33, 0, 62, Fresno State, (10-10; 5-2 MW), 29, 37, 0, 66
400591744, 2015-01-24, Wagner, (6-13; 4-4 NEC), 34, 16, 0, 50, Cent Conn St, (3-18; 1-7 NEC), 30, 23, 0, 53
400595963, 2015-01-24, CS Fullerton, (8-12; 0-5 Big West), 36, 13, 0, 49, UCSB, (10-9; 3-2 Big West), 31, 37, 0, 68
400596395, 2015-01-24, SE Missouri St, (9-11; 3-4 OVC), 32, 21, 0, 53, UT Martin, (12-7; 4-2 OVC), 40, 30, 0, 70
400597787, 2015-01-24, UIC, (5-16; 1-5 Horizon), 28, 36, 0, 64, Youngstown St, (10-13; 1-7 Horizon), 26, 51, 0, 77
400597860, 2015-01-24, Delaware, (4-15; 3-5 CAA), 39, 43, 0, 82, Elon, (11-10; 3-5 CAA), 41, 53, 0, 94
400591024, 2015-01-24, Southern, (9-12; 6-1 SWAC), 41, 24, 0, 65, Alabama A&M, (4-12; 3-3 SWAC), 32, 26, 0, 58
400595664, 2015-01-24, Texas A&M-CC, (10-8; 5-1 Southland), 35, 25, 11, 71, New Orleans, (5-10; 1-5 Southland), 29, 31, 7, 67
400587317, 2015-01-24, Pacific, (10-11; 2-7 WCC), 27, 33, 0, 60, Gonzaga, (20-1; 9-0 WCC), 45, 46, 0, 91
400586428, 2015-01-24, Missouri State, (8-12; 2-6 MVC), 25, 34, 0, 59, Bradley, (7-14; 2-6 MVC), 35, 26, 0, 61
400586796, 2015-01-24, Memphis, (12-7; 5-3 American), 32, 25, 0, 57, Tulane, (13-7; 4-4 American), 25, 30, 0, 55
400586982, 2015-01-24, South Dakota St, (15-7; 6-2 Summit), 34, 42, 0, 76, Oral Roberts, (10-10; 4-3 Summit), 36, 36, 0, 72
400590803, 2015-01-24, Grand Canyon, (11-10; 2-2 WAC), 29, 43, 0, 72, UT Pan American, (8-13; 2-3 WAC), 35, 38, 0, 73
400591467, 2015-01-24, LA Tech, (15-5; 6-1 C-USA), 28, 30, 0, 58, Rice, (6-12; 3-4 C-USA), 24, 21, 0, 45
400591469, 2015-01-24, Southern Miss, (6-12; 1-6 C-USA), 29, 33, 13, 75, North Texas, (8-11; 2-5 C-USA), 37, 25, 9, 71
400591649, 2015-01-24, Utah State, (11-8; 4-3 MW), 29, 39, 9, 77, UNLV, (11-9; 2-5 MW), 37, 31, 11, 79
400593279, 2015-01-24, Washington St, (9-10; 3-4 Pac-12), 31, 27, 0, 58, Colorado, (10-9; 3-4 Pac-12), 47, 43, 0, 90
400595665, 2015-01-24, Lamar, (10-9; 4-3 Southland), 35, 42, 0, 77, Houston Baptist, (9-8; 4-3 Southland), 48, 31, 0, 79
400596396, 2015-01-24, Murray State, (17-4; 7-0 OVC), 31, 29, 0, 60, SIU-ED, (8-11; 4-4 OVC), 31, 23, 0, 54
400597925, 2015-01-24, Towson, (9-12; 2-6 CAA), 22, 43, 0, 65, UNC-Wilmington, (11-8; 6-2 CAA), 31, 38, 0, 69
400597353, 2015-01-24, Auburn, (10-9; 2-4 SEC), 23, 32, 0, 55, Alabama, (13-6; 3-3 SEC), 25, 32, 0, 57
400601535, 2015-01-24, Texas Southern, (8-11; 5-1 SWAC), 30, 32, 0, 62, AR-Pine Bluff, (5-15; 2-4 SWAC), 30, 36, 0, 66
400586037, 2015-01-24, Sacramento St, (13-6; 7-1 Big Sky), 37, 41, 0, 78, Weber State, (8-11; 3-5 Big Sky), 37, 34, 0, 71
400586041, 2015-01-24, Southern Utah, (5-13; 2-5 Big Sky), 23, 33, 0, 56, Montana, (10-8; 6-1 Big Sky), 19, 39, 0, 58
400590800, 2015-01-24, Utah Valley, (7-11; 2-2 WAC), 22, 22, 0, 44, New Mexico St, (12-10; 4-1 WAC), 33, 36, 0, 69
400586040, 2015-01-24, Portland State, (10-8; 4-4 Big Sky), 41, 35, 0, 76, Idaho State, (5-15; 2-6 Big Sky), 45, 35, 0, 80
400596398, 2015-01-24, E Kentucky, (11-8; 3-3 OVC), 41, 31, 9, 81, Tenn Tech, (10-11; 2-6 OVC), 30, 42, 11, 83
400586039, 2015-01-24, N Colorado, (9-9; 4-3 Big Sky), 32, 47, 0, 79, Idaho, (8-10; 3-4 Big Sky), 47, 36, 0, 83
400587316, 2015-01-24, Loyola Mary, (6-15; 2-7 WCC), 30, 40, 0, 70, San Francisco, (9-12; 3-6 WCC), 43, 26, 0, 69
400587319, 2015-01-24, Saint Mary's, (16-4; 8-1 WCC), 30, 44, 0, 74, Portland, (12-9; 3-6 WCC), 31, 33, 0, 64
400591650, 2015-01-24, San Diego State, (15-5; 5-2 MW), 32, 41, 0, 73, Colorado State, (18-2; 5-2 MW), 40, 39, 0, 79
400595964, 2015-01-24, LBSU, (10-11; 4-1 Big West), 28, 36, 0, 64, CS Northridge, (6-15; 2-4 Big West), 18, 40, 0, 58
400595965, 2015-01-24, UC Riverside, (9-11; 2-4 Big West), 24, 25, 0, 49, Cal Poly, (10-8; 3-3 Big West), 24, 44, 0, 68
400593280, 2015-01-24, Arizona, (18-2; 6-1 Pac-12), 29, 44, 0, 73, Cal, (11-9; 1-6 Pac-12), 19, 31, 0, 50
400587318, 2015-01-24, Pepperdine, (12-8; 5-4 WCC), 24, 33, 0, 57, Santa Clara, (11-10; 5-4 WCC), 35, 25, 0, 60
400595966, 2015-01-24, UC Irvine, (11-8; 4-1 Big West), 42, 36, 0, 78, Hawaii, (14-7; 2-3 Big West), 34, 38, 0, 72
400593281, 2015-01-24, Arizona State, (10-10; 2-5 Pac-12), 41, 29, 0, 70, Stanford, (14-5; 5-2 Pac-12), 51, 38, 0, 89
400586798, 2015-01-25, USF, (7-13; 1-6 American), 20, 33, 0, 53, UConn, (11-7; 4-2 American), 30, 36, 0, 66
400587941, 2015-01-25, UVA, (19-0; 7-0 ACC), 30, 20, 0, 50, VT, (8-11; 0-6 ACC), 27, 20, 0, 47
400587939, 2015-01-25, Boston College, (9-9; 1-5 ACC), 26, 38, 0, 64, Georgia Tech, (9-10; 0-7 ACC), 24, 38, 0, 62
400595484, 2015-01-25, Indiana, (15-5; 5-2 Big Ten), 32, 38, 0, 70, OSU, (16-5; 5-3 Big Ten), 38, 44, 0, 82
400587943, 2015-01-25, Duke, (17-2; 4-2 ACC), 39, 38, 0, 77, St John's, (13-6; 2-4 Big East), 43, 25, 0, 68
400586430, 2015-01-25, Drake, (4-16; 1-7 MVC), 19, 21, 0, 40, Wichita State, (18-2; 8-0 MVC), 36, 38, 0, 74
400586254, 2015-01-25, St Peter's, (10-11; 4-6 MAAC), 32, 37, 0, 69, Siena, (8-11; 5-5 MAAC), 25, 30, 0, 55
400586256, 2015-01-25, Fairfield, (6-14; 4-6 MAAC), 26, 41, 0, 67, Marist, (2-18; 1-9 MAAC), 25, 48, 0, 73
400586257, 2015-01-25, Monmouth, (11-10; 7-3 MAAC), 33, 31, 0, 64, Manhattan, (9-10; 6-4 MAAC), 40, 31, 0, 71
400586799, 2015-01-25, Cincinnati, (14-5; 5-2 American), 29, 27, 0, 56, UCF, (9-10; 2-6 American), 24, 22, 0, 46
400591318, 2015-01-25, Rowan,  , 20, 28, 0, 48, Princeton, (8-9; 1-0 Ivy), 46, 50, 0, 96
400596477, 2015-01-25, Stony Brook, (14-8; 5-2 Am. East), 32, 29, 0, 61, Binghamton, (2-20; 1-6 Am. East), 26, 28, 0, 54
400596493, 2015-01-25, Maine, (2-18; 1-6 Am. East), 29, 41, 0, 70, Hartford, (11-9; 4-3 Am. East), 26, 35, 0, 61
400596539, 2015-01-25, UVM, (11-9; 6-1 Am. East), 31, 30, 0, 61, UMass Lowell, (9-12; 3-5 Am. East), 25, 25, 0, 50
400599787, 2015-01-25, St Bonaventure, (11-7; 4-3 A 10), 20, 28, 0, 48, URI, (13-5; 5-2 A 10), 24, 29, 0, 53
400588430, 2015-01-25, Seton Hall, (13-6; 3-4 Big East), 28, 29, 0, 57, Butler, (15-6; 5-3 Big East), 32, 45, 0, 77
400595291, 2015-01-25, NJIT, (12-10; 6-9 away), 24, 48, 0, 72, South Alabama, (6-14; 4-5 Sun Belt), 31, 24, 0, 55
400587940, 2015-01-25, Louisville, (16-3; 4-2 ACC), 40, 40, 0, 80, Pitt, (13-7; 3-4 ACC), 30, 38, 0, 68
400586429, 2015-01-25, Northern Iowa, (18-2; 7-1 MVC), 24, 30, 0, 54, Illinois State, (12-8; 4-4 MVC), 24, 29, 0, 53
400596459, 2015-01-25, UMBC, (3-17; 1-6 Am. East), 22, 33, 0, 55, Albany, (12-7; 7-0 Am. East), 35, 34, 0, 69
400586255, 2015-01-25, Niagara, (3-16; 2-8 MAAC), 30, 34, 0, 64, Iona, (15-6; 8-2 MAAC), 45, 42, 0, 87
400587942, 2015-01-25, Notre Dame, (19-2; 7-1 ACC), 30, 41, 10, 81, NC State, (13-8; 4-4 ACC), 42, 29, 7, 78
400596397, 2015-01-25, Belmont, (13-7; 5-2 OVC), 28, 35, 0, 63, Tennessee St, (3-18; 0-6 OVC), 30, 25, 0, 55
400588431, 2015-01-25, Creighton, (9-12; 0-8 Big East), 14, 36, 0, 50, Villanova, (18-2; 5-2 Big East), 29, 42, 0, 71
400595485, 2015-01-25, Northwestern, (10-10; 1-6 Big Ten), 41, 26, 0, 67, Maryland, (18-3; 6-2 Big Ten), 30, 38, 0, 68
400593282, 2015-01-25, Washington, (14-5; 3-4 Pac-12), 30, 26, 0, 56, Utah, (16-3; 6-1 Pac-12), 37, 40, 0, 77
400587944, 2015-01-26, Syracuse, (14-7; 5-3 ACC), 40, 43, 0, 83, UNC, (17-4; 7-1 ACC), 35, 58, 0, 93
400587159, 2015-01-26, Army, (13-6; 4-4 Patriot), 35, 33, 0, 68, American U, (11-9; 4-4 Patriot), 29, 37, 0, 66
400589380, 2015-01-26, High Point, (16-5; 7-2 Big South), 31, 32, 0, 63, Presbyterian, (7-15; 3-6 Big South), 28, 26, 0, 54
400597739, 2015-01-26, Cleveland State, (12-10; 6-2 Horizon), 22, 34, 0, 56, Oakland, (9-12; 4-2 Horizon), 33, 26, 0, 59
400597758, 2015-01-26, Wright State, (11-10; 3-4 Horizon), 33, 31, 0, 64, Detroit, (10-12; 3-4 Horizon), 27, 26, 0, 53
400598613, 2015-01-26, Delaware State, (10-10; 4-2 MEAC), 29, 25, 0, 54, NC Central, (16-5; 8-0 MEAC), 27, 28, 0, 55
400595666, 2015-01-26, Nicholls State, (5-12; 2-5 Southland), 25, 26, 0, 51, Northwestern St, (10-9; 5-3 Southland), 41, 39, 0, 80
400598618, 2015-01-26, Howard, (10-10; 4-2 MEAC), 25, 20, 0, 45, Bethune-Cookman, (6-15; 2-5 MEAC), 27, 15, 0, 42
400598619, 2015-01-26, Hampton, (8-12; 4-4 MEAC), 25, 31, 0, 56, S Carolina St, (7-15; 5-3 MEAC), 31, 34, 0, 65
400598620, 2015-01-26, Coppin State, (3-17; 2-5 MEAC), 39, 45, 0, 84, NC A&T, (5-17; 2-6 MEAC), 39, 32, 0, 71
400595667, 2015-01-26, Sam Houston, (15-5; 7-1 Southland), 45, 35, 0, 80, Abil Christian, (9-11; 3-4 Southland), 25, 38, 0, 63
400595668, 2015-01-26, Cent Arkansas, (0-18; 0-7 Southland), 33, 34, 0, 67, New Orleans, (6-10; 2-5 Southland), 50, 37, 0, 87
400595669, 2015-01-26, McNeese State, (7-11; 1-6 Southland), 46, 38, 0, 84, Incarnate Word, (11-5; 3-3 Southland), 34, 52, 0, 86
400595670, 2015-01-26, SF Austin, (17-3; 7-0 Southland), 39, 43, 0, 82, Lamar, (10-10; 4-4 Southland), 23, 42, 0, 65
400595671, 2015-01-26, Texas A&M-CC, (11-8; 6-1 Southland), 31, 39, 0, 70, SE Louisiana, (5-14; 2-4 Southland), 32, 29, 0, 61
400598622, 2015-01-26, MD-E Shore, (12-10; 5-2 MEAC), 39, 33, 0, 72, Florida A&M, (0-20; 0-7 MEAC), 30, 35, 0, 65
400598623, 2015-01-26, Norfolk State, (14-9; 7-1 MEAC), 31, 39, 0, 70, Savannah State, (5-15; 1-5 MEAC), 21, 33, 0, 54
400754874, 2015-01-26, Gardner-Webb, (13-9; 5-4 Big South), 30, 29, 0, 59, Campbell, (8-14; 2-7 Big South), 37, 41, 0, 78
400597802, 2015-01-26, Milwaukee, (7-14; 2-5 Horizon), 16, 32, 0, 48, Valparaiso, (19-4; 6-2 Horizon), 39, 34, 0, 73
400591074, 2015-01-26, Alcorn State, (4-16; 3-5 SWAC), 35, 31, 0, 66, Alabama A&M, (5-12; 4-3 SWAC), 42, 36, 0, 78
400585812, 2015-01-26, Texas, (14-6; 3-4 Big 12), 25, 61, 0, 86, Iowa State, (15-4; 5-2 Big 12), 36, 53, 0, 89
400591025, 2015-01-26, Southern, (9-13; 6-2 SWAC), 36, 20, 3, 59, Alabama State, (11-5; 7-0 SWAC), 26, 30, 7, 63
400598821, 2015-01-26, Texas Southern, (9-11; 6-1 SWAC), 28, 36, 21, 85, Miss Valley St, (2-18; 1-6 SWAC), 32, 32, 20, 84
400598828, 2015-01-26, PV A&M, (5-15; 3-4 SWAC), 33, 35, 0, 68, AR-Pine Bluff, (6-15; 3-4 SWAC), 50, 55, 0, 105
400599616, 2015-01-27, G Washington, (16-5; 6-2 A 10), 21, 27, 0, 48, VCU, (17-3; 7-0 A 10), 29, 43, 0, 72
400585813, 2015-01-27, West Virginia, (17-3; 5-2 Big 12), 26, 39, 0, 65, Kansas State, (12-9; 5-3 Big 12), 24, 35, 0, 59
400588432, 2015-01-27, Xavier, (14-7; 5-4 Big East), 29, 37, 0, 66, Georgetown, (14-6; 6-3 Big East), 16, 37, 0, 53
400586800, 2015-01-27, Tulsa, (15-5; 8-0 American), 27, 35, 0, 62, Tulane, (13-8; 4-5 American), 20, 35, 0, 55
400587523, 2015-01-27, Ohio, (7-11; 2-5 MAC), 16, 24, 0, 40, E Michigan, (13-7; 2-5 MAC), 31, 45, 0, 76
400587524, 2015-01-27, Miami (OH), (7-13; 2-5 MAC), 27, 38, 0, 65, Toledo, (12-8; 4-3 MAC), 34, 36, 0, 70
400587525, 2015-01-27, Ball State, (7-11; 2-5 MAC), 24, 23, 0, 47, Akron, (14-6; 5-2 MAC), 24, 35, 0, 59
400587526, 2015-01-27, W Michigan, (13-7; 4-3 MAC), 35, 36, 0, 71, Buffalo, (13-6; 4-3 MAC), 33, 44, 0, 77
400587527, 2015-01-27, N Illinois, (8-10; 2-5 MAC), 20, 26, 0, 46, Bowling Green, (13-5; 5-2 MAC), 21, 35, 0, 56
400587528, 2015-01-27, Cent Michigan, (14-4; 4-3 MAC), 23, 30, 0, 53, Kent State, (15-5; 6-1 MAC), 24, 39, 0, 63
400587945, 2015-01-27, Pitt, (13-8; 3-5 ACC), 24, 38, 5, 67, VT, (9-11; 1-6 ACC), 29, 33, 8, 70
400595486, 2015-01-27, Nebraska, (12-8; 4-4 Big Ten), 18, 26, 0, 44, Michigan, (13-8; 6-3 Big Ten), 23, 35, 0, 58
400597354, 2015-01-27, Vanderbilt, (11-9; 1-6 SEC), 27, 35, 0, 62, Georgia, (14-5; 5-2 SEC), 31, 39, 0, 70
400599768, 2015-01-27, Saint Joe's, (8-11; 2-5 A 10), 27, 21, 0, 48, La Salle, (11-9; 3-4 A 10), 18, 35, 0, 53
400586431, 2015-01-27, Indiana State, (10-11; 6-3 MVC), 36, 42, 0, 78, Evansville, (16-5; 6-3 MVC), 40, 49, 0, 89
400586983, 2015-01-27, Tabor College,  , 24, 29, 0, 53, Oral Roberts, (11-10; 4-3 Summit), 43, 51, 0, 94
400585814, 2015-01-27, Baylor, (15-5; 3-4 Big 12), 21, 32, 0, 53, Oklahoma State, (14-6; 4-4 Big 12), 30, 34, 0, 64
400591652, 2015-01-27, Fresno State, (10-11; 5-3 MW), 22, 25, 0, 47, San Diego State, (16-5; 6-2 MW), 32, 26, 0, 58
400591653, 2015-01-27, Wyoming, (17-4; 6-2 MW), 26, 18, 0, 44, Utah State, (12-8; 5-3 MW), 29, 27, 0, 56
400597355, 2015-01-27, Florida, (11-9; 4-3 SEC), 35, 17, 0, 52, Alabama, (13-7; 3-4 SEC), 22, 28, 0, 50
400597356, 2015-01-27, Tennessee, (12-7; 4-3 SEC), 37, 27, 0, 64, Arkansas, (16-4; 5-2 SEC), 35, 34, 0, 69
400597357, 2015-01-27, Texas A&M, (14-5; 5-2 SEC), 34, 37, 0, 71, Auburn, (10-10; 2-5 SEC), 27, 34, 0, 61
400590804, 2015-01-27, Non D-I School, NA, 33, 21, 0, 54, CSU Bakersfield, (7-14; 2-3 WAC), 32, 47, 0, 79
400591654, 2015-01-27, UNLV, (12-9; 3-5 MW), 33, 34, 0, 67, Nevada, (6-13; 2-5 MW), 26, 36, 0, 62
400591655, 2015-01-27, Colorado State, (18-3; 5-3 MW), 40, 38, 0, 78, Boise State, (15-6; 5-3 MW), 30, 52, 0, 82
400588433, 2015-01-27, DePaul, (12-20; 6-12 Big East),  ,  , 0, 0, Providence, (22-11; 11-7 Big East),  ,  , 0, 0
400595487, 2015-01-27, Michigan State, (23-11; 12-6 Big Ten),  ,  , 0, 0, Rutgers, (10-22; 2-16 Big Ten),  ,  , 0, 0
400586801, 2015-01-28, SMU, (17-4; 8-1 American), 32, 31, 0, 63, USF, (7-14; 1-7 American), 25, 27, 0, 52
400586804, 2015-01-28, Temple, (14-7; 5-3 American), 37, 49, 0, 86, UCF, (9-11; 2-7 American), 18, 44, 0, 62
400587160, 2015-01-28, American U, (11-10; 4-5 Patriot), 34, 20, 0, 54, Navy, (8-13; 4-5 Patriot), 37, 27, 0, 64
400587162, 2015-01-28, Lafayette, (12-8; 4-5 Patriot), 25, 34, 0, 59, Colgate, (9-13; 6-3 Patriot), 32, 22, 0, 54
400587946, 2015-01-28, Wake Forest, (9-12; 1-7 ACC), 33, 32, 11, 76, FSU, (11-10; 3-5 ACC), 27, 38, 17, 82
400588434, 2015-01-28, Seton Hall, (14-6; 4-4 Big East), 32, 48, 0, 80, Marquette, (10-10; 2-6 Big East), 28, 42, 0, 70
400589382, 2015-01-28, Winthrop, (11-9; 6-3 Big South), 35, 40, 0, 75, Coast Carolina, (15-6; 6-3 Big South), 34, 34, 0, 68
400589383, 2015-01-28, UNC Asheville, (10-10; 6-3 Big South), 37, 37, 0, 74, Longwood, (6-16; 2-7 Big South), 31, 33, 0, 64
400591183, 2015-01-28, URI, (14-5; 6-2 A 10), 31, 33, 0, 64, Fordham, (5-13; 0-7 A 10), 32, 31, 0, 63
400591184, 2015-01-28, Duquesne, (6-13; 1-7 A 10), 27, 28, 0, 55, Richmond, (11-9; 4-3 A 10), 49, 37, 0, 86
400595488, 2015-01-28, Minnesota, (13-9; 2-7 Big Ten), 23, 35, 0, 58, Penn State, (14-7; 2-6 Big Ten), 33, 30, 0, 63
400596460, 2015-01-28, Albany, (13-7; 8-0 Am. East), 25, 22, 0, 47, UVM, (11-10; 6-2 Am. East), 17, 27, 0, 44
400596478, 2015-01-28, Binghamton, (3-20; 2-6 Am. East), 33, 35, 0, 68, UMBC, (3-18; 1-7 Am. East), 24, 32, 0, 56
400596494, 2015-01-28, Hartford, (11-10; 4-4 Am. East), 28, 38, 0, 66, Stony Brook, (15-8; 6-2 Am. East), 25, 47, 0, 72
400596527, 2015-01-28, UNH, (12-9; 5-3 Am. East), 23, 40, 0, 63, Maine, (2-19; 1-7 Am. East), 20, 38, 0, 58
400597358, 2015-01-28, South Carolina, (10-9; 1-6 SEC), 28, 30, 0, 58, LSU, (16-4; 5-2 SEC), 29, 35, 0, 64
400597812, 2015-01-28, Wright State, (11-11; 3-5 Horizon), 33, 29, 14, 76, Oakland, (10-12; 5-2 Horizon), 28, 34, 22, 84
400597861, 2015-01-28, Delaware, (4-16; 3-6 CAA), 34, 48, 0, 82, JMU, (13-9; 6-3 CAA), 40, 48, 0, 88
400597877, 2015-01-28, Northeastern, (14-8; 6-3 CAA), 29, 31, 0, 60, Drexel, (6-14; 4-5 CAA), 19, 46, 0, 65
400597893, 2015-01-28, Elon, (11-11; 3-6 CAA), 23, 42, 0, 65, UNC-Wilmington, (12-8; 7-2 CAA), 47, 35, 0, 82
400597906, 2015-01-28, Hofstra, (14-8; 5-4 CAA), 34, 45, 0, 79, William & Mary, (13-7; 7-2 CAA), 54, 46, 0, 100
400587947, 2015-01-28, Duke, (17-3; 4-3 ACC), 39, 34, 0, 73, Notre Dame, (20-2; 8-1 ACC), 36, 41, 0, 77
400585815, 2015-01-28, Texas Tech, (11-10; 1-7 Big 12), 16, 20, 0, 36, Oklahoma, (13-7; 4-4 Big 12), 37, 44, 0, 81
400589384, 2015-01-28, Radford, (15-7; 6-3 Big South), 45, 39, 0, 84, Charleston So, (12-8; 6-3 Big South), 35, 42, 0, 77
400586433, 2015-01-28, Loyola (CHI), (13-8; 3-6 MVC), 23, 24, 0, 47, Wichita State, (19-2; 9-0 MVC), 29, 29, 0, 58
400586432, 2015-01-28, Missouri State, (8-13; 2-7 MVC), 25, 32, 0, 57, Illinois State, (13-8; 5-4 MVC), 28, 39, 0, 67
400586435, 2015-01-28, Drake, (5-16; 2-7 MVC), 41, 28, 0, 69, Bradley, (7-15; 2-7 MVC), 31, 26, 0, 57
400586802, 2015-01-28, Rice, (6-13; 3-4 C-USA), 20, 28, 0, 48, Houston, (8-12; 0-8 American), 22, 37, 0, 59
400586984, 2015-01-28, Omaha, (8-12; 2-6 Summit), 31, 33, 0, 64, South Dakota St, (16-7; 7-2 Summit), 41, 45, 0, 86
400587163, 2015-01-28, Lehigh, (10-10; 4-5 Patriot), 26, 36, 0, 62, Bucknell, (12-10; 7-2 Patriot), 23, 45, 0, 68
400593283, 2015-01-28, Oregon State, (14-6; 5-3 Pac-12), 23, 32, 0, 55, Arizona State, (11-10; 3-5 Pac-12), 40, 33, 0, 73
400596399, 2015-01-28, Morehead State, (10-13; 5-3 OVC), 33, 49, 0, 82, Austin Peay, (7-14; 2-5 OVC), 33, 36, 0, 69
400586434, 2015-01-28, Northern Iowa, (19-2; 8-1 MVC), 23, 36, 0, 59, S Illinois, (9-13; 2-7 MVC), 26, 26, 0, 52
400585816, 2015-01-28, Kansas, (17-3; 6-1 Big 12), 36, 28, 0, 64, TCU, (14-6; 1-6 Big 12), 30, 31, 0, 61
400587949, 2015-01-28, Louisville, (17-3; 5-2 ACC), 35, 46, 0, 81, Boston College, (9-10; 1-6 ACC), 33, 39, 0, 72
400595489, 2015-01-28, Indiana, (15-6; 5-3 Big Ten), 27, 40, 0, 67, Purdue, (13-8; 5-3 Big Ten), 38, 45, 0, 83
400587950, 2015-01-28, Georgia Tech, (10-10; 1-7 ACC), 34, 36, 0, 70, Miami (FL), (14-6; 4-3 ACC), 26, 24, 0, 50
400586803, 2015-01-28, ECU, (8-12; 1-6 American), 24, 34, 0, 58, Memphis, (13-7; 6-3 American), 39, 31, 0, 70
400587948, 2015-01-28, Clemson, (12-8; 4-4 ACC), 36, 32, 0, 68, NC State, (13-9; 4-5 ACC), 16, 41, 0, 57
400597359, 2015-01-28, Miss St, (9-11; 2-5 SEC), 32, 41, 0, 73, Ole Miss, (13-7; 4-3 SEC), 28, 51, 0, 79
400588435, 2015-01-28, St John's, (13-7; 2-5 Big East), 27, 47, 0, 74, Creighton, (10-12; 1-8 Big East), 37, 40, 0, 77
400593284, 2015-01-28, Oregon, (14-7; 4-4 Pac-12), 27, 29, 0, 56, Arizona, (19-2; 7-1 Pac-12), 42, 48, 0, 90
400591656, 2015-01-28, Air Force, (9-11; 2-7 MW), 29, 37, 0, 66, San Jose State, (2-18; 0-8 MW), 23, 29, 0, 52
400593285, 2015-01-28, Stanford, (15-5; 6-2 Pac-12), 36, 48, 0, 84, Washington, (14-6; 3-5 Pac-12), 24, 50, 0, 74
400587164, 2015-01-28, Holy Cross, (14-16; 8-10 Patriot),  ,  , 0, 0, Loyola (MD), (11-19; 7-11 Patriot),  ,  , 0, 0
400755862, 2015-01-29, DePaul, (11-11; 5-4 Big East), 23, 49, 0, 72, Providence, (16-5; 6-2 Big East), 41, 42, 0, 83
400755871, 2015-01-29, Michigan State, (14-7; 5-3 Big Ten), 42, 29, 0, 71, Rutgers, (10-12; 2-7 Big Ten), 34, 17, 0, 51
400595490, 2015-01-29, Maryland, (18-4; 6-3 Big Ten), 26, 30, 0, 56, OSU, (17-5; 6-3 Big Ten), 34, 46, 0, 80
400587161, 2015-01-29, Boston U, (8-12; 4-5 Patriot), 37, 30, 0, 67, Army, (14-6; 5-4 Patriot), 32, 39, 0, 71
400588746, 2015-01-29, USC Upstate, (15-7; 3-3 A-Sun), 44, 34, 0, 78, Jacksonville, (7-16; 1-5 A-Sun), 34, 31, 0, 65
400588747, 2015-01-29, Kennesaw St, (6-16; 1-5 A-Sun), 23, 44, 0, 67, North Florida, (14-9; 6-0 A-Sun), 48, 38, 0, 86
400588748, 2015-01-29, N Kentucky, (9-12; 3-3 A-Sun), 27, 48, 0, 75, Stetson, (6-15; 1-5 A-Sun), 37, 48, 0, 85
400588749, 2015-01-29, Lipscomb, (10-11; 4-2 A-Sun), 25, 37, 0, 62, FGCU, (15-7; 5-1 A-Sun), 37, 41, 0, 78
400589190, 2015-01-29, East Tenn St, (12-8; 6-5 Southern), 24, 31, 0, 55, Furman, (7-13; 4-5 Southern), 29, 30, 0, 59
400589191, 2015-01-29, Chattanooga, (14-8; 7-2 Southern), 26, 42, 4, 72, Mercer, (12-10; 7-2 Southern), 36, 32, 7, 75
400589192, 2015-01-29, Wofford, (17-5; 8-1 Southern), 30, 28, 0, 58, UNC Greensboro, (6-16; 2-7 Southern), 22, 20, 0, 42
400589193, 2015-01-29, W Carolina, (10-12; 5-5 Southern), 40, 45, 0, 85, VMI, (8-14; 4-7 Southern), 36, 34, 0, 70
400589385, 2015-01-29, High Point, (17-5; 8-2 Big South), 33, 39, 0, 72, Liberty, (6-16; 0-9 Big South), 26, 27, 0, 53
400591185, 2015-01-29, Dayton, (16-4; 6-2 A 10), 34, 30, 0, 64, UMass, (11-9; 4-3 A 10), 36, 30, 0, 66
400591472, 2015-01-29, FAU, (8-9; 1-5 C-USA), 25, 36, 0, 61, Charlotte, (9-11; 3-5 C-USA), 41, 45, 0, 86
400591473, 2015-01-29, FIU, (9-10; 2-4 C-USA), 26, 30, 0, 56, Old Dominion, (16-4; 5-3 C-USA), 34, 37, 0, 71
400591474, 2015-01-29, W Kentucky, (14-6; 7-1 C-USA), 23, 33, 0, 56, LA Tech, (16-5; 7-1 C-USA), 31, 38, 0, 69
400591722, 2015-01-29, Bryant, (9-10; 6-3 NEC), 35, 33, 0, 68, St Francis (PA), (11-9; 5-4 NEC), 37, 38, 0, 75
400591745, 2015-01-29, Cent Conn St, (3-19; 1-8 NEC), 24, 31, 0, 55, LIU Brooklyn, (8-12; 4-5 NEC), 34, 33, 0, 67
400591764, 2015-01-29, Fair Dickinson, (7-13; 2-7 NEC), 28, 37, 0, 65, Robert Morris, (11-10; 7-2 NEC), 41, 46, 0, 87
400591799, 2015-01-29, Mt St Mary's, (9-11; 5-4 NEC), 27, 36, 4, 67, St Francis (BKN), (13-9; 7-2 NEC), 26, 37, 10, 73
400596025, 2015-01-29, Sacred Heart, (9-13; 3-6 NEC), 33, 31, 0, 64, Wagner, (7-13; 5-4 NEC), 30, 45, 0, 75
400597759, 2015-01-29, Youngstown St, (10-14; 1-8 Horizon), 22, 50, 15, 87, Detroit, (11-12; 4-4 Horizon), 34, 38, 21, 93
400597843, 2015-01-29, Charleston, (6-16; 1-8 CAA), 19, 51, 0, 70, Towson, (10-12; 3-6 CAA), 33, 41, 0, 74
400599605, 2015-01-29, Saint Louis, (9-11; 1-6 A 10), 24, 36, 0, 60, George Mason, (7-12; 2-5 A 10), 29, 39, 0, 68
400595293, 2015-01-29, Appalachian St, (8-11; 5-5 Sun Belt), 16, 30, 0, 46, Ga Southern, (14-4; 7-2 Sun Belt), 33, 50, 0, 83
400596400, 2015-01-29, E Illinois, (12-9; 6-3 OVC), 22, 29, 0, 51, UT Martin, (13-7; 5-2 OVC), 43, 38, 0, 81
400755857, 2015-01-29, Holy Cross, (8-11; 3-6 Patriot), 18, 36, 0, 54, Loyola (MD), (8-12; 4-5 Patriot), 26, 38, 0, 64
400586042, 2015-01-29, Weber State, (9-11; 4-5 Big Sky), 30, 37, 0, 67, North Dakota, (6-13; 2-6 Big Sky), 26, 34, 0, 60
400586229, 2015-01-29, Rider, (14-8; 8-3 MAAC), 25, 33, 0, 58, St Peter's, (10-12; 4-7 MAAC), 23, 26, 0, 49
400586805, 2015-01-29, UConn, (11-8; 4-3 American), 22, 36, 0, 58, Cincinnati, (15-5; 6-2 American), 30, 40, 0, 70
400586985, 2015-01-29, Denver, (9-12; 3-5 Summit), 26, 21, 7, 54, North Dakota St, (14-7; 6-2 Summit), 16, 31, 14, 61
400586986, 2015-01-29, IPFW, (10-11; 3-5 Summit), 33, 33, 0, 66, South Dakota, (10-12; 4-4 Summit), 24, 31, 0, 55
400591475, 2015-01-29, Marshall, (6-15; 2-6 C-USA), 35, 34, 0, 69, Southern Miss, (6-13; 1-7 C-USA), 25, 29, 0, 54
400591476, 2015-01-29, Mid Tennessee, (12-9; 5-3 C-USA), 38, 20, 0, 58, UTSA, (10-9; 4-4 C-USA), 31, 38, 0, 69
400596401, 2015-01-29, Jacksonville St, (9-14; 2-7 OVC), 35, 47, 0, 82, Belmont, (14-7; 6-2 OVC), 45, 58, 0, 103
400596402, 2015-01-29, Tenn Tech, (10-12; 2-7 OVC), 22, 34, 0, 56, Tennessee St, (4-18; 1-6 OVC), 32, 32, 0, 64
400596403, 2015-01-29, SIU-ED, (9-11; 5-4 OVC), 35, 40, 0, 75, SE Missouri St, (9-12; 3-5 OVC), 34, 27, 0, 61
400597788, 2015-01-29, UIC, (5-17; 1-6 Horizon), 28, 37, 0, 65, Milwaukee, (8-14; 3-5 Horizon), 28, 43, 0, 71
400595294, 2015-01-29, LA-Lafayette, (11-10; 5-5 Sun Belt), 43, 42, 0, 85, South Alabama, (7-14; 5-5 Sun Belt), 33, 56, 0, 89
400595292, 2015-01-29, AR-Little Rock, (8-12; 3-7 Sun Belt), 37, 38, 0, 75, Arkansas State, (9-11; 4-7 Sun Belt), 38, 27, 0, 65
400595296, 2015-01-29, Georgia State, (14-7; 7-3 Sun Belt), 34, 54, 0, 88, UT-Arlington, (12-8; 6-4 Sun Belt), 38, 36, 0, 74
400595295, 2015-01-29, UL Monroe, (13-8; 7-3 Sun Belt), 21, 29, 8, 58, Troy, (7-12; 2-8 Sun Belt), 31, 19, 5, 55
400597360, 2015-01-29, Kentucky, (20-0; 7-0 SEC), 34, 35, 0, 69, Missouri, (7-13; 1-6 SEC), 25, 28, 0, 53
400587323, 2015-01-29, Portland, (12-10; 3-7 WCC), 25, 21, 0, 46, Gonzaga, (21-1; 10-0 WCC), 31, 33, 0, 64
400586045, 2015-01-29, Idaho State, (5-16; 2-7 Big Sky), 39, 37, 0, 76, N Colorado, (10-9; 5-3 Big Sky), 38, 41, 0, 79
400590805, 2015-01-29, UMKC, (8-14; 3-2 WAC), 23, 34, 0, 57, Grand Canyon, (12-10; 3-2 WAC), 43, 35, 0, 78
400591477, 2015-01-29, UAB, (10-11; 6-2 C-USA), 33, 36, 0, 69, UTEP, (13-7; 5-3 C-USA), 30, 41, 0, 71
400596404, 2015-01-29, E Kentucky, (11-9; 3-4 OVC), 38, 32, 8, 78, Murray State, (18-4; 8-0 OVC), 32, 38, 15, 85
400590806, 2015-01-29, Chicago State, (4-18; 0-5 WAC), 35, 27, 0, 62, Utah Valley, (8-11; 3-2 WAC), 42, 36, 0, 78
400593286, 2015-01-29, Colorado, (11-9; 4-4 Pac-12), 37, 29, 32, 98, USC, (9-11; 1-7 Pac-12), 38, 28, 28, 94
400593287, 2015-01-29, Utah, (16-4; 6-2 Pac-12), 30, 29, 0, 59, UCLA, (12-9; 4-4 Pac-12), 33, 36, 0, 69
400587322, 2015-01-29, Pepperdine, (13-8; 6-4 WCC), 22, 28, 0, 50, Pacific, (10-12; 2-8 WCC), 21, 22, 0, 43
400587324, 2015-01-29, Santa Clara, (11-11; 5-5 WCC), 22, 42, 0, 64, San Diego, (11-11; 4-6 WCC), 32, 37, 0, 69
400595967, 2015-01-29, Cal Poly, (10-9; 3-4 Big West), 25, 32, 0, 57, UC Irvine, (12-8; 5-1 Big West), 34, 33, 0, 67
400595968, 2015-01-29, UCSB, (10-10; 3-3 Big West), 35, 29, 0, 64, UC Davis, (15-4; 5-1 Big West), 37, 33, 0, 70
400595969, 2015-01-29, Hawaii, (15-7; 3-3 Big West), 50, 34, 0, 84, CS Northridge, (6-16; 2-5 Big West), 34, 39, 0, 73
400586043, 2015-01-29, Montana State, (4-16; 1-7 Big Sky), 33, 26, 0, 59, Sacramento St, (14-6; 8-1 Big Sky), 36, 39, 0, 75
400586044, 2015-01-29, Montana, (11-8; 7-1 Big Sky), 32, 41, 0, 73, Portland State, (10-9; 4-5 Big Sky), 31, 23, 0, 54
400587321, 2015-01-29, Loyola Mary, (6-16; 2-8 WCC), 32, 22, 0, 54, Saint Mary's, (17-4; 9-1 WCC), 35, 33, 0, 68
400595970, 2015-01-29, LBSU, (11-11; 5-1 Big West), 36, 39, 16, 91, CS Fullerton, (8-13; 0-6 Big West), 42, 33, 10, 85
400587320, 2015-01-29, San Francisco, (9-13; 3-7 WCC), 30, 44, 0, 74, BYU, (16-7; 6-4 WCC), 34, 44, 0, 78
400593288, 2015-01-29, Cal, (12-9; 2-6 Pac-12), 39, 37, 0, 76, Washington St, (9-11; 3-5 Pac-12), 37, 30, 0, 67
400591297, 2015-01-30, Harvard, (12-5; 2-1 Ivy), 39, 36, 0, 75, Princeton, (8-10; 1-1 Ivy), 29, 43, 0, 72
400586259, 2015-01-30, Siena, (8-12; 5-6 MAAC), 41, 38, 0, 79, Manhattan, (10-10; 7-4 MAAC), 43, 44, 0, 87
400586260, 2015-01-30, Quinnipiac, (11-9; 5-6 MAAC), 25, 32, 0, 57, Canisius, (12-8; 7-4 MAAC), 33, 30, 0, 63
400586261, 2015-01-30, Marist, (3-18; 2-9 MAAC), 24, 41, 0, 65, Niagara, (3-17; 2-9 MAAC), 21, 40, 0, 61
400591226, 2015-01-30, Brown, (9-11; 0-3 Ivy), 27, 22, 0, 49, Cornell, (10-9; 2-1 Ivy), 24, 33, 0, 57
400591284, 2015-01-30, Dartmouth, (8-9; 1-2 Ivy), 16, 35, 0, 51, Penn, (6-10; 1-1 Ivy), 20, 38, 0, 58
400586262, 2015-01-30, Monmouth, (12-10; 8-3 MAAC), 29, 31, 0, 60, Fairfield, (6-15; 4-7 MAAC), 22, 37, 0, 59
400586987, 2015-01-30, IUPUI, (8-14; 4-4 Summit), 27, 32, 0, 59, W Illinois, (8-11; 3-5 Summit), 28, 35, 0, 63
400591248, 2015-01-30, Yale, (14-6; 3-0 Ivy), 35, 28, 0, 63, Columbia, (9-8; 1-2 Ivy), 32, 27, 0, 59
400593289, 2015-01-30, Oregon, (15-7; 5-4 Pac-12), 34, 26, 8, 68, Arizona State, (11-11; 3-6 Pac-12), 29, 31, 7, 67
400593290, 2015-01-30, Oregon State, (14-7; 5-4 Pac-12), 13, 21, 0, 34, Arizona, (20-2; 8-1 Pac-12), 24, 33, 0, 57
400587531, 2015-01-30, Kent State, (15-6; 6-2 MAC), 25, 30, 0, 55, Buffalo, (14-6; 5-3 MAC), 45, 35, 0, 80
400595491, 2015-01-31, Wisconsin, (19-2; 7-1 Big Ten), 42, 32, 0, 74, Iowa, (13-8; 4-4 Big Ten), 36, 27, 0, 63
400587952, 2015-01-31, Notre Dame, (20-3; 8-2 ACC), 38, 34, 0, 72, Pitt, (14-8; 4-5 ACC), 37, 39, 0, 76
400585817, 2015-01-31, Texas Tech, (11-11; 1-8 Big 12), 31, 27, 0, 58, West Virginia, (18-3; 6-2 Big 12), 37, 40, 0, 77
400586806, 2015-01-31, Tulane, (13-9; 4-6 American), 8, 29, 0, 37, Temple, (15-7; 6-3 American), 28, 27, 0, 55
400587533, 2015-01-31, W Michigan, (13-8; 4-4 MAC), 31, 32, 0, 63, E Michigan, (14-7; 3-5 MAC), 31, 38, 0, 69
400587951, 2015-01-31, NC State, (14-9; 5-5 ACC), 40, 28, 13, 81, Georgia Tech, (10-11; 1-8 ACC), 31, 37, 12, 80
400587953, 2015-01-31, Boston College, (9-11; 1-7 ACC), 16, 33, 0, 49, Clemson, (13-8; 5-4 ACC), 27, 37, 0, 64
400588436, 2015-01-31, Providence, (16-6; 6-3 Big East), 32, 34, 0, 66, St John's, (14-7; 3-5 Big East), 44, 31, 0, 75
400588437, 2015-01-31, Xavier, (14-8; 5-5 Big East), 37, 45, 0, 82, Seton Hall, (15-6; 5-4 Big East), 38, 52, 0, 90
400591186, 2015-01-31, Davidson, (14-5; 5-3 A 10), 41, 29, 0, 70, Saint Joe's, (9-11; 3-5 A 10), 28, 47, 0, 75
400597361, 2015-01-31, Auburn, (10-11; 2-6 SEC), 29, 34, 0, 63, Tennessee, (13-7; 5-3 SEC), 33, 38, 0, 71
400597692, 2015-01-31, Stony Brook, (15-9; 6-3 Am. East), 25, 23, 0, 48, UNH, (13-9; 6-3 Am. East), 29, 34, 0, 63
400586807, 2015-01-31, USF, (7-15; 1-8 American), 33, 29, 9, 71, Tulsa, (16-5; 9-0 American), 30, 32, 16, 78
400588752, 2015-01-31, Lipscomb, (10-12; 4-3 A-Sun), 40, 33, 0, 73, Stetson, (7-15; 2-5 A-Sun), 30, 45, 0, 75
400595492, 2015-01-31, Penn State, (14-8; 2-7 Big Ten), 26, 32, 0, 58, Illinois, (14-8; 4-5 Big Ten), 30, 30, 0, 60
400597362, 2015-01-31, Arkansas, (16-5; 5-3 SEC), 27, 29, 0, 56, Florida, (12-9; 5-3 SEC), 29, 28, 0, 57
400586436, 2015-01-31, Bradley, (7-16; 2-8 MVC), 26, 32, 0, 58, Indiana State, (11-11; 7-3 MVC), 23, 41, 0, 64
400588439, 2015-01-31, Villanova, (19-2; 6-2 Big East), 31, 37, 0, 68, DePaul, (11-12; 5-5 Big East), 37, 18, 0, 55
400585819, 2015-01-31, Kansas State, (12-10; 5-4 Big 12), 17, 40, 0, 57, Kansas, (18-3; 7-1 Big 12), 33, 35, 0, 68
400599794, 2015-01-31, Richmond, (12-9; 5-3 A 10), 22, 42, 0, 64, VCU, (17-4; 7-1 A 10), 28, 27, 0, 55
400585818, 2015-01-31, TCU, (14-7; 1-7 Big 12), 33, 33, 0, 66, Iowa State, (16-4; 6-2 Big 12), 35, 48, 0, 83
400588440, 2015-01-31, Georgetown, (15-6; 7-3 Big East), 28, 39, 0, 67, Creighton, (10-13; 1-9 Big East), 17, 23, 0, 40
400588438, 2015-01-31, Butler, (16-6; 6-3 Big East), 29, 29, 14, 72, Marquette, (10-11; 2-7 Big East), 26, 32, 10, 68
400586437, 2015-01-31, Illinois State, (14-8; 6-4 MVC), 26, 22, 0, 48, Loyola (CHI), (13-9; 3-7 MVC), 19, 26, 0, 45
400586988, 2015-01-31, IPFW, (11-11; 4-5 Summit), 27, 48, 0, 75, Omaha, (8-13; 2-7 Summit), 29, 36, 0, 65
400587165, 2015-01-31, Boston U, (8-13; 4-6 Patriot), 23, 63, 0, 86, Lehigh, (11-10; 5-5 Patriot), 45, 44, 0, 89
400587954, 2015-01-31, VT, (9-12; 1-7 ACC), 28, 42, 0, 70, Wake Forest, (10-12; 2-7 ACC), 32, 41, 0, 73
400588750, 2015-01-31, Kennesaw St, (7-16; 2-5 A-Sun), 23, 28, 0, 51, Jacksonville, (7-17; 1-6 A-Sun), 20, 30, 0, 50
400591800, 2015-01-31, Mt St Mary's, (10-11; 6-4 NEC), 41, 36, 0, 77, Sacred Heart, (9-14; 3-7 NEC), 33, 38, 0, 71
400595298, 2015-01-31, Arkansas State, (9-12; 4-8 Sun Belt), 18, 25, 0, 43, Georgia State, (15-7; 8-3 Sun Belt), 34, 40, 0, 74
400596461, 2015-01-31, Albany, (14-7; 9-0 Am. East), 30, 47, 0, 77, Maine, (2-20; 1-8 Am. East), 27, 32, 0, 59
400596479, 2015-01-31, UMass Lowell, (9-13; 3-6 Am. East), 27, 42, 0, 69, Binghamton, (4-20; 3-6 Am. East), 28, 48, 0, 76
400596495, 2015-01-31, UVM, (12-10; 7-2 Am. East), 26, 39, 0, 65, Hartford, (11-11; 4-5 Am. East), 20, 26, 0, 46
400597363, 2015-01-31, LSU, (16-5; 5-3 SEC), 28, 39, 0, 67, Miss St, (10-11; 3-5 SEC), 31, 42, 0, 73
400597740, 2015-01-31, Green Bay, (17-5; 6-2 Horizon), 21, 41, 0, 62, Cleveland State, (13-10; 7-2 Horizon), 32, 44, 0, 76
400597844, 2015-01-31, Charleston, (6-17; 1-9 CAA), 33, 35, 0, 68, Delaware, (5-16; 4-6 CAA), 29, 42, 0, 71
400586046, 2015-01-31, Idaho State, (5-17; 2-8 Big Sky), 26, 43, 0, 69, North Dakota, (7-13; 3-6 Big Sky), 37, 43, 0, 80
400587166, 2015-01-31, Loyola (MD), (9-12; 5-5 Patriot), 29, 48, 0, 77, Army, (14-7; 5-5 Patriot), 32, 39, 0, 71
400591484, 2015-01-31, UAB, (11-11; 7-2 C-USA), 33, 32, 0, 65, UTSA, (10-10; 4-5 C-USA), 29, 28, 0, 57
400596405, 2015-01-31, Tenn Tech, (10-13; 2-8 OVC), 30, 23, 0, 53, Belmont, (15-7; 7-2 OVC), 37, 34, 0, 71
400597789, 2015-01-31, Valparaiso, (20-4; 7-2 Horizon), 39, 31, 0, 70, UIC, (5-18; 1-7 Horizon), 25, 40, 0, 65
400598626, 2015-01-31, Bethune-Cookman, (7-15; 3-5 MEAC), 26, 35, 0, 61, Florida A&M, (0-21; 0-8 MEAC), 16, 28, 0, 44
400586440, 2015-01-31, Evansville, (16-6; 6-4 MVC), 27, 38, 0, 65, Drake, (6-16; 3-7 MVC), 29, 41, 0, 70
400595493, 2015-01-31, Rutgers, (10-13; 2-8 Big Ten), 30, 34, 0, 64, Indiana, (16-6; 6-3 Big Ten), 32, 40, 0, 72
400587530, 2015-01-31, Ball State, (7-12; 2-6 MAC), 38, 35, 0, 73, Miami (OH), (8-13; 3-5 MAC), 30, 49, 0, 79
400587956, 2015-01-31, UNC, (17-5; 7-2 ACC), 36, 24, 8, 68, Louisville, (18-3; 6-2 ACC), 25, 35, 18, 78
400586439, 2015-01-31, Wichita State, (19-3; 9-1 MVC), 24, 30, 0, 54, Northern Iowa, (20-2; 9-1 MVC), 37, 33, 0, 70
400587325, 2015-01-31, Loyola Mary, (7-16; 3-8 WCC), 27, 31, 18, 76, Pacific, (10-13; 2-9 WCC), 34, 24, 13, 71
400589386, 2015-01-31, Coast Carolina, (15-7; 6-4 Big South), 23, 41, 0, 64, Gardner-Webb, (14-9; 6-4 Big South), 29, 37, 0, 66
400589387, 2015-01-31, Winthrop, (11-10; 6-4 Big South), 35, 31, 0, 66, Radford, (16-7; 7-3 Big South), 28, 45, 0, 73
400591723, 2015-01-31, Bryant, (10-10; 7-3 NEC), 31, 40, 0, 71, Robert Morris, (11-11; 7-3 NEC), 24, 44, 0, 68
400591746, 2015-01-31, Cent Conn St, (3-20; 1-9 NEC), 25, 30, 0, 55, Wagner, (8-13; 6-4 NEC), 43, 43, 0, 86
400591765, 2015-01-31, Fair Dickinson, (7-14; 2-8 NEC), 32, 31, 0, 63, St Francis (PA), (12-9; 6-4 NEC), 35, 33, 0, 68
400591781, 2015-01-31, LIU Brooklyn, (8-13; 4-6 NEC), 34, 30, 0, 64, St Francis (BKN), (14-9; 8-2 NEC), 40, 41, 0, 81
400597364, 2015-01-31, Georgia, (14-6; 5-3 SEC), 24, 26, 0, 50, South Carolina, (11-9; 2-6 SEC), 33, 34, 0, 67
400597365, 2015-01-31, Ole Miss, (14-7; 5-3 SEC), 37, 30, 0, 67, Missouri, (7-14; 1-7 SEC), 25, 22, 0, 47
400597878, 2015-01-31, UNC-Wilmington, (12-9; 7-3 CAA), 35, 41, 0, 76, Drexel, (7-14; 5-5 CAA), 43, 42, 0, 85
400597918, 2015-01-31, William & Mary, (14-7; 8-2 CAA), 43, 41, 0, 84, JMU, (13-10; 6-4 CAA), 22, 43, 0, 65
400599670, 2015-01-31, G Washington, (16-6; 6-3 A 10), 19, 36, 0, 55, URI, (15-5; 7-2 A 10), 28, 31, 0, 59
400599779, 2015-01-31, UMass, (12-9; 5-3 A 10), 30, 30, 0, 60, Saint Louis, (9-12; 1-7 A 10), 27, 29, 0, 56
400596406, 2015-01-31, SIU-ED, (9-12; 5-5 OVC), 19, 35, 0, 54, E Illinois, (13-9; 7-3 OVC), 26, 31, 0, 57
400598627, 2015-01-31, Coppin State, (3-18; 2-6 MEAC), 48, 34, 0, 82, MD-E Shore, (13-10; 6-2 MEAC), 45, 47, 0, 92
400598625, 2015-01-31, Morgan State, (4-17; 2-5 MEAC), 20, 28, 0, 48, Howard, (11-10; 5-2 MEAC), 28, 36, 0, 64
400587534, 2015-01-31, Ohio, (7-12; 2-6 MAC), 31, 38, 0, 69, Cent Michigan, (15-4; 5-3 MAC), 41, 33, 0, 74
400589388, 2015-01-31, Campbell, (8-15; 2-8 Big South), 27, 36, 0, 63, UNC Asheville, (11-10; 7-3 Big South), 24, 46, 0, 70
400595673, 2015-01-31, Incarnate Word, (12-5; 4-3 Southland), 30, 39, 0, 69, Nicholls State, (5-13; 2-6 Southland), 27, 31, 0, 58
400597366, 2015-01-31, Vanderbilt, (11-10; 1-7 SEC), 23, 35, 0, 58, Texas A&M, (15-5; 6-2 SEC), 39, 30, 0, 69
400596410, 2015-01-31, E Kentucky, (12-9; 4-4 OVC), 27, 39, 0, 66, Morehead State, (10-14; 5-4 OVC), 34, 23, 0, 57
400586049, 2015-01-31, Idaho, (8-11; 3-5 Big Sky), 45, 41, 9, 95, E Washington, (16-5; 7-1 Big Sky), 43, 43, 12, 98
400589195, 2015-01-31, W Carolina, (11-12; 6-5 Southern), 37, 41, 0, 78, UNC Greensboro, (6-17; 2-8 Southern), 34, 39, 0, 73
400591050, 2015-01-31, Jackson State, (5-16; 3-5 SWAC), 29, 33, 0, 62, Miss Valley St, (3-18; 2-6 SWAC), 44, 31, 0, 75
400597760, 2015-01-31, Detroit, (11-13; 4-5 Horizon), 33, 41, 0, 74, Milwaukee, (9-14; 4-5 Horizon), 35, 43, 0, 78
400586989, 2015-01-31, Oral Roberts, (12-10; 5-3 Summit), 29, 44, 0, 73, South Dakota, (10-13; 4-5 Summit), 39, 33, 0, 72
400586990, 2015-01-31, Denver, (9-13; 3-6 Summit), 23, 16, 0, 39, South Dakota St, (17-7; 8-2 Summit), 32, 37, 0, 69
400591480, 2015-01-31, Marshall, (6-16; 2-7 C-USA), 30, 27, 0, 57, LA Tech, (17-5; 8-1 C-USA), 44, 37, 0, 81
400595300, 2015-01-31, South Alabama, (7-15; 5-6 Sun Belt), 18, 43, 0, 61, UL Monroe, (14-8; 8-3 Sun Belt), 32, 35, 0, 67
400595674, 2015-01-31, Houston Baptist, (9-9; 4-4 Southland), 22, 30, 0, 52, Sam Houston, (16-5; 8-1 Southland), 32, 31, 0, 63
400595299, 2015-01-31, LA-Lafayette, (12-10; 6-5 Sun Belt), 34, 38, 0, 72, Texas State, (10-10; 4-7 Sun Belt), 27, 36, 0, 63
400585820, 2015-01-31, Texas, (14-7; 3-5 Big 12), 27, 33, 0, 60, Baylor, (16-5; 4-4 Big 12), 39, 44, 0, 83
400587326, 2015-01-31, Pepperdine, (14-8; 7-4 WCC), 28, 39, 0, 67, Saint Mary's, (17-5; 9-2 WCC), 33, 29, 0, 62
400589194, 2015-01-31, The Citadel, (8-13; 3-7 Southern), 30, 43, 0, 73, Chattanooga, (15-8; 8-2 Southern), 47, 31, 0, 78
400591263, 2015-01-31, Yale, (15-6; 4-0 Ivy), 31, 34, 0, 65, Cornell, (10-10; 2-2 Ivy), 26, 31, 0, 57
400591285, 2015-01-31, Dartmouth, (8-10; 1-3 Ivy), 24, 29, 0, 53, Princeton, (9-10; 2-1 Ivy), 33, 31, 0, 64
400591483, 2015-01-31, W Kentucky, (15-6; 8-1 C-USA), 34, 39, 0, 73, Southern Miss, (6-14; 1-8 C-USA), 28, 34, 0, 62
400591657, 2015-01-31, Nevada, (6-14; 2-6 MW), 23, 32, 0, 55, Wyoming, (18-4; 7-2 MW), 33, 30, 0, 63
400591658, 2015-01-31, Fresno State, (10-12; 5-4 MW), 22, 35, 0, 57, Colorado State, (19-3; 6-3 MW), 35, 45, 0, 80
400595494, 2015-01-31, Nebraska, (12-9; 4-5 Big Ten), 16, 26, 0, 42, Minnesota, (14-9; 3-7 Big Ten), 23, 37, 0, 60
400595495, 2015-01-31, Purdue, (14-8; 6-3 Big Ten), 28, 40, 0, 68, Northwestern, (10-11; 1-7 Big Ten), 29, 31, 0, 60
400598605, 2015-01-31, Delaware State, (10-11; 4-3 MEAC), 24, 50, 0, 74, S Carolina St, (8-15; 6-3 MEAC), 33, 45, 0, 78
400598809, 2015-01-31, AR-Pine Bluff, (7-15; 4-4 SWAC), 20, 45, 0, 65, Grambling St, (2-16; 0-8 SWAC), 22, 31, 0, 53
400591026, 2015-01-31, Southern, (10-13; 7-2 SWAC), 28, 37, 0, 65, Alcorn State, (4-17; 3-6 SWAC), 24, 32, 0, 56
400598624, 2015-01-31, NC A&T, (6-17; 3-6 MEAC), 28, 34, 0, 62, Savannah State, (5-16; 1-6 MEAC), 30, 29, 0, 59
400598829, 2015-01-31, Alabama A&M, (5-13; 4-4 SWAC), 23, 40, 0, 63, PV A&M, (6-15; 4-4 SWAC), 47, 42, 0, 89
400598680, 2015-01-31, Hampton, (8-13; 4-5 MEAC), 22, 38, 0, 60, Norfolk State, (15-9; 8-1 MEAC), 28, 35, 0, 63
400597367, 2015-01-31, Alabama, (13-8; 3-5 SEC), 24, 31, 0, 55, Kentucky, (21-0; 8-0 SEC), 37, 33, 0, 70
400587955, 2015-01-31, Duke, (18-3; 5-3 ACC), 26, 43, 0, 69, UVA, (19-1; 7-1 ACC), 25, 38, 0, 63
400586263, 2015-01-31, St Peter's, (10-13; 4-8 MAAC), 25, 32, 4, 61, Iona, (16-6; 9-2 MAAC), 25, 32, 11, 68
400587167, 2015-01-31, Colgate, (10-13; 7-3 Patriot), 27, 44, 0, 71, Bucknell, (12-11; 7-3 Patriot), 35, 34, 0, 69
400587168, 2015-01-31, Lafayette, (13-8; 5-5 Patriot), 40, 34, 0, 74, Navy, (8-14; 4-6 Patriot), 37, 28, 0, 65
400587529, 2015-01-31, Akron, (15-6; 6-2 MAC), 29, 40, 0, 69, Bowling Green, (13-6; 5-3 MAC), 29, 39, 0, 68
400588751, 2015-01-31, USC Upstate, (16-7; 4-3 A-Sun), 38, 41, 0, 79, North Florida, (14-10; 6-1 A-Sun), 46, 28, 0, 74
400588753, 2015-01-31, N Kentucky, (9-13; 3-4 A-Sun), 31, 33, 0, 64, FGCU, (16-7; 6-1 A-Sun), 44, 30, 0, 74
400589196, 2015-01-31, Furman, (7-14; 4-6 Southern), 29, 29, 0, 58, Samford, (10-14; 3-8 Southern), 29, 39, 0, 68
400589197, 2015-01-31, Mercer, (12-11; 7-3 Southern), 26, 20, 0, 46, Wofford, (18-5; 9-1 Southern), 20, 29, 0, 49
400589389, 2015-01-31, Charleston So, (13-8; 7-3 Big South), 35, 39, 0, 74, Liberty, (6-17; 0-10 Big South), 31, 31, 0, 62
400589390, 2015-01-31, Longwood, (7-16; 3-7 Big South), 35, 36, 0, 71, Presbyterian, (7-16; 3-7 Big South), 27, 40, 0, 67
400591187, 2015-01-31, George Mason, (7-13; 2-6 A 10), 15, 38, 0, 53, Duquesne, (7-13; 2-7 A 10), 22, 40, 0, 62
400591227, 2015-01-31, Brown, (9-12; 0-4 Ivy), 35, 30, 0, 65, Columbia, (10-8; 2-2 Ivy), 39, 47, 0, 86
400591298, 2015-01-31, Harvard, (13-5; 3-1 Ivy), 36, 27, 0, 63, Penn, (6-11; 1-2 Ivy), 15, 23, 0, 38
400591478, 2015-01-31, FIU, (10-10; 3-4 C-USA), 44, 34, 0, 78, Charlotte, (9-12; 3-6 C-USA), 31, 39, 0, 70
400591479, 2015-01-31, FAU, (8-10; 1-6 C-USA), 30, 27, 0, 57, Old Dominion, (17-4; 6-3 C-USA), 29, 39, 0, 68
400595974, 2015-01-31, Hawaii, (15-8; 3-4 Big West), 27, 23, 0, 50, LBSU, (12-11; 6-1 Big West), 26, 39, 0, 65
400597894, 2015-01-31, Elon, (11-12; 3-7 CAA), 25, 36, 0, 61, Northeastern, (15-8; 7-3 CAA), 40, 40, 0, 80
400599769, 2015-01-31, La Salle, (12-9; 4-4 A 10), 29, 37, 0, 66, St Bonaventure, (11-8; 4-4 A 10), 27, 29, 0, 56
400600687, 2015-01-31, NC Central, (16-6; 8-0 MEAC), 35, 24, 0, 59, East Tenn St, (13-8; 6-5 Southern), 28, 33, 0, 61
400595672, 2015-01-31, New Orleans, (6-11; 2-6 Southland), 23, 38, 0, 61, McNeese State, (8-11; 2-6 Southland), 32, 36, 0, 68
400595675, 2015-01-31, Abil Christian, (9-12; 3-5 Southland), 39, 35, 0, 74, Lamar, (11-10; 5-4 Southland), 39, 45, 0, 84
400595676, 2015-01-31, Texas A&M-CC, (11-9; 6-2 Southland), 21, 30, 0, 51, SF Austin, (18-3; 8-0 Southland), 27, 34, 0, 61
400595297, 2015-01-31, AR-Little Rock, (8-13; 3-8 Sun Belt), 28, 33, 0, 61, Ga Southern, (15-4; 8-2 Sun Belt), 33, 43, 0, 76
400585821, 2015-01-31, Oklahoma, (14-7; 5-4 Big 12), 25, 39, 0, 64, Oklahoma State, (14-7; 4-5 Big 12), 32, 24, 0, 56
400586809, 2015-01-31, UCF, (9-12; 2-8 American), 30, 26, 0, 56, SMU, (18-4; 9-1 American), 36, 39, 0, 75
400587327, 2015-01-31, San Francisco, (9-14; 3-8 WCC), 38, 31, 0, 69, San Diego, (12-11; 5-6 WCC), 37, 40, 0, 77
400587532, 2015-01-31, Toledo, (13-8; 5-3 MAC), 35, 45, 0, 80, N Illinois, (8-11; 2-6 MAC), 33, 36, 0, 69
400591482, 2015-01-31, Rice, (6-14; 3-5 C-USA), 45, 20, 0, 65, North Texas, (9-11; 3-5 C-USA), 37, 38, 0, 75
400591659, 2015-01-31, Utah State, (12-9; 5-4 MW), 14, 28, 0, 42, San Diego State, (17-5; 7-2 MW), 21, 41, 0, 62
400595677, 2015-01-31, Northwestern St, (11-9; 6-3 Southland), 45, 43, 0, 88, SE Louisiana, (5-15; 2-5 Southland), 33, 40, 0, 73
400595971, 2015-01-31, CS Northridge, (6-17; 2-6 Big West), 31, 31, 0, 62, UC Riverside, (10-11; 3-4 Big West), 29, 37, 0, 66
400596407, 2015-01-31, SE Missouri St, (10-12; 4-5 OVC), 38, 32, 0, 70, Austin Peay, (7-15; 2-6 OVC), 36, 28, 0, 64
400597907, 2015-01-31, Towson, (11-12; 4-6 CAA), 36, 50, 0, 86, Hofstra, (14-9; 5-5 CAA), 37, 35, 0, 72
400586438, 2015-01-31, S Illinois, (9-14; 2-8 MVC), 19, 27, 0, 46, Missouri State, (9-13; 3-7 MVC), 23, 29, 0, 52
400595301, 2015-01-31, Troy, (8-12; 3-8 Sun Belt), 22, 33, 0, 55, UT-Arlington, (12-9; 6-5 Sun Belt), 32, 22, 0, 54
400596408, 2015-01-31, UT Martin, (13-8; 5-3 OVC), 25, 37, 0, 62, Murray State, (19-4; 9-0 OVC), 36, 29, 0, 65
400591660, 2015-01-31, San Jose State, (2-19; 0-9 MW), 15, 26, 0, 41, New Mexico, (14-7; 6-3 MW), 31, 36, 0, 67
400593291, 2015-01-31, Stanford, (15-6; 6-3 Pac-12), 41, 47, 0, 88, Washington St, (10-11; 4-5 Pac-12), 42, 47, 0, 89
400596409, 2015-01-31, Jacksonville St, (9-15; 2-8 OVC), 22, 21, 0, 43, Tennessee St, (5-18; 2-6 OVC), 19, 26, 0, 45
400598795, 2015-01-31, Alabama State, (11-6; 7-1 SWAC), 34, 31, 0, 65, Texas Southern, (10-11; 7-1 SWAC), 41, 39, 0, 80
400586047, 2015-01-31, Weber State, (9-12; 4-6 Big Sky), 30, 27, 0, 57, N Colorado, (11-9; 6-3 Big Sky), 30, 41, 0, 71
400586051, 2015-01-31, N Arizona, (10-11; 5-3 Big Sky), 47, 34, 0, 81, Southern Utah, (5-14; 2-6 Big Sky), 20, 40, 0, 60
400587328, 2015-01-31, Santa Clara, (11-12; 5-6 WCC), 29, 28, 0, 57, BYU, (17-7; 7-4 WCC), 35, 43, 0, 78
400590808, 2015-01-31, Chicago State, (5-18; 1-5 WAC), 27, 29, 0, 56, Grand Canyon, (12-11; 3-3 WAC), 33, 22, 0, 55
400590809, 2015-01-31, UT Pan American, (8-14; 2-4 WAC), 16, 32, 0, 48, New Mexico St, (13-10; 5-1 WAC), 26, 27, 0, 53
400591481, 2015-01-31, Mid Tennessee, (12-10; 5-4 C-USA), 38, 32, 0, 70, UTEP, (14-7; 6-3 C-USA), 45, 38, 0, 83
400586808, 2015-01-31, Memphis, (13-8; 6-3 American), 25, 39, 0, 64, Gonzaga, (22-1; 10-0 WCC), 43, 39, 0, 82
400590807, 2015-01-31, Seattle, (10-10; 3-3 WAC), 29, 25, 7, 61, CSU Bakersfield, (8-14; 3-3 WAC), 29, 25, 17, 71
400591661, 2015-01-31, Air Force, (9-12; 2-8 MW), 24, 39, 0, 63, UNLV, (13-9; 4-5 MW), 29, 45, 0, 74
400595972, 2015-01-31, Cal Poly, (10-10; 3-5 Big West), 40, 25, 13, 78, UC Davis, (16-4; 6-1 Big West), 30, 35, 16, 81
400595973, 2015-01-31, UCSB, (10-11; 3-4 Big West), 26, 29, 0, 55, UC Irvine, (13-8; 6-1 Big West), 36, 41, 0, 77
400586048, 2015-01-31, Montana State, (4-17; 1-8 Big Sky), 35, 27, 0, 62, Portland State, (11-9; 5-5 Big Sky), 47, 33, 0, 80
400586050, 2015-01-31, Montana, (11-9; 7-2 Big Sky), 30, 39, 0, 69, Sacramento St, (15-6; 9-1 Big Sky), 32, 38, 0, 70
400590810, 2015-01-31, UMKC, (9-14; 4-2 WAC), 26, 40, 0, 66, Utah Valley, (8-12; 3-3 WAC), 27, 32, 0, 59
400593292, 2015-01-31, Colorado, (11-10; 4-5 Pac-12), 23, 36, 0, 59, UCLA, (13-9; 5-4 Pac-12), 27, 45, 0, 72
400587957, 2015-02-01, Miami (FL), (14-7; 4-4 ACC), 36, 18, 0, 54, FSU, (12-10; 4-5 ACC), 25, 30, 0, 55
400597813, 2015-02-01, Oakland, (11-12; 6-2 Horizon), 49, 47, 0, 96, Youngstown St, (10-15; 1-9 Horizon), 42, 38, 0, 80
400586810, 2015-02-01, Cincinnati, (15-6; 6-3 American), 23, 23, 0, 46, ECU, (9-12; 2-6 American), 18, 32, 0, 50
400595496, 2015-02-01, Michigan, (13-9; 6-4 Big Ten), 24, 42, 0, 66, Michigan State, (15-7; 6-3 Big Ten), 29, 37, 10, 76
400586264, 2015-02-01, Manhattan, (11-10; 8-4 MAAC), 42, 45, 0, 87, Monmouth, (12-11; 8-4 MAAC), 24, 52, 0, 76
400586265, 2015-02-01, Marist, (4-18; 3-9 MAAC), 41, 34, 0, 75, Canisius, (12-9; 7-5 MAAC), 35, 32, 0, 67
400586277, 2015-02-01, Quinnipiac, (11-10; 5-7 MAAC), 39, 43, 18, 100, Niagara, (4-17; 3-9 MAAC), 41, 41, 23, 105
400591188, 2015-02-01, Fordham, (5-14; 0-8 A 10), 30, 47, 0, 77, Dayton, (17-4; 7-2 A 10), 47, 54, 0, 101
400593293, 2015-02-01, Utah, (17-4; 7-2 Pac-12), 32, 35, 0, 67, USC, (9-12; 1-8 Pac-12), 12, 27, 0, 39
400586811, 2015-02-01, UConn, (11-9; 4-4 American), 25, 43, 0, 68, Houston, (9-12; 1-8 American), 28, 42, 0, 70
400586991, 2015-02-01, North Dakota St, (15-7; 7-2 Summit), 36, 28, 0, 64, W Illinois, (8-12; 3-6 Summit), 29, 33, 0, 62
400593294, 2015-02-01, Cal, (13-9; 3-6 Pac-12), 43, 47, 0, 90, Washington, (14-7; 3-6 Pac-12), 41, 47, 0, 88
400587959, 2015-02-02, UVA, (20-1; 8-1 ACC), 32, 43, 0, 75, UNC, (17-6; 7-3 ACC), 33, 31, 0, 64
400587958, 2015-02-02, Bryant, (10-11; 7-3 NEC), 36, 31, 0, 67, Pitt, (15-8; 4-5 ACC), 34, 38, 0, 72
400598630, 2015-02-02, Hampton, (8-14; 4-5 MEAC), 29, 38, 0, 67, NJIT, (13-10; 7-1 home), 45, 41, 0, 86
400598669, 2015-02-02, Morgan State, (4-18; 2-6 MEAC), 30, 37, 0, 67, Coppin State, (4-18; 3-6 MEAC), 41, 39, 0, 80
400601259, 2015-02-02, Rider, (14-9; 8-4 MAAC), 34, 38, 0, 72, Siena, (9-12; 6-6 MAAC), 32, 47, 0, 79
400587169, 2015-02-02, American U, (12-10; 5-5 Patriot), 18, 39, 0, 57, Holy Cross, (8-12; 3-7 Patriot), 23, 27, 0, 50
400595678, 2015-02-02, New Orleans, (6-12; 2-7 Southland), 28, 27, 0, 55, Nicholls State, (6-13; 3-6 Southland), 34, 33, 0, 67
400595679, 2015-02-02, Lamar, (11-11; 5-5 Southland), 22, 28, 0, 50, Sam Houston, (17-5; 9-1 Southland), 37, 42, 0, 79
400598633, 2015-02-02, Florida A&M, (0-22; 0-9 MEAC), 20, 23, 0, 43, NC Central, (17-6; 9-0 MEAC), 42, 43, 0, 85
400589391, 2015-02-02, Charleston So, (13-9; 7-4 Big South), 26, 29, 0, 55, Winthrop, (12-10; 7-4 Big South), 42, 35, 0, 77
400595680, 2015-02-02, Abil Christian, (9-13; 3-6 Southland), 27, 34, 0, 61, Houston Baptist, (10-9; 5-4 Southland), 30, 47, 0, 77
400595681, 2015-02-02, McNeese State, (9-11; 3-6 Southland), 34, 39, 0, 73, SE Louisiana, (5-16; 2-6 Southland), 35, 25, 0, 60
400597776, 2015-02-02, Green Bay, (18-5; 7-2 Horizon), 37, 34, 0, 71, Wright State, (11-12; 3-6 Horizon), 25, 33, 0, 58
400598632, 2015-02-02, MD-E Shore, (13-11; 6-3 MEAC), 33, 41, 0, 74, Howard, (12-10; 6-2 MEAC), 33, 50, 0, 83
400598810, 2015-02-02, Miss Valley St, (4-18; 3-6 SWAC), 39, 29, 0, 68, Grambling St, (2-17; 0-9 SWAC), 24, 41, 0, 65
400591051, 2015-02-02, AR-Pine Bluff, (7-16; 4-5 SWAC), 23, 22, 0, 45, Jackson State, (6-16; 4-5 SWAC), 21, 48, 0, 69
400598796, 2015-02-02, Alabama State, (12-6; 8-1 SWAC), 37, 36, 0, 73, PV A&M, (6-16; 4-5 SWAC), 36, 35, 0, 71
400585822, 2015-02-02, Iowa State, (16-5; 6-3 Big 12), 28, 48, 0, 76, Kansas, (19-3; 8-1 Big 12), 35, 54, 0, 89
400598835, 2015-02-02, Alabama A&M, (5-14; 4-5 SWAC), 29, 32, 4, 65, Texas Southern, (11-11; 8-1 SWAC), 29, 32, 7, 68
400586268, 2015-02-02, Iona, (26-8; 17-3 MAAC),  ,  , 0, 0, Fairfield, (7-24; 5-15 MAAC),  ,  , 0, 0
400597368, 2015-02-03, Georgia, (14-7; 5-4 SEC), 27, 31, 0, 58, Kentucky, (22-0; 9-0 SEC), 42, 27, 0, 69
400595497, 2015-02-03, Indiana, (16-7; 6-4 Big Ten), 36, 42, 0, 78, Wisconsin, (20-2; 8-1 Big Ten), 44, 48, 0, 92
400588441, 2015-02-03, St John's, (14-8; 3-6 Big East), 28, 34, 0, 62, Butler, (17-6; 7-3 Big East), 36, 49, 0, 85
400588754, 2015-02-03, Non D-I School, NA, 18, 21, 0, 39, USC Upstate, (17-7; 4-3 A-Sun), 51, 28, 0, 79
400588756, 2015-02-03, Paine,  , 37, 38, 0, 75, Kennesaw St, (8-16; 2-5 A-Sun), 32, 48, 0, 80
400589392, 2015-02-03, Presbyterian, (7-17; 3-8 Big South), 23, 30, 0, 53, Campbell, (9-15; 3-8 Big South), 30, 36, 0, 66
400589393, 2015-02-03, UNC Asheville, (11-11; 7-4 Big South), 27, 29, 0, 56, Coast Carolina, (16-7; 7-4 Big South), 27, 41, 0, 68
400589394, 2015-02-03, Gardner-Webb, (15-9; 7-4 Big South), 38, 49, 0, 87, Longwood, (7-17; 3-8 Big South), 37, 41, 0, 78
400589395, 2015-02-03, Radford, (17-7; 8-3 Big South), 40, 27, 0, 67, High Point, (17-6; 8-3 Big South), 29, 35, 0, 64
400596480, 2015-02-03, Hartford, (12-11; 5-5 Am. East), 30, 32, 0, 62, Binghamton, (4-21; 3-7 Am. East), 24, 37, 0, 61
400596528, 2015-02-03, Maine, (2-21; 1-9 Am. East), 20, 29, 0, 49, UVM, (13-10; 8-2 Am. East), 40, 28, 0, 68
400597369, 2015-02-03, Miss St, (11-11; 4-5 SEC), 32, 39, 0, 71, Tennessee, (13-8; 5-4 SEC), 30, 36, 0, 66
400586442, 2015-02-03, Northern Iowa, (21-2; 10-1 MVC), 33, 28, 0, 61, Indiana State, (11-12; 7-4 MVC), 22, 29, 0, 51
400588755, 2015-02-03, Stetson, (8-15; 2-5 A-Sun), 36, 41, 0, 77, Bethune-Cookman, (7-16; 3-5 MEAC), 42, 30, 0, 72
400591466, 2015-02-03, FAU, (8-11; 1-7 C-USA), 16, 40, 0, 56, FIU, (11-10; 4-4 C-USA), 36, 28, 0, 64
400595498, 2015-02-03, Northwestern, (10-12; 1-8 Big Ten), 33, 27, 0, 60, Nebraska, (13-9; 5-5 Big Ten), 35, 41, 0, 76
400599928, 2015-02-03, Saint Joe's, (9-12; 3-6 A 10), 30, 27, 4, 61, Saint Louis, (10-12; 2-7 A 10), 25, 32, 11, 68
400587960, 2015-02-03, Louisville, (19-3; 7-2 ACC), 35, 28, 0, 63, Miami (FL), (14-8; 4-5 ACC), 26, 29, 0, 55
400585823, 2015-02-03, West Virginia, (18-4; 6-3 Big 12), 24, 28, 0, 52, Oklahoma, (15-7; 6-4 Big 12), 38, 33, 0, 71
400586441, 2015-02-03, Evansville, (16-7; 6-5 MVC), 24, 27, 0, 51, Illinois State, (15-8; 7-4 MVC), 43, 34, 0, 77
400587961, 2015-02-03, NC State, (14-10; 5-6 ACC), 30, 54, 0, 84, Wake Forest, (11-12; 3-7 ACC), 51, 37, 0, 88
400589198, 2015-02-03, UNC Greensboro, (7-17; 3-8 Southern), 38, 47, 0, 85, VMI, (8-15; 4-8 Southern), 23, 33, 0, 56
400595682, 2015-02-03, Northwestern St, (12-9; 7-3 Southland), 52, 58, 0, 110, Cent Arkansas, (0-19; 0-8 Southland), 47, 61, 0, 108
400595683, 2015-02-03, Incarnate Word, (12-6; 4-4 Southland), 38, 32, 0, 70, Texas A&M-CC, (12-9; 7-2 Southland), 29, 42, 0, 71
400596411, 2015-02-03, Non D-I School, NA, 14, 18, 0, 32, E Illinois, (14-9; 7-3 OVC), 29, 30, 0, 59
400598634, 2015-02-03, Delaware State, (10-12; 4-3 MEAC), 24, 27, 0, 51, NJIT, (14-10; 8-1 home), 38, 31, 0, 69
400587962, 2015-02-03, VT, (9-13; 1-8 ACC), 30, 40, 0, 70, Syracuse, (15-7; 6-3 ACC), 34, 38, 0, 72
400597370, 2015-02-03, Florida, (12-10; 5-4 SEC), 23, 38, 0, 61, Vanderbilt, (12-10; 2-7 SEC), 31, 36, 0, 67
400597371, 2015-02-03, South Carolina, (11-10; 2-7 SEC), 28, 27, 0, 55, Arkansas, (17-5; 6-3 SEC), 35, 40, 0, 75
400588442, 2015-02-03, Seton Hall, (15-7; 5-5 Big East), 33, 29, 0, 62, DePaul, (12-12; 6-5 Big East), 35, 40, 0, 75
400591662, 2015-02-03, Boise State, (16-6; 6-3 MW), 33, 35, 0, 68, Utah State, (12-10; 5-5 MW), 28, 35, 0, 63
400595499, 2015-02-03, Rutgers, (10-14; 2-9 Big Ten), 24, 30, 0, 54, Illinois, (15-8; 5-5 Big Ten), 35, 31, 0, 66
400595500, 2015-02-04, OSU, (17-6; 6-4 Big Ten), 26, 32, 0, 58, Purdue, (15-8; 7-3 Big Ten), 27, 33, 0, 60
400586812, 2015-02-04, Temple, (16-7; 7-3 American), 23, 38, 0, 61, USF, (7-16; 1-9 American), 24, 24, 0, 48
400587963, 2015-02-04, Georgia Tech, (10-12; 1-9 ACC), 34, 32, 0, 66, Duke, (19-3; 6-3 ACC), 38, 34, 0, 72
400588443, 2015-02-04, Marquette, (10-12; 2-8 Big East), 19, 33, 0, 52, Villanova, (20-2; 7-2 Big East), 36, 34, 0, 70
400587964, 2015-02-04, Boston College, (9-12; 1-8 ACC), 25, 38, 0, 63, Notre Dame, (21-3; 9-2 ACC), 41, 30, 0, 71
400599606, 2015-02-04, VCU, (18-4; 8-1 A 10), 32, 40, 0, 72, George Mason, (7-14; 2-7 A 10), 34, 26, 0, 60
400586813, 2015-02-04, ECU, (9-13; 2-7 American), 34, 18, 0, 52, UConn, (12-9; 5-4 American), 27, 38, 0, 65
400587170, 2015-02-04, Army, (14-8; 5-6 Patriot), 36, 38, 0, 74, Lehigh, (12-10; 6-5 Patriot), 61, 42, 0, 103
400587171, 2015-02-04, Bucknell, (12-12; 7-4 Patriot), 38, 29, 7, 74, Lafayette, (14-8; 6-5 Patriot), 23, 44, 17, 84
400587172, 2015-02-04, Navy, (8-15; 4-7 Patriot), 19, 40, 0, 59, Boston U, (9-13; 5-6 Patriot), 24, 38, 0, 62
400587535, 2015-02-04, E Michigan, (14-8; 3-6 MAC), 25, 35, 0, 60, Toledo, (14-8; 6-3 MAC), 40, 44, 0, 84
400587536, 2015-02-04, Kent State, (15-7; 6-3 MAC), 28, 38, 0, 66, W Michigan, (14-8; 5-4 MAC), 27, 40, 0, 67
400587537, 2015-02-04, Bowling Green, (14-6; 6-3 MAC), 28, 34, 14, 76, Cent Michigan, (15-5; 5-4 MAC), 30, 32, 12, 74
400587538, 2015-02-04, N Illinois, (9-11; 3-6 MAC), 27, 42, 0, 69, Miami (OH), (8-14; 3-6 MAC), 33, 34, 0, 67
400587539, 2015-02-04, Akron, (15-7; 6-3 MAC), 47, 35, 0, 82, Ohio, (8-12; 3-6 MAC), 37, 46, 0, 83
400587540, 2015-02-04, Buffalo, (15-6; 6-3 MAC), 40, 42, 0, 82, Ball State, (7-13; 2-7 MAC), 30, 48, 0, 78
400589396, 2015-02-04, Liberty, (6-18; 0-11 Big South), 21, 40, 0, 61, Winthrop, (13-10; 8-4 Big South), 33, 41, 0, 74
400591189, 2015-02-04, UMass, (13-9; 6-3 A 10), 35, 43, 0, 78, Fordham, (5-15; 0-9 A 10), 41, 31, 0, 72
400591190, 2015-02-04, St Bonaventure, (12-8; 5-4 A 10), 29, 33, 0, 62, Davidson, (14-6; 5-4 A 10), 33, 28, 0, 61
400596462, 2015-02-04, UNH, (13-10; 6-4 Am. East), 31, 31, 0, 62, Albany, (15-7; 10-0 Am. East), 34, 29, 0, 63
400597372, 2015-02-04, Texas A&M, (15-6; 6-3 SEC), 32, 27, 0, 59, Ole Miss, (15-7; 6-3 SEC), 33, 36, 0, 69
400597741, 2015-02-04, Youngstown St, (10-16; 1-10 Horizon), 28, 32, 0, 60, Cleveland State, (14-10; 8-2 Horizon), 37, 36, 0, 73
400597862, 2015-02-04, Hofstra, (15-9; 6-5 CAA), 33, 46, 0, 79, Delaware, (5-17; 4-7 CAA), 25, 44, 0, 69
400597919, 2015-02-04, UNC-Wilmington, (13-9; 8-3 CAA), 37, 40, 0, 77, JMU, (13-11; 6-5 CAA), 23, 42, 0, 65
400597934, 2015-02-04, Towson, (11-13; 4-7 CAA), 26, 36, 0, 62, Northeastern, (16-8; 8-3 CAA), 39, 30, 0, 69
400598635, 2015-02-04, NC A&T, (6-18; 3-6 MEAC), 33, 28, 0, 61, Charlotte, (10-12; 3-6 C-USA), 31, 46, 0, 77
400598636, 2015-02-04, Non D-I School, NA, 19, 29, 0, 48, S Carolina St, (9-15; 6-3 MEAC), 33, 47, 0, 80
400586445, 2015-02-04, Wichita State, (20-3; 10-1 MVC), 35, 27, 0, 62, Bradley, (7-17; 2-9 MVC), 22, 37, 0, 59
400585824, 2015-02-04, Oklahoma State, (15-7; 5-5 Big 12), 35, 21, 9, 65, Texas, (14-8; 3-6 Big 12), 24, 32, 7, 63
400586814, 2015-02-04, Jacksonville St, (9-16; 2-8 OVC), 24, 24, 0, 48, Memphis, (14-8; 6-3 American), 34, 40, 0, 74
400587173, 2015-02-04, Loyola (MD), (9-13; 5-6 Patriot), 25, 24, 0, 49, American U, (13-10; 6-5 Patriot), 42, 22, 0, 64
400586444, 2015-02-04, S Illinois, (9-15; 2-9 MVC), 29, 32, 0, 61, Drake, (7-16; 4-7 MVC), 31, 32, 0, 63
400597761, 2015-02-04, Detroit, (11-14; 4-6 Horizon), 25, 45, 0, 70, Valparaiso, (21-4; 8-2 Horizon), 31, 47, 0, 78
400595501, 2015-02-04, Penn State, (14-9; 2-8 Big Ten), 28, 30, 0, 58, Maryland, (19-4; 7-3 Big Ten), 29, 35, 0, 64
400585825, 2015-02-04, TCU, (14-8; 1-8 Big 12), 29, 28, 0, 57, Baylor, (17-5; 5-4 Big 12), 37, 40, 0, 77
400595302, 2015-02-04, Texas State, (11-10; 5-7 Sun Belt), 36, 27, 0, 63, South Alabama, (7-16; 5-7 Sun Belt), 18, 25, 0, 43
400597790, 2015-02-04, Oakland, (12-12; 7-2 Horizon), 41, 50, 0, 91, UIC, (5-19; 1-8 Horizon), 40, 37, 0, 77
400588445, 2015-02-04, Providence, (17-6; 7-3 Big East), 38, 36, 0, 74, Georgetown, (15-7; 7-4 Big East), 41, 30, 0, 71
400585826, 2015-02-04, Kansas State, (12-11; 5-5 Big 12), 26, 21, 0, 47, Texas Tech, (12-11; 2-8 Big 12), 34, 30, 0, 64
400586443, 2015-02-04, Loyola (CHI), (14-9; 4-7 MVC), 31, 22, 0, 53, Missouri State, (9-14; 3-8 MVC), 19, 31, 0, 50
400587965, 2015-02-04, Clemson, (14-8; 6-4 ACC), 27, 35, 0, 62, FSU, (12-11; 4-6 ACC), 21, 35, 0, 56
400588444, 2015-02-04, Creighton, (11-13; 2-9 Big East), 32, 33, 14, 79, Xavier, (14-9; 5-6 Big East), 29, 36, 7, 72
400591664, 2015-02-04, New Mexico, (14-8; 6-4 MW), 26, 23, 0, 49, Air Force, (10-12; 3-8 MW), 28, 25, 0, 53
400591665, 2015-02-04, Colorado State, (19-4; 6-4 MW), 15, 33, 0, 48, Wyoming, (19-4; 8-2 MW), 26, 33, 0, 59
400593295, 2015-02-04, Washington, (14-8; 3-7 Pac-12), 37, 37, 0, 74, Oregon, (16-7; 6-4 Pac-12), 42, 36, 0, 78
400597373, 2015-02-04, Missouri, (7-15; 1-8 SEC), 24, 25, 0, 49, Alabama, (14-8; 4-5 SEC), 26, 36, 0, 62
400591663, 2015-02-04, San Jose State, (2-20; 0-10 MW), 31, 32, 0, 63, Fresno State, (11-12; 6-4 MW), 37, 44, 0, 81
400591666, 2015-02-04, San Diego State, (18-5; 8-2 MW), 30, 35, 0, 65, Nevada, (6-15; 2-7 MW), 28, 35, 0, 63
400589199, 2015-02-05, Mercer, (13-11; 8-3 Southern), 33, 43, 0, 76, The Citadel, (8-14; 3-8 Southern), 21, 32, 0, 53
400599770, 2015-02-05, Richmond, (12-10; 5-4 A 10), 26, 36, 0, 62, La Salle, (13-9; 5-4 A 10), 40, 24, 0, 64
400586227, 2015-02-05, Monmouth, (12-12; 8-5 MAAC), 21, 31, 0, 52, Quinnipiac, (12-10; 6-7 MAAC), 34, 38, 0, 72
400586815, 2015-02-05, Tulsa, (17-5; 10-0 American), 29, 28, 0, 57, Houston, (9-13; 1-9 American), 34, 10, 0, 44
400586992, 2015-02-05, South Dakota St, (17-8; 8-3 Summit), 28, 46, 0, 74, IPFW, (12-11; 5-5 Summit), 32, 52, 0, 84
400586993, 2015-02-05, Oral Roberts, (13-10; 6-3 Summit), 26, 52, 0, 78, IUPUI, (8-15; 4-5 Summit), 25, 43, 0, 68
400587174, 2015-02-05, Colgate, (10-14; 7-4 Patriot), 36, 24, 0, 60, Holy Cross, (9-12; 4-7 Patriot), 27, 43, 0, 70
400589200, 2015-02-05, Wofford, (19-5; 10-1 Southern), 31, 43, 0, 74, East Tenn St, (13-9; 6-6 Southern), 25, 39, 0, 64
400589201, 2015-02-05, Chattanooga, (16-8; 9-2 Southern), 36, 29, 9, 74, Furman, (7-15; 4-7 Southern), 36, 29, 6, 71
400589202, 2015-02-05, Samford, (11-14; 4-8 Southern), 26, 50, 0, 76, W Carolina, (11-13; 6-6 Southern), 35, 37, 0, 72
400591488, 2015-02-05, Rice, (6-15; 3-6 C-USA), 24, 31, 0, 55, Marshall, (7-16; 3-7 C-USA), 28, 41, 0, 69
400591724, 2015-02-05, Mt St Mary's, (10-12; 6-5 NEC), 34, 19, 0, 53, Bryant, (11-11; 8-3 NEC), 32, 23, 0, 55
400591747, 2015-02-05, St Francis (BKN), (15-9; 9-2 NEC), 33, 57, 0, 90, Cent Conn St, (3-21; 1-10 NEC), 37, 44, 0, 81
400591782, 2015-02-05, Robert Morris, (11-12; 7-4 NEC), 27, 38, 0, 65, LIU Brooklyn, (9-13; 5-6 NEC), 24, 48, 0, 72
400595502, 2015-02-05, Iowa, (14-8; 5-4 Big Ten), 31, 41, 0, 72, Michigan, (13-10; 6-5 Big Ten), 21, 33, 0, 54
400596026, 2015-02-05, Wagner, (8-14; 6-5 NEC), 31, 44, 0, 75, Sacred Heart, (10-14; 4-7 NEC), 42, 44, 0, 86
400596415, 2015-02-05, Tennessee St, (5-19; 2-7 OVC), 24, 33, 0, 57, Morehead State, (11-14; 6-4 OVC), 34, 38, 0, 72
400596540, 2015-02-05, UMBC, (3-19; 1-8 Am. East), 34, 17, 0, 51, UMass Lowell, (10-13; 4-6 Am. East), 35, 32, 0, 67
400597374, 2015-02-05, Auburn, (11-11; 3-6 SEC), 41, 40, 0, 81, LSU, (16-6; 5-4 SEC), 39, 38, 0, 77
400597879, 2015-02-05, Drexel, (8-14; 6-5 CAA), 31, 36, 0, 67, Elon, (11-13; 3-8 CAA), 26, 37, 0, 63
400591485, 2015-02-05, UTSA, (11-10; 5-5 C-USA), 26, 48, 0, 74, FIU, (11-11; 4-5 C-USA), 35, 28, 0, 63
400595304, 2015-02-05, Georgia State, (15-8; 8-4 Sun Belt), 25, 29, 0, 54, Ga Southern, (16-4; 9-2 Sun Belt), 19, 39, 0, 58
400597845, 2015-02-05, William & Mary, (14-8; 8-3 CAA), 32, 40, 0, 72, Charleston, (7-17; 2-9 CAA), 35, 45, 0, 80
400586269, 2015-02-05, Fairfield, (6-16; 4-8 MAAC), 13, 30, 9, 52, Rider, (15-9; 9-4 MAAC), 20, 23, 11, 54
400586994, 2015-02-05, Omaha, (8-14; 2-8 Summit), 33, 24, 0, 57, North Dakota St, (16-7; 8-2 Summit), 28, 36, 0, 64
400586995, 2015-02-05, W Illinois, (8-13; 3-7 Summit), 34, 27, 0, 61, South Dakota, (11-13; 5-5 Summit), 35, 40, 0, 75
400590811, 2015-02-05, New Mexico St, (14-10; 6-1 WAC), 31, 26, 12, 69, Chicago State, (5-19; 1-6 WAC), 21, 36, 4, 61
400590813, 2015-02-05, UT Pan American, (8-15; 2-5 WAC), 19, 26, 0, 45, UMKC, (10-14; 5-2 WAC), 34, 36, 0, 70
400591486, 2015-02-05, UTEP, (15-7; 7-3 C-USA), 27, 36, 0, 63, FAU, (8-12; 1-8 C-USA), 27, 29, 0, 56
400591489, 2015-02-05, Southern Miss, (6-15; 1-9 C-USA), 23, 28, 0, 51, Mid Tennessee, (13-10; 6-4 C-USA), 33, 28, 0, 61
400591490, 2015-02-05, North Texas, (9-12; 3-6 C-USA), 25, 34, 0, 59, W Kentucky, (16-6; 9-1 C-USA), 34, 31, 0, 65
400597777, 2015-02-05, Milwaukee, (9-15; 4-6 Horizon), 20, 50, 0, 70, Green Bay, (19-5; 8-2 Horizon), 42, 39, 0, 81
400596412, 2015-02-05, SE Missouri St, (10-13; 4-6 OVC), 31, 41, 0, 72, Murray State, (20-4; 10-0 OVC), 36, 46, 0, 82
400586054, 2015-02-05, N Colorado, (11-10; 6-4 Big Sky), 25, 35, 0, 60, N Arizona, (11-11; 6-3 Big Sky), 29, 36, 0, 65
400595303, 2015-02-05, Troy, (9-12; 4-8 Sun Belt), 42, 27, 0, 69, Arkansas State, (9-13; 4-9 Sun Belt), 24, 40, 0, 64
400595306, 2015-02-05, Appalachian St, (8-12; 5-6 Sun Belt), 41, 25, 0, 66, LA-Lafayette, (13-10; 7-5 Sun Belt), 48, 33, 0, 81
400596413, 2015-02-05, UT Martin, (14-8; 6-3 OVC), 29, 47, 0, 76, Austin Peay, (7-16; 2-7 OVC), 24, 40, 0, 64
400586816, 2015-02-05, Cincinnati, (16-6; 7-3 American), 20, 42, 0, 62, SMU, (18-5; 9-2 American), 25, 29, 0, 54
400586052, 2015-02-05, North Dakota, (8-13; 4-6 Big Sky), 41, 34, 14, 89, Southern Utah, (5-15; 2-7 Big Sky), 28, 47, 10, 85
400586055, 2015-02-05, E Washington, (17-5; 8-1 Big Sky), 33, 42, 0, 75, Montana, (11-10; 7-3 Big Sky), 29, 40, 0, 69
400587331, 2015-02-05, Portland, (13-10; 4-7 WCC), 33, 36, 0, 69, San Francisco, (9-15; 3-9 WCC), 36, 21, 0, 57
400591487, 2015-02-05, LA Tech, (17-6; 8-2 C-USA), 37, 23, 0, 60, UAB, (12-11; 8-2 C-USA), 44, 36, 0, 80
400591766, 2015-02-05, St Francis (PA), (13-9; 7-4 NEC), 27, 37, 0, 64, Fair Dickinson, (7-15; 2-9 NEC), 26, 34, 0, 60
400593296, 2015-02-05, UCLA, (14-9; 6-4 Pac-12), 31, 38, 0, 69, Stanford, (15-7; 6-4 Pac-12), 25, 42, 0, 67
400595305, 2015-02-05, UL Monroe, (15-8; 9-3 Sun Belt), 37, 40, 0, 77, AR-Little Rock, (8-14; 3-9 Sun Belt), 27, 34, 0, 61
400596414, 2015-02-05, Belmont, (15-8; 7-3 OVC), 29, 40, 0, 69, E Kentucky, (13-9; 5-4 OVC), 40, 41, 0, 81
400586053, 2015-02-05, Idaho, (9-11; 4-5 Big Sky), 38, 42, 0, 80, Montana State, (4-18; 1-9 Big Sky), 39, 32, 0, 71
400587332, 2015-02-05, San Diego, (12-12; 5-7 WCC), 28, 33, 0, 61, Loyola Mary, (8-16; 4-8 WCC), 38, 32, 0, 70
400590812, 2015-02-05, Utah Valley, (8-13; 3-4 WAC), 27, 42, 0, 69, CSU Bakersfield, (9-14; 4-3 WAC), 36, 36, 0, 72
400590814, 2015-02-05, Grand Canyon, (13-11; 4-3 WAC), 36, 30, 0, 66, Seattle, (10-11; 3-4 WAC), 34, 30, 0, 64
400593297, 2015-02-05, Washington St, (10-12; 4-6 Pac-12), 32, 18, 0, 50, Oregon State, (15-7; 6-4 Pac-12), 30, 25, 0, 55
400595975, 2015-02-05, CS Northridge, (6-18; 2-7 Big West), 31, 22, 0, 53, CS Fullerton, (9-13; 1-6 Big West), 35, 34, 0, 69
400595976, 2015-02-05, UC Davis, (17-4; 7-1 Big West), 35, 40, 0, 75, UC Irvine, (13-9; 6-2 Big West), 25, 31, 0, 56
400595977, 2015-02-05, UC Riverside, (10-12; 3-5 Big West), 29, 34, 0, 63, LBSU, (13-11; 7-1 Big West), 32, 36, 0, 68
400595978, 2015-02-05, Hawaii, (16-8; 4-4 Big West), 26, 33, 0, 59, Cal Poly, (10-11; 3-6 Big West), 28, 28, 0, 56
400587329, 2015-02-05, Gonzaga, (23-1; 11-0 WCC), 34, 43, 0, 77, Santa Clara, (11-13; 5-7 WCC), 36, 27, 0, 63
400587330, 2015-02-05, BYU, (17-8; 7-5 WCC), 38, 36, 0, 74, Pepperdine, (15-8; 8-4 WCC), 25, 55, 0, 80
400593298, 2015-02-05, USC, (9-13; 1-9 Pac-12), 26, 43, 0, 69, Cal, (14-9; 4-6 Pac-12), 35, 35, 0, 70
400586271, 2015-02-06, Niagara, (4-18; 3-10 MAAC), 33, 28, 0, 61, Marist, (5-18; 4-9 MAAC), 32, 31, 0, 63
400586272, 2015-02-06, Siena, (9-13; 6-7 MAAC), 42, 41, 0, 83, Iona, (17-6; 10-2 MAAC), 46, 41, 0, 87
400586273, 2015-02-06, Canisius, (12-10; 7-6 MAAC), 28, 41, 0, 69, Manhattan, (12-10; 9-4 MAAC), 30, 48, 0, 78
400588757, 2015-02-06, Jacksonville, (7-18; 1-7 A-Sun), 25, 25, 0, 50, North Florida, (15-10; 7-1 A-Sun), 36, 41, 0, 77
400589397, 2015-02-06, Campbell, (9-16; 3-9 Big South), 25, 29, 11, 65, Gardner-Webb, (16-9; 8-4 Big South), 21, 33, 19, 73
400589398, 2015-02-06, Charleston So, (14-9; 8-4 Big South), 32, 47, 0, 79, Radford, (17-8; 8-4 Big South), 36, 35, 0, 71
400589400, 2015-02-06, Liberty, (6-19; 0-12 Big South), 31, 30, 0, 61, Presbyterian, (8-17; 4-8 Big South), 34, 35, 0, 69
400589401, 2015-02-06, Longwood, (7-18; 3-9 Big South), 33, 23, 0, 56, UNC Asheville, (12-11; 8-4 Big South), 23, 48, 0, 71
400591191, 2015-02-06, Dayton, (17-5; 7-3 A 10), 21, 35, 8, 64, G Washington, (17-6; 7-3 A 10), 24, 32, 9, 65
400591228, 2015-02-06, Harvard, (14-5; 4-1 Ivy), 36, 28, 12, 76, Brown, (9-13; 0-5 Ivy), 30, 34, 10, 74
400591249, 2015-02-06, Princeton, (10-10; 3-1 Ivy), 33, 41, 0, 74, Columbia, (10-9; 2-3 Ivy), 31, 31, 0, 62
400591286, 2015-02-06, Dartmouth, (8-11; 1-4 Ivy), 21, 45, 0, 66, Yale, (16-6; 5-0 Ivy), 35, 46, 0, 81
400591264, 2015-02-06, Penn, (7-11; 2-2 Ivy), 27, 44, 0, 71, Cornell, (10-11; 2-3 Ivy), 35, 34, 0, 69
400589399, 2015-02-06, High Point, (17-7; 8-4 Big South), 31, 29, 0, 60, Coast Carolina, (17-7; 8-4 Big South), 23, 42, 0, 65
400585827, 2015-02-07, Baylor, (18-5; 6-4 Big 12), 46, 41, 0, 87, West Virginia, (18-5; 6-4 Big 12), 30, 39, 0, 69
400587966, 2015-02-07, Wake Forest, (11-13; 3-8 ACC), 22, 37, 0, 59, Georgia Tech, (11-12; 2-9 ACC), 34, 39, 0, 73
400588446, 2015-02-07, Creighton, (11-14; 2-10 Big East), 30, 36, 0, 66, St John's, (15-8; 4-6 Big East), 52, 32, 0, 84
400588447, 2015-02-07, Marquette, (11-12; 3-8 Big East), 30, 27, 0, 57, Seton Hall, (15-8; 5-6 Big East), 22, 32, 0, 54
400595503, 2015-02-07, Illinois, (16-8; 6-5 Big Ten), 28, 31, 0, 59, Michigan State, (15-8; 6-4 Big Ten), 27, 27, 0, 54
400597375, 2015-02-07, Tennessee, (13-9; 5-5 SEC), 22, 31, 0, 53, Georgia, (15-7; 6-4 SEC), 29, 27, 0, 56
400597863, 2015-02-07, Delaware, (6-17; 5-7 CAA), 29, 44, 0, 73, Northeastern, (16-9; 8-4 CAA), 25, 43, 0, 68
400587967, 2015-02-07, Notre Dame, (21-4; 9-3 ACC), 24, 36, 0, 60, Duke, (20-3; 7-3 ACC), 50, 40, 0, 90
400586817, 2015-02-07, Temple, (17-7; 8-3 American), 28, 33, 0, 61, Memphis, (14-9; 6-4 American), 38, 22, 0, 60
400586998, 2015-02-07, South Dakota St, (18-8; 9-3 Summit), 29, 34, 0, 63, IUPUI, (8-16; 4-6 Summit), 23, 33, 0, 56
400588448, 2015-02-07, Providence, (17-7; 7-4 Big East), 40, 29, 0, 69, Xavier, (15-9; 6-6 Big East), 34, 44, 0, 78
400589203, 2015-02-07, UNC Greensboro, (8-17; 4-8 Southern), 36, 43, 0, 79, The Citadel, (8-15; 3-9 Southern), 37, 26, 0, 63
400589206, 2015-02-07, Wofford, (20-5; 11-1 Southern), 42, 23, 0, 65, VMI, (8-16; 4-9 Southern), 24, 38, 0, 62
400596481, 2015-02-07, Binghamton, (4-22; 3-8 Am. East), 24, 40, 0, 64, Maine, (3-21; 2-9 Am. East), 37, 30, 0, 67
400597713, 2015-02-07, UMBC, (3-20; 1-9 Am. East), 18, 28, 0, 46, UNH, (14-10; 7-4 Am. East), 41, 39, 0, 80
400588449, 2015-02-07, Georgetown, (15-8; 7-5 Big East), 23, 30, 0, 53, Villanova, (21-2; 8-2 Big East), 37, 32, 0, 69
400585829, 2015-02-07, Kansas, (19-4; 8-2 Big 12), 41, 21, 0, 62, Oklahoma State, (16-7; 6-5 Big 12), 30, 37, 0, 67
400585828, 2015-02-07, Texas Tech, (12-12; 2-9 Big 12), 17, 21, 0, 38, Iowa State, (17-5; 7-3 Big 12), 35, 40, 0, 75
400599950, 2015-02-07, VCU, (18-5; 8-2 A 10), 31, 40, 0, 71, St Bonaventure, (13-8; 6-4 A 10), 32, 41, 0, 73
400586274, 2015-02-07, Fairfield, (6-17; 4-9 MAAC), 23, 35, 0, 58, St Peter's, (11-13; 5-8 MAAC), 33, 36, 0, 69
400586448, 2015-02-07, Illinois State, (15-9; 7-5 MVC), 28, 31, 0, 59, S Illinois, (10-15; 3-9 MVC), 34, 31, 0, 65
400587175, 2015-02-07, American U, (13-11; 6-6 Patriot), 14, 29, 0, 43, Colgate, (11-14; 8-4 Patriot), 34, 25, 0, 59
400587176, 2015-02-07, Army, (14-9; 5-7 Patriot), 30, 29, 0, 59, Navy, (9-15; 5-7 Patriot), 36, 31, 0, 67
400587541, 2015-02-07, E Michigan, (14-9; 3-7 MAC), 24, 49, 0, 73, Ohio, (9-12; 4-6 MAC), 33, 43, 0, 76
400587542, 2015-02-07, W Michigan, (14-9; 5-5 MAC), 39, 26, 0, 65, Cent Michigan, (16-5; 6-4 MAC), 30, 40, 0, 70
400587545, 2015-02-07, Toledo, (15-8; 7-3 MAC), 42, 30, 0, 72, Ball State, (7-14; 2-8 MAC), 27, 34, 0, 61
400591667, 2015-02-07, Wyoming, (19-5; 8-3 MW), 28, 22, 0, 50, Air Force, (11-12; 4-8 MW), 33, 40, 0, 73
400595311, 2015-02-07, UT-Arlington, (13-9; 7-5 Sun Belt), 41, 43, 0, 84, LA-Lafayette, (13-11; 7-6 Sun Belt), 45, 24, 0, 69
400597742, 2015-02-07, Wright State, (11-13; 3-7 Horizon), 33, 39, 0, 72, Cleveland State, (15-10; 9-2 Horizon), 44, 44, 0, 88
400597920, 2015-02-07, JMU, (14-11; 7-5 CAA), 35, 28, 0, 63, Towson, (11-14; 4-8 CAA), 33, 28, 0, 61
400586446, 2015-02-07, Bradley, (8-17; 3-9 MVC), 16, 40, 0, 56, Evansville, (16-8; 6-6 MVC), 30, 23, 0, 53
400587969, 2015-02-07, UNC, (18-6; 8-3 ACC), 36, 43, 0, 79, Boston College, (9-13; 1-9 ACC), 36, 32, 0, 68
400585830, 2015-02-07, Oklahoma, (16-7; 7-4 Big 12), 31, 37, 0, 68, TCU, (14-9; 1-9 Big 12), 28, 28, 0, 56
400586999, 2015-02-07, South Dakota, (11-14; 5-6 Summit), 20, 27, 0, 47, North Dakota St, (17-7; 9-2 Summit), 35, 36, 0, 71
400587968, 2015-02-07, FSU, (13-11; 5-6 ACC), 31, 42, 0, 73, VT, (9-14; 1-9 ACC), 26, 39, 0, 65
400588760, 2015-02-07, USC Upstate, (18-7; 5-3 A-Sun), 38, 36, 0, 74, Kennesaw St, (8-17; 2-6 A-Sun), 24, 22, 0, 46
400590817, 2015-02-07, UT Pan American, (8-16; 2-6 WAC), 27, 46, 0, 73, Chicago State, (6-19; 2-6 WAC), 31, 47, 0, 78
400591497, 2015-02-07, Southern Miss, (6-16; 1-10 C-USA), 30, 38, 0, 68, UAB, (13-11; 9-2 C-USA), 35, 43, 0, 78
400595504, 2015-02-07, Purdue, (15-9; 7-4 Big Ten), 31, 27, 0, 58, Minnesota, (15-9; 4-7 Big Ten), 27, 35, 0, 62
400588450, 2015-02-07, DePaul, (12-13; 6-6 Big East), 27, 46, 0, 73, Butler, (18-6; 8-3 Big East), 40, 43, 0, 83
400588758, 2015-02-07, FGCU, (17-7; 7-1 A-Sun), 25, 42, 0, 67, Stetson, (8-16; 2-6 A-Sun), 18, 33, 0, 51
400591725, 2015-02-07, Bryant, (11-12; 8-4 NEC), 46, 25, 4, 75, Sacred Heart, (11-14; 5-7 NEC), 32, 39, 13, 84
400591748, 2015-02-07, Mt St Mary's, (11-12; 7-5 NEC), 32, 31, 0, 63, Cent Conn St, (3-22; 1-11 NEC), 32, 14, 0, 46
400595307, 2015-02-07, Troy, (9-13; 4-9 Sun Belt), 27, 35, 0, 62, Appalachian St, (9-12; 6-6 Sun Belt), 33, 32, 0, 65
400595686, 2015-02-07, New Orleans, (6-13; 2-8 Southland), 24, 43, 0, 67, Cent Arkansas, (1-19; 1-8 Southland), 36, 34, 0, 70
400585831, 2015-02-07, Texas, (15-8; 4-6 Big 12), 27, 34, 0, 61, Kansas State, (12-12; 5-6 Big 12), 27, 30, 0, 57
400586056, 2015-02-07, North Dakota, (8-14; 4-7 Big Sky), 27, 36, 0, 63, N Arizona, (12-11; 7-3 Big Sky), 53, 35, 0, 88
400586449, 2015-02-07, Indiana State, (12-12; 8-4 MVC), 34, 45, 0, 79, Loyola (CHI), (14-10; 4-8 MVC), 28, 37, 0, 65
400587334, 2015-02-07, BYU, (18-8; 8-5 WCC), 40, 47, 0, 87, Loyola Mary, (8-17; 4-9 WCC), 30, 38, 0, 68
400587970, 2015-02-07, Syracuse, (15-8; 6-4 ACC), 40, 37, 0, 77, Pitt, (16-8; 5-5 ACC), 38, 45, 0, 83
400589204, 2015-02-07, Samford, (12-14; 5-8 Southern), 34, 37, 0, 71, East Tenn St, (13-10; 6-7 Southern), 34, 34, 0, 68
400589205, 2015-02-07, Mercer, (14-11; 9-3 Southern), 31, 43, 0, 74, Furman, (7-16; 4-8 Southern), 36, 32, 0, 68
400591668, 2015-02-07, UNLV, (13-10; 4-6 MW), 41, 41, 0, 82, Colorado State, (20-4; 7-4 MW), 39, 44, 0, 83
400595505, 2015-02-07, Nebraska, (13-10; 5-6 Big Ten), 13, 30, 0, 43, Penn State, (15-9; 3-8 Big Ten), 22, 34, 0, 56
400596035, 2015-02-07, St Francis (BKN), (16-9; 10-2 NEC), 35, 31, 0, 66, Wagner, (8-15; 6-6 NEC), 26, 25, 0, 51
400597376, 2015-02-07, Miss St, (11-12; 4-6 SEC), 9, 32, 0, 41, Arkansas, (18-5; 7-3 SEC), 30, 31, 0, 61
400597377, 2015-02-07, South Carolina, (11-11; 2-8 SEC), 26, 24, 0, 50, Vanderbilt, (13-10; 3-7 SEC), 22, 43, 0, 65
400598638, 2015-02-07, Savannah State, (5-17; 1-7 MEAC), 25, 32, 0, 57, Morgan State, (5-18; 3-6 MEAC), 25, 42, 0, 67
400598838, 2015-02-07, Non D-I School, NA, 35, 35, 0, 70, NJIT, (15-10; 9-1 home), 48, 48, 0, 96
400599593, 2015-02-07, Saint Louis, (10-13; 2-8 A 10), 29, 36, 0, 65, Fordham, (6-15; 1-9 A 10), 33, 50, 0, 83
400599607, 2015-02-07, George Mason, (7-15; 2-8 A 10), 24, 30, 0, 54, Saint Joe's, (10-12; 4-6 A 10), 31, 27, 0, 58
400598637, 2015-02-07, S Carolina St, (9-16; 6-4 MEAC), 34, 40, 0, 74, Coppin State, (5-18; 4-6 MEAC), 46, 31, 0, 77
400598639, 2015-02-07, Bethune-Cookman, (8-16; 4-5 MEAC), 28, 47, 0, 75, Delaware State, (10-13; 4-4 MEAC), 34, 36, 0, 70
400593299, 2015-02-07, Arizona, (20-3; 8-2 Pac-12), 34, 44, 0, 78, Arizona State, (12-11; 4-6 Pac-12), 41, 40, 0, 81
400589207, 2015-02-07, Chattanooga, (16-9; 9-3 Southern), 25, 45, 0, 70, W Carolina, (12-13; 7-6 Southern), 39, 34, 0, 73
400591767, 2015-02-07, Robert Morris, (12-12; 8-4 NEC), 38, 38, 0, 76, Fair Dickinson, (7-16; 2-10 NEC), 34, 28, 0, 62
400595684, 2015-02-07, McNeese State, (9-12; 3-7 Southland), 27, 32, 0, 59, Nicholls State, (7-13; 4-6 Southland), 24, 46, 0, 70
400586057, 2015-02-07, E Washington, (18-5; 9-1 Big Sky), 35, 26, 0, 61, Montana State, (4-19; 1-10 Big Sky), 34, 17, 0, 51
400591783, 2015-02-07, St Francis (PA), (13-10; 7-5 NEC), 37, 23, 0, 60, LIU Brooklyn, (10-13; 6-6 NEC), 25, 41, 0, 66
400586821, 2015-02-07, UCF, (9-13; 2-9 American), 22, 27, 0, 49, ECU, (10-13; 3-7 American), 31, 36, 0, 67
400597846, 2015-02-07, Drexel, (9-14; 7-5 CAA), 27, 32, 0, 59, Charleston, (7-18; 2-10 CAA), 18, 27, 0, 45
400586060, 2015-02-07, Portland State, (11-10; 5-6 Big Sky), 24, 36, 0, 60, Sacramento St, (16-6; 10-1 Big Sky), 33, 31, 0, 64
400595685, 2015-02-07, SE Louisiana, (6-16; 3-6 Southland), 26, 39, 0, 65, Abil Christian, (9-14; 3-7 Southland), 24, 28, 0, 52
400595309, 2015-02-07, Georgia State, (16-8; 9-4 Sun Belt), 26, 39, 0, 65, South Alabama, (7-17; 5-8 Sun Belt), 24, 30, 0, 54
400595506, 2015-02-07, Northwestern, (10-13; 1-9 Big Ten), 21, 29, 0, 50, Wisconsin, (21-2; 9-1 Big Ten), 37, 28, 0, 65
400591492, 2015-02-07, UTEP, (16-7; 8-3 C-USA), 34, 33, 0, 67, FIU, (11-12; 4-6 C-USA), 25, 39, 0, 64
400595688, 2015-02-07, Texas A&M-CC, (12-10; 7-3 Southland), 12, 47, 0, 59, Sam Houston, (18-5; 10-1 Southland), 26, 41, 0, 67
400586996, 2015-02-07, Omaha, (8-15; 2-9 Summit), 26, 48, 0, 74, Denver, (10-13; 4-6 Summit), 42, 46, 0, 88
400591229, 2015-02-07, Dartmouth, (8-12; 1-5 Ivy), 25, 39, 0, 64, Brown, (10-13; 1-5 Ivy), 33, 34, 0, 67
400591265, 2015-02-07, Princeton, (10-11; 3-2 Ivy), 29, 31, 0, 60, Cornell, (11-11; 3-3 Ivy), 25, 43, 0, 68
400591669, 2015-02-07, Utah State, (13-10; 6-5 MW), 33, 30, 0, 63, New Mexico, (14-9; 6-5 MW), 30, 30, 0, 60
400591670, 2015-02-07, Nevada, (7-15; 3-7 MW), 27, 33, 0, 60, San Jose State, (2-21; 0-11 MW), 20, 37, 0, 57
400597378, 2015-02-07, Alabama, (14-9; 4-6 SEC), 20, 40, 0, 60, LSU, (17-6; 6-4 SEC), 30, 41, 0, 71
400597379, 2015-02-07, Texas A&M, (16-6; 7-3 SEC), 38, 45, 0, 83, Missouri, (7-16; 1-9 SEC), 31, 30, 0, 61
400598641, 2015-02-07, MD-E Shore, (13-12; 6-4 MEAC), 29, 32, 0, 61, Hampton, (9-14; 5-5 MEAC), 23, 41, 0, 64
400598678, 2015-02-07, Howard, (12-11; 6-3 MEAC), 38, 31, 0, 69, Norfolk State, (16-9; 9-1 MEAC), 38, 34, 0, 72
400586818, 2015-02-07, UConn, (13-9; 6-4 American), 24, 38, 0, 62, Tulane, (13-10; 4-7 American), 27, 26, 0, 53
400595310, 2015-02-07, Texas State, (11-11; 5-8 Sun Belt), 23, 38, 0, 61, AR-Little Rock, (9-14; 4-9 Sun Belt), 32, 37, 0, 69
400598797, 2015-02-07, AR-Pine Bluff, (7-17; 4-6 SWAC), 23, 32, 0, 55, Alabama State, (13-6; 9-1 SWAC), 36, 37, 0, 73
400598642, 2015-02-07, NC Central, (18-6; 10-0 MEAC), 30, 28, 0, 58, NC A&T, (6-19; 3-7 MEAC), 26, 18, 0, 44
400591027, 2015-02-07, Grambling St, (2-18; 0-10 SWAC), 28, 22, 0, 50, Southern, (11-13; 8-2 SWAC), 26, 32, 0, 58
400591052, 2015-02-07, Jackson State, (7-16; 5-5 SWAC), 33, 31, 0, 64, Alcorn State, (4-18; 3-7 SWAC), 27, 34, 0, 61
400597380, 2015-02-07, Ole Miss, (16-7; 7-3 SEC), 31, 55, 0, 86, Auburn, (11-12; 3-7 SEC), 32, 47, 0, 79
400587971, 2015-02-07, Louisville, (19-4; 7-3 ACC), 13, 34, 0, 47, UVA, (21-1; 9-1 ACC), 24, 28, 0, 52
400586997, 2015-02-07, Oral Roberts, (13-11; 6-4 Summit), 32, 37, 0, 69, IPFW, (13-11; 6-5 Summit), 35, 40, 0, 75
400587543, 2015-02-07, Miami (OH), (8-15; 3-7 MAC), 37, 23, 0, 60, Kent State, (16-7; 7-3 MAC), 37, 24, 0, 61
400587544, 2015-02-07, Buffalo, (15-7; 6-4 MAC), 43, 29, 0, 72, Akron, (16-7; 7-3 MAC), 41, 34, 0, 75
400588759, 2015-02-07, Lipscomb, (10-13; 4-4 A-Sun), 20, 40, 0, 60, N Kentucky, (10-13; 4-4 A-Sun), 41, 36, 0, 77
400590818, 2015-02-07, New Mexico St, (15-10; 7-1 WAC), 34, 43, 0, 77, UMKC, (10-15; 5-3 WAC), 34, 29, 0, 63
400591192, 2015-02-07, Duquesne, (7-14; 2-8 A 10), 38, 31, 0, 69, Davidson, (15-6; 6-4 A 10), 52, 43, 0, 95
400591250, 2015-02-07, Penn, (7-12; 2-3 Ivy), 19, 37, 0, 56, Columbia, (11-9; 3-3 Ivy), 46, 37, 0, 83
400591299, 2015-02-07, Harvard, (15-5; 5-1 Ivy), 16, 36, 0, 52, Yale, (16-7; 5-1 Ivy), 11, 39, 0, 50
400591491, 2015-02-07, Charlotte, (10-13; 3-7 C-USA), 30, 27, 0, 57, Old Dominion, (18-4; 7-3 C-USA), 30, 31, 0, 61
400591493, 2015-02-07, UTSA, (12-10; 6-5 C-USA), 30, 44, 0, 74, FAU, (8-13; 1-9 C-USA), 28, 31, 0, 59
400591495, 2015-02-07, North Texas, (9-13; 3-7 C-USA), 38, 35, 0, 73, Marshall, (8-16; 4-7 C-USA), 35, 45, 0, 80
400595979, 2015-02-07, UC Irvine, (14-9; 7-2 Big West), 34, 22, 0, 56, LBSU, (13-12; 7-2 Big West), 27, 28, 0, 55
400596417, 2015-02-07, Tennessee St, (5-20; 2-8 OVC), 30, 42, 0, 72, E Kentucky, (14-9; 6-4 OVC), 42, 35, 0, 77
400596418, 2015-02-07, E Illinois, (14-10; 7-4 OVC), 32, 32, 0, 64, SE Missouri St, (11-13; 5-6 OVC), 22, 46, 0, 68
400597693, 2015-02-07, UVM, (14-10; 9-2 Am. East), 15, 42, 0, 57, Stony Brook, (15-10; 6-4 Am. East), 29, 19, 0, 48
400597895, 2015-02-07, Elon, (11-14; 3-9 CAA), 37, 32, 0, 69, Hofstra, (16-9; 7-5 CAA), 39, 41, 0, 80
400595689, 2015-02-07, Houston Baptist, (10-10; 5-5 Southland), 27, 32, 0, 59, SF Austin, (19-3; 9-0 Southland), 47, 48, 0, 95
400760595, 2015-02-07, Miss Valley St, (4-19; 3-7 SWAC), 34, 34, 0, 68, Alabama A&M, (6-14; 5-5 SWAC), 42, 32, 0, 74
400587177, 2015-02-07, Lehigh, (13-10; 7-5 Patriot), 36, 33, 0, 69, Loyola (MD), (9-14; 5-7 Patriot), 31, 32, 0, 63
400595308, 2015-02-07, UL Monroe, (16-8; 10-3 Sun Belt), 34, 28, 9, 71, Ga Southern, (16-5; 9-3 Sun Belt), 29, 33, 6, 68
400596416, 2015-02-07, SIU-ED, (9-13; 5-6 OVC), 30, 29, 0, 59, UT Martin, (15-8; 7-3 OVC), 28, 36, 0, 64
400596421, 2015-02-07, Belmont, (15-9; 7-4 OVC), 31, 40, 0, 71, Morehead State, (12-14; 7-4 OVC), 31, 42, 0, 73
400596463, 2015-02-07, UMass Lowell, (10-14; 4-7 Am. East), 25, 34, 0, 59, Albany, (16-7; 11-0 Am. East), 40, 29, 0, 69
400586450, 2015-02-07, Drake, (7-17; 4-8 MVC), 20, 33, 0, 53, Northern Iowa, (22-2; 11-1 MVC), 36, 33, 0, 69
400586447, 2015-02-07, Missouri State, (9-15; 3-9 MVC), 13, 22, 0, 35, Wichita State, (21-3; 11-1 MVC), 37, 41, 0, 78
400586820, 2015-02-07, SMU, (19-5; 10-2 American), 34, 34, 0, 68, Tulsa, (17-6; 10-1 American), 28, 29, 0, 57
400586819, 2015-02-07, USF, (7-17; 1-10 American), 20, 38, 0, 58, Cincinnati, (17-6; 8-3 American), 31, 32, 0, 63
400587336, 2015-02-07, Portland, (14-10; 5-7 WCC), 42, 32, 0, 74, Santa Clara, (11-14; 5-8 WCC), 26, 28, 0, 54
400587337, 2015-02-07, San Diego, (13-12; 6-7 WCC), 33, 39, 0, 72, Pepperdine, (15-9; 8-5 WCC), 24, 26, 0, 50
400591494, 2015-02-07, LA Tech, (18-6; 9-2 C-USA), 33, 40, 0, 73, Mid Tennessee, (13-11; 6-5 C-USA), 21, 41, 0, 62
400591496, 2015-02-07, Rice, (7-15; 4-6 C-USA), 43, 29, 0, 72, W Kentucky, (16-7; 9-2 C-USA), 26, 42, 0, 68
400593300, 2015-02-07, UCLA, (14-10; 6-5 Pac-12), 28, 34, 0, 62, Cal, (15-9; 5-6 Pac-12), 32, 32, 0, 64
400596419, 2015-02-07, Murray State, (21-4; 11-0 OVC), 42, 40, 0, 82, Austin Peay, (7-17; 2-8 OVC), 26, 46, 0, 72
400597926, 2015-02-07, William & Mary, (15-8; 9-3 CAA), 26, 30, 0, 56, UNC-Wilmington, (13-10; 8-4 CAA), 29, 24, 0, 53
400587546, 2015-02-07, Bowling Green, (15-6; 7-3 MAC), 28, 41, 0, 69, N Illinois, (9-12; 3-7 MAC), 31, 34, 0, 65
400595687, 2015-02-07, Lamar, (11-12; 5-6 Southland), 35, 37, 0, 72, Incarnate Word, (13-6; 5-4 Southland), 39, 39, 0, 78
400596420, 2015-02-07, Jacksonville St, (9-17; 2-9 OVC), 22, 37, 0, 59, Tenn Tech, (11-13; 3-8 OVC), 38, 34, 0, 72
400598830, 2015-02-07, PV A&M, (7-16; 5-5 SWAC), 24, 34, 0, 58, Texas Southern, (11-12; 8-2 SWAC), 26, 29, 0, 55
400597381, 2015-02-07, Kentucky, (23-0; 10-0 SEC), 28, 40, 0, 68, Florida, (12-11; 5-5 SEC), 30, 31, 0, 61
400586058, 2015-02-07, Weber State, (10-12; 5-6 Big Sky), 32, 38, 0, 70, Idaho State, (5-18; 2-9 Big Sky), 27, 36, 0, 63
400586059, 2015-02-07, Idaho, (9-12; 4-6 Big Sky), 24, 32, 0, 56, Montana, (12-10; 8-3 Big Sky), 32, 38, 0, 70
400586061, 2015-02-07, N Colorado, (12-10; 7-4 Big Sky), 29, 55, 0, 84, Southern Utah, (5-16; 2-8 Big Sky), 31, 49, 0, 80
400595981, 2015-02-07, UC Riverside, (11-12; 4-5 Big West), 37, 22, 12, 71, CS Fullerton, (9-14; 1-7 Big West), 29, 30, 7, 66
400593301, 2015-02-07, Utah, (18-4; 8-2 Pac-12), 35, 44, 0, 79, Colorado, (11-11; 4-6 Pac-12), 23, 28, 0, 51
400587335, 2015-02-07, Pacific, (10-14; 2-10 WCC), 27, 31, 0, 58, Saint Mary's, (18-5; 10-2 WCC), 39, 34, 0, 73
400590815, 2015-02-07, Utah Valley, (8-14; 3-5 WAC), 19, 14, 0, 33, Seattle, (11-11; 4-4 WAC), 26, 27, 0, 53
400595980, 2015-02-07, Hawaii, (16-9; 4-5 Big West), 37, 37, 0, 74, UCSB, (11-11; 4-4 Big West), 33, 42, 0, 75
400590816, 2015-02-07, Grand Canyon, (14-11; 5-3 WAC), 37, 41, 0, 78, CSU Bakersfield, (9-15; 4-4 WAC), 34, 42, 0, 76
400595982, 2015-02-07, UC Davis, (18-4; 8-1 Big West), 36, 32, 0, 68, CS Northridge, (6-19; 2-8 Big West), 30, 25, 0, 55
400587333, 2015-02-07, Gonzaga, (24-1; 12-0 WCC), 38, 43, 0, 81, San Francisco, (9-16; 3-10 WCC), 38, 32, 0, 70
400586266, 2015-02-08, Niagara, (4-19; 3-11 MAAC), 19, 50, 0, 69, Quinnipiac, (13-10; 7-7 MAAC), 36, 55, 0, 91
400595507, 2015-02-08, Michigan, (13-11; 6-6 Big Ten), 29, 38, 0, 67, Indiana, (17-7; 7-4 Big Ten), 36, 34, 0, 70
400586275, 2015-02-08, Marist, (5-19; 4-10 MAAC), 35, 32, 0, 67, Iona, (18-6; 11-2 MAAC), 45, 44, 0, 89
400586276, 2015-02-08, Canisius, (12-11; 7-7 MAAC), 16, 24, 0, 40, Monmouth, (13-12; 9-5 MAAC), 19, 25, 0, 44
400586278, 2015-02-08, Manhattan, (12-11; 9-5 MAAC), 37, 35, 5, 77, Rider, (16-9; 10-4 MAAC), 37, 35, 13, 85
400587178, 2015-02-08, Holy Cross, (9-13; 4-8 Patriot), 27, 30, 0, 57, Bucknell, (13-12; 8-4 Patriot), 25, 45, 0, 70
400597762, 2015-02-08, UIC, (6-19; 2-8 Horizon), 43, 40, 0, 83, Detroit, (11-15; 4-7 Horizon), 36, 37, 0, 73
400599788, 2015-02-08, URI, (16-5; 8-2 A 10), 33, 46, 0, 79, Richmond, (12-11; 5-5 A 10), 26, 48, 0, 74
400597814, 2015-02-08, Oakland, (12-13; 7-3 Horizon), 35, 41, 0, 76, Valparaiso, (22-4; 9-2 Horizon), 41, 41, 0, 82
400595508, 2015-02-08, Maryland, (19-5; 7-4 Big Ten), 17, 38, 0, 55, Iowa, (15-8; 6-4 Big Ten), 40, 31, 0, 71
400599771, 2015-02-08, La Salle, (13-10; 5-5 A 10), 30, 29, 0, 59, UMass, (14-9; 7-3 A 10), 37, 29, 0, 66
400593302, 2015-02-08, Washington, (14-9; 3-8 Pac-12), 18, 32, 0, 50, Oregon State, (16-7; 7-4 Pac-12), 21, 43, 0, 64
400595509, 2015-02-08, OSU, (18-6; 7-4 Big Ten), 44, 35, 0, 79, Rutgers, (10-15; 2-10 Big Ten), 26, 34, 0, 60
400591671, 2015-02-08, San Diego State, (18-6; 8-3 MW), 18, 28, 0, 46, Boise State, (17-6; 7-3 MW), 30, 31, 0, 61
400587972, 2015-02-08, Clemson, (14-9; 6-5 ACC), 25, 20, 0, 45, Miami (FL), (15-8; 5-5 ACC), 24, 32, 0, 56
400593303, 2015-02-08, Washington St, (10-13; 4-7 Pac-12), 28, 44, 0, 72, Oregon, (17-7; 7-4 Pac-12), 52, 43, 0, 95
400593304, 2015-02-08, USC, (9-14; 1-10 Pac-12), 39, 23, 0, 62, Stanford, (16-7; 7-4 Pac-12), 33, 37, 0, 70
400587973, 2015-02-09, Duke, (21-3; 8-3 ACC), 32, 41, 0, 73, FSU, (13-12; 5-7 ACC), 24, 46, 0, 70
400585832, 2015-02-09, Oklahoma State, (17-7; 7-5 Big 12), 32, 42, 0, 74, Baylor, (18-6; 6-5 Big 12), 33, 32, 0, 65
400586279, 2015-02-09, Siena, (9-14; 6-8 MAAC), 26, 31, 0, 57, St Peter's, (12-13; 6-8 MAAC), 17, 48, 0, 65
400587179, 2015-02-09, Boston U, (10-13; 6-6 Patriot), 48, 26, 0, 74, Lafayette, (14-9; 6-6 Patriot), 39, 21, 0, 60
400595690, 2015-02-09, SF Austin, (20-3; 10-0 Southland), 42, 51, 0, 93, Northwestern St, (12-10; 7-4 Southland), 41, 41, 0, 82
400595691, 2015-02-09, Non D-I School, NA, 22, 17, 0, 39, Sam Houston, (19-5; 10-1 Southland), 53, 35, 0, 88
400598644, 2015-02-09, Florida A&M, (0-23; 0-10 MEAC), 32, 42, 0, 74, Delaware State, (11-13; 5-4 MEAC), 41, 49, 0, 90
400598645, 2015-02-09, S Carolina St, (9-17; 6-5 MEAC), 22, 21, 0, 43, Morgan State, (6-18; 4-6 MEAC), 33, 22, 0, 55
400589402, 2015-02-09, UNC Asheville, (13-11; 9-4 Big South), 47, 45, 0, 92, Gardner-Webb, (16-10; 8-5 Big South), 43, 46, 0, 89
400595692, 2015-02-09, Lamar, (12-12; 6-6 Southland), 40, 40, 0, 80, Abil Christian, (9-15; 3-8 Southland), 32, 29, 0, 61
400595693, 2015-02-09, Texas A&M-CC, (12-11; 7-4 Southland), 35, 31, 0, 66, Houston Baptist, (11-10; 6-5 Southland), 33, 44, 0, 77
400595695, 2015-02-09, McNeese State, (9-13; 3-8 Southland), 30, 41, 0, 71, New Orleans, (7-13; 3-8 Southland), 35, 46, 0, 81
400598646, 2015-02-09, MD-E Shore, (14-12; 7-4 MEAC), 36, 46, 0, 82, Norfolk State, (16-10; 9-2 MEAC), 37, 27, 0, 64
400601360, 2015-02-09, Howard, (12-12; 6-4 MEAC), 29, 35, 5, 69, Hampton, (10-14; 6-5 MEAC), 31, 33, 9, 73
400598643, 2015-02-09, Savannah State, (6-17; 2-7 MEAC), 41, 32, 0, 73, Coppin State, (5-19; 4-7 MEAC), 34, 36, 0, 70
400591075, 2015-02-09, Grambling St, (2-19; 0-11 SWAC), 29, 48, 0, 77, Alcorn State, (5-18; 4-7 SWAC), 43, 48, 0, 91
400598798, 2015-02-09, Miss Valley St, (4-20; 3-8 SWAC), 31, 26, 0, 57, Alabama State, (14-6; 10-1 SWAC), 31, 34, 0, 65
400585833, 2015-02-09, Iowa State, (17-6; 7-4 Big 12), 46, 37, 0, 83, Oklahoma, (17-7; 8-4 Big 12), 46, 48, 0, 94
400587974, 2015-02-09, Georgia Tech, (11-13; 2-10 ACC), 31, 32, 0, 63, VT, (10-14; 2-9 ACC), 26, 39, 0, 65
400600654, 2015-02-09, Non D-I School, NA, 31, 24, 0, 55, Utah Valley, (9-14; 3-5 WAC), 38, 39, 0, 77
400601532, 2015-02-09, AR-Pine Bluff, (8-17; 5-6 SWAC), 23, 30, 0, 53, Alabama A&M, (6-15; 5-6 SWAC), 23, 19, 0, 42
400591028, 2015-02-09, Jackson State, (8-16; 6-5 SWAC), 30, 32, 0, 62, Southern, (11-14; 8-3 SWAC), 29, 23, 0, 52
400597880, 2015-02-10, Towson, (11-15; 4-9 CAA), 17, 32, 0, 49, Drexel, (10-14; 8-5 CAA), 29, 24, 0, 53
400597382, 2015-02-10, Kentucky, (24-0; 11-0 SEC), 38, 33, 0, 71, LSU, (17-7; 6-5 SEC), 34, 35, 0, 69
400587975, 2015-02-10, Notre Dame, (22-4; 10-3 ACC), 29, 31, 0, 60, Clemson, (14-10; 6-6 ACC), 31, 27, 0, 58
400586822, 2015-02-10, Memphis, (14-10; 6-5 American), 25, 28, 0, 53, ECU, (11-13; 4-7 American), 21, 43, 0, 64
400587547, 2015-02-10, Kent State, (16-8; 7-4 MAC), 23, 29, 0, 52, Akron, (17-7; 8-3 MAC), 25, 36, 0, 61
400587548, 2015-02-10, Toledo, (16-8; 8-3 MAC), 41, 51, 0, 92, Buffalo, (15-8; 6-5 MAC), 33, 55, 0, 88
400587550, 2015-02-10, W Michigan, (14-10; 5-6 MAC), 22, 27, 0, 49, Bowling Green, (16-6; 8-3 MAC), 34, 31, 0, 65
400587551, 2015-02-10, Miami (OH), (8-16; 3-8 MAC), 26, 43, 0, 69, E Michigan, (15-9; 4-7 MAC), 33, 50, 0, 83
400587552, 2015-02-10, Cent Michigan, (17-5; 7-4 MAC), 39, 29, 0, 68, Ohio, (9-13; 4-7 MAC), 20, 37, 0, 57
400588451, 2015-02-10, Georgetown, (16-8; 8-5 Big East), 43, 43, 0, 86, Seton Hall, (15-9; 5-7 Big East), 38, 29, 0, 67
400595510, 2015-02-10, Michigan State, (16-8; 7-4 Big Ten), 38, 30, 0, 68, Northwestern, (10-14; 1-10 Big Ten), 14, 30, 0, 44
400596464, 2015-02-10, Albany, (17-7; 12-0 Am. East), 31, 31, 0, 62, Binghamton, (4-23; 3-9 Am. East), 17, 29, 0, 46
400596496, 2015-02-10, UNH, (15-10; 8-4 Am. East), 30, 31, 15, 76, Hartford, (12-12; 5-6 Am. East), 26, 35, 9, 70
400597383, 2015-02-10, Missouri, (7-17; 1-10 SEC), 30, 30, 0, 60, South Carolina, (12-11; 3-8 SEC), 30, 35, 0, 65
400586823, 2015-02-10, Cincinnati, (17-7; 8-4 American), 25, 34, 0, 59, Temple, (18-7; 9-3 American), 36, 39, 0, 75
400586451, 2015-02-10, Missouri State, (9-16; 3-10 MVC), 30, 36, 0, 66, Evansville, (17-8; 7-6 MVC), 30, 43, 0, 73
400587549, 2015-02-10, Ball State, (7-15; 2-9 MAC), 32, 31, 0, 63, N Illinois, (10-12; 4-7 MAC), 35, 40, 0, 75
400589403, 2015-02-10, Campbell, (9-17; 3-10 Big South), 36, 24, 0, 60, Liberty, (7-19; 1-12 Big South), 32, 41, 0, 73
400595694, 2015-02-10, Nicholls State, (7-14; 4-7 Southland), 23, 41, 0, 64, Incarnate Word, (14-6; 6-4 Southland), 29, 44, 0, 73
400595696, 2015-02-10, Cent Arkansas, (1-20; 1-9 Southland), 25, 33, 0, 58, SE Louisiana, (7-16; 4-6 Southland), 48, 35, 0, 83
400597803, 2015-02-10, Oakland, (12-14; 7-4 Horizon), 27, 40, 0, 67, Milwaukee, (10-15; 5-6 Horizon), 31, 53, 0, 84
400597864, 2015-02-10, JMU, (15-11; 8-5 CAA), 32, 35, 0, 67, Delaware, (6-18; 5-8 CAA), 27, 27, 0, 54
400760035, 2015-02-10, Iona, (19-6; 12-2 MAAC), 38, 34, 0, 72, Fairfield, (6-18; 4-10 MAAC), 22, 35, 0, 57
400595511, 2015-02-10, Wisconsin, (22-2; 10-1 Big Ten), 27, 38, 0, 65, Nebraska, (13-11; 5-7 Big Ten), 13, 42, 0, 55
400585834, 2015-02-10, Kansas, (20-4; 9-2 Big 12), 27, 46, 0, 73, Texas Tech, (12-13; 2-10 Big 12), 22, 29, 0, 51
400597384, 2015-02-10, Arkansas, (19-5; 8-3 SEC), 58, 43, 0, 101, Auburn, (11-13; 3-8 SEC), 47, 40, 0, 87
400588452, 2015-02-10, Xavier, (16-9; 7-6 Big East), 28, 36, 0, 64, Marquette, (11-13; 3-9 Big East), 25, 19, 0, 44
400591672, 2015-02-10, Nevada, (7-16; 3-8 MW), 33, 29, 0, 62, Utah State, (14-10; 7-5 MW), 42, 33, 0, 75
400597385, 2015-02-10, Alabama, (15-9; 5-6 SEC), 25, 30, 0, 55, Miss St, (11-13; 4-7 SEC), 21, 30, 0, 51
400591193, 2015-02-10, Dayton, (18-5; 8-3 A 10), 19, 32, 0, 51, Saint Louis, (10-14; 2-9 A 10), 25, 19, 0, 44
400591673, 2015-02-10, Fresno State, (11-13; 6-5 MW), 25, 36, 0, 61, UNLV, (14-10; 5-6 MW), 35, 38, 0, 73
400591674, 2015-02-10, New Mexico, (14-10; 6-6 MW), 19, 40, 0, 59, Colorado State, (21-4; 8-4 MW), 35, 35, 0, 70
400599772, 2015-02-11, La Salle, (14-10; 6-5 A 10), 30, 24, 20, 74, VCU, (18-6; 8-3 A 10), 30, 24, 15, 69
400585835, 2015-02-11, Kansas State, (12-13; 5-7 Big 12), 35, 37, 0, 72, West Virginia, (19-5; 7-4 Big 12), 46, 30, 0, 76
400595512, 2015-02-11, Penn State, (15-10; 3-9 Big Ten), 23, 32, 0, 55, OSU, (19-6; 8-4 Big Ten), 37, 38, 0, 75
400586824, 2015-02-11, USF, (7-18; 1-11 American), 26, 36, 0, 62, UCF, (10-13; 3-9 American), 35, 38, 0, 73
400587000, 2015-02-11, IPFW, (14-11; 7-5 Summit), 32, 37, 0, 69, IUPUI, (8-17; 4-7 Summit), 23, 31, 0, 54
400587180, 2015-02-11, Bucknell, (14-12; 9-4 Patriot), 18, 34, 0, 52, Navy, (9-16; 5-8 Patriot), 24, 27, 0, 51
400587181, 2015-02-11, Holy Cross, (10-13; 5-8 Patriot), 31, 42, 0, 73, Army, (14-10; 5-8 Patriot), 29, 35, 0, 64
400587976, 2015-02-11, Syracuse, (16-8; 7-4 ACC), 28, 42, 0, 70, Boston College, (9-14; 1-10 ACC), 24, 32, 0, 56
400587977, 2015-02-11, Miami (FL), (15-9; 5-6 ACC), 33, 37, 0, 70, Wake Forest, (12-13; 4-8 ACC), 42, 30, 0, 72
400589404, 2015-02-11, Winthrop, (13-11; 8-5 Big South), 38, 34, 0, 72, High Point, (18-7; 9-4 Big South), 28, 45, 0, 73
400589405, 2015-02-11, Longwood, (7-19; 3-10 Big South), 33, 42, 0, 75, Radford, (18-8; 9-4 Big South), 44, 36, 0, 80
400591194, 2015-02-11, George Mason, (7-16; 2-9 A 10), 30, 41, 0, 71, Davidson, (16-6; 7-4 A 10), 50, 42, 0, 92
400596541, 2015-02-11, UMass Lowell, (10-15; 4-8 Am. East), 19, 34, 0, 53, UVM, (15-10; 10-2 Am. East), 57, 39, 0, 96
400597386, 2015-02-11, Georgia, (16-7; 7-4 SEC), 34, 28, 0, 62, Texas A&M, (16-7; 7-4 SEC), 31, 22, 0, 53
400597694, 2015-02-11, Stony Brook, (16-10; 7-4 Am. East), 31, 42, 0, 73, UMBC, (3-21; 1-10 Am. East), 30, 31, 0, 61
400597847, 2015-02-11, Charleston, (7-19; 2-11 CAA), 30, 15, 0, 45, UNC-Wilmington, (14-10; 9-4 CAA), 24, 34, 0, 58
400597896, 2015-02-11, Elon, (11-15; 3-10 CAA), 23, 35, 0, 58, William & Mary, (16-8; 10-3 CAA), 42, 35, 0, 77
400599594, 2015-02-11, Fordham, (6-16; 1-10 A 10), 29, 42, 0, 71, Richmond, (13-11; 6-5 A 10), 28, 45, 0, 73
400599721, 2015-02-11, G Washington, (17-7; 7-4 A 10), 21, 41, 0, 62, Duquesne, (8-14; 3-8 A 10), 33, 45, 0, 78
400599780, 2015-02-11, UMass, (15-9; 8-3 A 10), 30, 25, 0, 55, St Bonaventure, (13-9; 6-5 A 10), 23, 30, 0, 53
400599789, 2015-02-11, URI, (16-6; 8-3 A 10), 35, 29, 0, 64, Saint Joe's, (11-12; 5-6 A 10), 31, 34, 0, 65
400587183, 2015-02-11, Lafayette, (14-10; 6-7 Patriot), 21, 22, 0, 43, Loyola (MD), (10-14; 6-7 Patriot), 30, 32, 0, 62
400589406, 2015-02-11, Coast Carolina, (17-8; 8-5 Big South), 33, 39, 0, 72, Charleston So, (15-9; 9-4 Big South), 32, 51, 0, 83
400597778, 2015-02-11, Green Bay, (20-5; 9-2 Horizon), 31, 32, 0, 63, Youngstown St, (10-17; 1-11 Horizon), 33, 29, 0, 62
400587979, 2015-02-11, UVA, (22-1; 10-1 ACC), 19, 32, 0, 51, NC State, (14-11; 5-7 ACC), 21, 26, 0, 47
400588453, 2015-02-11, Villanova, (22-2; 9-2 Big East), 29, 45, 0, 74, Providence, (17-8; 7-5 Big East), 26, 42, 0, 68
400587978, 2015-02-11, Pitt, (16-9; 5-6 ACC), 22, 34, 0, 56, Louisville, (20-4; 8-3 ACC), 27, 42, 0, 69
400586452, 2015-02-11, Illinois State, (15-10; 7-6 MVC), 33, 31, 0, 64, Northern Iowa, (23-2; 12-1 MVC), 50, 33, 0, 83
400586454, 2015-02-11, Indiana State, (12-13; 8-5 MVC), 24, 33, 0, 57, Wichita State, (22-3; 12-1 MVC), 38, 36, 0, 74
400585836, 2015-02-11, TCU, (14-10; 1-10 Big 12), 16, 27, 0, 43, Texas, (16-8; 5-6 Big 12), 31, 35, 0, 66
400586453, 2015-02-11, S Illinois, (10-16; 3-10 MVC), 34, 28, 0, 62, Loyola (CHI), (15-10; 5-8 MVC), 33, 33, 0, 66
400587182, 2015-02-11, Colgate, (12-14; 9-4 Patriot), 30, 46, 0, 76, Boston U, (10-14; 6-7 Patriot), 33, 36, 0, 69
400586455, 2015-02-11, Bradley, (8-18; 3-10 MVC), 24, 30, 0, 54, Drake, (8-17; 5-8 MVC), 21, 39, 0, 60
400595513, 2015-02-11, Indiana, (17-8; 7-5 Big Ten), 34, 32, 0, 66, Maryland, (20-5; 8-4 Big Ten), 35, 33, 0, 68
400588454, 2015-02-11, DePaul, (12-14; 6-7 Big East), 33, 45, 0, 78, St John's, (16-8; 5-6 Big East), 36, 50, 0, 86
400591675, 2015-02-11, Air Force, (11-13; 4-9 MW), 14, 28, 0, 42, Boise State, (18-6; 8-3 MW), 25, 42, 0, 67
400593305, 2015-02-11, Oregon, (18-7; 8-4 Pac-12), 35, 45, 0, 80, USC, (9-15; 1-11 Pac-12), 27, 48, 0, 75
400596422, 2015-02-11, Morehead State, (12-15; 7-5 OVC), 28, 29, 0, 57, E Kentucky, (15-9; 7-4 OVC), 32, 37, 0, 69
400596423, 2015-02-11, Belmont, (15-10; 7-5 OVC), 26, 44, 0, 70, Jacksonville St, (10-17; 3-9 OVC), 37, 35, 0, 72
400597387, 2015-02-11, Tennessee, (14-9; 6-5 SEC), 35, 32, 9, 76, Vanderbilt, (13-11; 3-8 SEC), 32, 35, 6, 73
400593306, 2015-02-11, Oregon State, (16-8; 7-5 Pac-12), 25, 34, 0, 59, UCLA, (15-10; 7-5 Pac-12), 40, 35, 0, 75
400591676, 2015-02-11, Wyoming, (19-6; 8-4 MW), 14, 27, 0, 41, San Diego State, (19-6; 9-3 MW), 36, 31, 0, 67
400596424, 2015-02-12, E Illinois, (15-10; 8-4 OVC), 39, 27, 0, 66, Austin Peay, (7-18; 2-9 OVC), 31, 24, 0, 55
400586825, 2015-02-12, Tulsa, (17-7; 10-2 American), 17, 28, 0, 45, UConn, (14-9; 7-4 American), 26, 44, 0, 70
400587184, 2015-02-12, American U, (13-12; 6-7 Patriot), 19, 39, 0, 58, Lehigh, (14-10; 8-5 Patriot), 33, 32, 0, 65
400588762, 2015-02-12, North Florida, (15-11; 7-2 A-Sun), 36, 27, 0, 63, USC Upstate, (19-7; 6-3 A-Sun), 36, 44, 0, 80
400588763, 2015-02-12, FGCU, (18-7; 8-1 A-Sun), 35, 30, 0, 65, N Kentucky, (10-14; 4-5 A-Sun), 37, 22, 0, 59
400588764, 2015-02-12, Jacksonville, (7-19; 1-8 A-Sun), 35, 30, 0, 65, Kennesaw St, (9-17; 3-6 A-Sun), 35, 43, 0, 78
400589208, 2015-02-12, W Carolina, (13-13; 8-6 Southern), 24, 34, 0, 58, Mercer, (14-12; 9-4 Southern), 26, 28, 0, 54
400589209, 2015-02-12, East Tenn St, (14-10; 7-7 Southern), 28, 37, 0, 65, UNC Greensboro, (8-18; 4-9 Southern), 30, 32, 0, 62
400589211, 2015-02-12, Furman, (7-17; 4-9 Southern), 38, 21, 0, 59, VMI, (9-16; 5-9 Southern), 38, 55, 0, 93
400589212, 2015-02-12, Chattanooga, (17-9; 10-3 Southern), 19, 37, 0, 56, Wofford, (20-6; 11-2 Southern), 18, 28, 0, 46
400589407, 2015-02-12, Presbyterian, (9-17; 5-8 Big South), 35, 34, 0, 69, UNC Asheville, (13-12; 9-5 Big South), 22, 43, 0, 65
400591726, 2015-02-12, Bryant, (12-12; 9-4 NEC), 35, 39, 0, 74, Fair Dickinson, (7-17; 2-11 NEC), 30, 41, 0, 71
400591749, 2015-02-12, Cent Conn St, (3-23; 1-12 NEC), 17, 46, 0, 63, St Francis (PA), (14-10; 8-5 NEC), 40, 34, 0, 74
400591784, 2015-02-12, LIU Brooklyn, (11-13; 7-6 NEC), 30, 33, 0, 63, Robert Morris, (12-13; 8-5 NEC), 40, 22, 0, 62
400591801, 2015-02-12, Sacred Heart, (12-14; 6-7 NEC), 28, 34, 0, 62, Mt St Mary's, (11-13; 7-6 NEC), 27, 28, 0, 55
400595514, 2015-02-12, Minnesota, (16-9; 5-7 Big Ten), 23, 41, 0, 64, Iowa, (15-9; 6-5 Big Ten), 19, 40, 0, 59
400595515, 2015-02-12, Purdue, (16-9; 8-4 Big Ten), 29, 32, 0, 61, Rutgers, (10-16; 2-11 Big Ten), 16, 35, 0, 51
400596036, 2015-02-12, Wagner, (8-16; 6-7 NEC), 30, 36, 0, 66, St Francis (BKN), (17-9; 11-2 NEC), 33, 50, 0, 83
400597388, 2015-02-12, Ole Miss, (17-7; 8-3 SEC), 33, 29, 0, 62, Florida, (12-12; 5-6 SEC), 38, 23, 0, 61
400597791, 2015-02-12, UIC, (7-19; 3-8 Horizon), 45, 34, 0, 79, Wright State, (11-14; 3-8 Horizon), 30, 45, 0, 75
400597908, 2015-02-12, Northeastern, (17-9; 9-4 CAA), 33, 46, 0, 79, Hofstra, (16-10; 7-6 CAA), 29, 39, 0, 68
400588761, 2015-02-12, Stetson, (8-17; 2-7 A-Sun), 37, 48, 0, 85, Lipscomb, (11-13; 5-4 A-Sun), 51, 36, 0, 87
400591500, 2015-02-12, FAU, (8-14; 1-10 C-USA), 25, 29, 0, 54, LA Tech, (19-6; 10-2 C-USA), 36, 29, 0, 65
400595312, 2015-02-12, AR-Little Rock, (10-14; 5-9 Sun Belt), 37, 42, 0, 79, Appalachian St, (9-13; 6-7 Sun Belt), 37, 37, 0, 74
400595313, 2015-02-12, Arkansas State, (9-14; 4-10 Sun Belt), 27, 33, 0, 60, Ga Southern, (17-5; 10-3 Sun Belt), 31, 34, 0, 65
400586062, 2015-02-12, Montana, (13-10; 9-3 Big Sky), 33, 32, 0, 65, North Dakota, (8-15; 4-8 Big Sky), 32, 29, 0, 61
400586280, 2015-02-12, Siena, (10-14; 7-8 MAAC), 38, 28, 0, 66, Marist, (5-20; 4-11 MAAC), 25, 39, 0, 64
400587002, 2015-02-12, South Dakota, (12-14; 6-6 Summit), 33, 41, 0, 74, Omaha, (8-16; 2-10 Summit), 34, 39, 0, 73
400587003, 2015-02-12, W Illinois, (8-14; 3-8 Summit), 25, 42, 0, 67, Oral Roberts, (14-11; 7-4 Summit), 36, 41, 0, 77
400589210, 2015-02-12, The Citadel, (9-15; 4-9 Southern), 38, 28, 0, 66, Samford, (12-15; 5-9 Southern), 34, 31, 0, 65
400590820, 2015-02-12, CSU Bakersfield, (10-15; 5-4 WAC), 31, 35, 0, 66, UT Pan American, (8-17; 2-7 WAC), 21, 33, 0, 54
400591501, 2015-02-12, Mid Tennessee, (13-12; 6-6 C-USA), 18, 35, 15, 68, Rice, (8-15; 5-6 C-USA), 27, 26, 18, 71
400591502, 2015-02-12, UAB, (13-12; 9-3 C-USA), 31, 33, 0, 64, North Texas, (10-13; 4-7 C-USA), 32, 35, 0, 67
400591503, 2015-02-12, Old Dominion, (18-5; 7-4 C-USA), 37, 30, 0, 67, UTSA, (13-10; 7-5 C-USA), 30, 42, 0, 72
400596425, 2015-02-12, SIU-ED, (9-14; 5-7 OVC), 16, 30, 0, 46, Murray State, (22-4; 12-0 OVC), 40, 38, 0, 78
400596427, 2015-02-12, Tennessee St, (5-21; 2-9 OVC), 25, 27, 0, 52, Tenn Tech, (12-13; 4-8 OVC), 37, 34, 0, 71
400595315, 2015-02-12, South Alabama, (8-17; 6-8 Sun Belt), 36, 35, 0, 71, Troy, (9-14; 4-10 Sun Belt), 34, 33, 0, 67
400587340, 2015-02-12, Loyola Mary, (8-18; 4-10 WCC), 15, 36, 0, 51, Gonzaga, (25-1; 13-0 WCC), 44, 36, 0, 80
400593307, 2015-02-12, Stanford, (16-8; 7-5 Pac-12), 27, 32, 0, 59, Utah, (19-4; 9-2 Pac-12), 33, 42, 0, 75
400586826, 2015-02-12, SMU, (20-5; 11-2 American), 33, 42, 0, 75, Houston, (9-14; 1-10 American), 27, 42, 0, 69
400586063, 2015-02-12, Southern Utah, (6-16; 3-8 Big Sky), 30, 35, 0, 65, Weber State, (10-13; 5-7 Big Sky), 28, 28, 0, 56
400586064, 2015-02-12, Montana State, (5-19; 2-10 Big Sky), 40, 50, 0, 90, N Colorado, (12-11; 7-5 Big Sky), 34, 53, 0, 87
400587001, 2015-02-12, North Dakota St, (18-7; 10-2 Summit), 29, 34, 10, 73, Denver, (10-14; 4-7 Summit), 21, 42, 6, 69
400587338, 2015-02-12, Saint Mary's, (18-6; 10-3 WCC), 30, 30, 0, 60, BYU, (19-8; 9-5 WCC), 42, 40, 0, 82
400590819, 2015-02-12, Seattle, (11-12; 4-5 WAC), 21, 26, 0, 47, New Mexico St, (16-10; 8-1 WAC), 34, 39, 0, 73
400591498, 2015-02-12, Charlotte, (10-14; 3-8 C-USA), 27, 41, 0, 68, UTEP, (17-7; 9-3 C-USA), 34, 39, 0, 73
400591499, 2015-02-12, FIU, (12-12; 5-6 C-USA), 30, 34, 9, 73, Southern Miss, (6-17; 1-11 C-USA), 34, 30, 7, 71
400593308, 2015-02-12, Cal, (16-9; 6-6 Pac-12), 28, 40, 0, 68, Colorado, (11-12; 4-7 Pac-12), 27, 34, 0, 61
400595516, 2015-02-12, Michigan, (13-12; 6-7 Big Ten), 22, 28, 2, 52, Illinois, (17-8; 7-5 Big Ten), 20, 30, 14, 64
400596426, 2015-02-12, UT Martin, (15-9; 7-4 OVC), 40, 36, 0, 76, SE Missouri St, (12-13; 6-6 OVC), 53, 45, 0, 98
400586065, 2015-02-12, Sacramento St, (16-7; 10-2 Big Sky), 24, 37, 0, 61, E Washington, (19-5; 10-1 Big Sky), 31, 33, 0, 64
400586066, 2015-02-12, N Arizona, (12-12; 7-4 Big Sky), 32, 34, 0, 66, Idaho State, (6-18; 3-9 Big Sky), 42, 38, 0, 80
400595314, 2015-02-12, UT-Arlington, (14-9; 8-5 Sun Belt), 31, 39, 0, 70, Texas State, (11-12; 5-9 Sun Belt), 28, 33, 0, 61
400595316, 2015-02-12, LA-Lafayette, (13-12; 7-7 Sun Belt), 33, 22, 0, 55, UL Monroe, (17-8; 11-3 Sun Belt), 30, 37, 0, 67
400586067, 2015-02-12, Portland State, (11-11; 5-7 Big Sky), 32, 44, 0, 76, Idaho, (10-12; 5-6 Big Sky), 30, 57, 0, 87
400587341, 2015-02-12, Pacific, (10-15; 2-11 WCC), 22, 26, 0, 48, San Diego, (14-12; 7-7 WCC), 31, 37, 0, 68
400587342, 2015-02-12, Pepperdine, (15-10; 8-6 WCC), 28, 24, 0, 52, Portland, (15-10; 6-7 WCC), 30, 39, 0, 69
400595983, 2015-02-12, CS Fullerton, (9-15; 1-8 Big West), 24, 45, 0, 69, UC Davis, (19-4; 9-1 Big West), 31, 44, 0, 75
400595984, 2015-02-12, CS Northridge, (6-20; 2-9 Big West), 19, 44, 0, 63, Cal Poly, (11-11; 4-6 Big West), 33, 37, 0, 70
400595985, 2015-02-12, LBSU, (13-13; 7-3 Big West), 23, 32, 0, 55, UCSB, (12-11; 5-4 Big West), 26, 44, 0, 70
400587339, 2015-02-12, Santa Clara, (11-15; 5-9 WCC), 24, 34, 4, 62, San Francisco, (10-16; 4-10 WCC), 18, 40, 11, 69
400595986, 2015-02-12, UC Riverside, (11-13; 4-6 Big West), 28, 24, 0, 52, Hawaii, (17-9; 5-5 Big West), 42, 31, 0, 73
400587554, 2015-02-13, Kent State, (17-8; 8-4 MAC), 36, 31, 9, 76, Toledo, (16-9; 8-4 MAC), 32, 35, 8, 75
400591251, 2015-02-13, Columbia, (11-10; 3-4 Ivy), 31, 37, 0, 68, Harvard, (16-5; 6-1 Ivy), 48, 24, 0, 72
400586126, 2015-02-13, St Peter's, (13-13; 7-8 MAAC), 27, 50, 0, 77, Niagara, (4-20; 3-12 MAAC), 39, 26, 0, 65
400586281, 2015-02-13, Rider, (17-9; 11-4 MAAC), 28, 32, 0, 60, Canisius, (12-12; 7-8 MAAC), 36, 23, 0, 59
400591266, 2015-02-13, Cornell, (12-11; 4-3 Ivy), 31, 33, 17, 81, Dartmouth, (8-13; 1-6 Ivy), 31, 33, 8, 72
400591309, 2015-02-13, Yale, (17-7; 6-1 Ivy), 38, 37, 0, 75, Penn, (7-13; 2-4 Ivy), 23, 25, 0, 48
400596465, 2015-02-13, Albany, (18-7; 12-0 Am. East), 30, 35, 0, 65, NJIT, (15-11; 9-2 home), 30, 29, 0, 59
400597779, 2015-02-13, Green Bay, (20-6; 9-3 Horizon), 23, 36, 0, 59, Valparaiso, (23-4; 10-2 Horizon), 29, 34, 0, 63
400586282, 2015-02-13, Quinnipiac, (14-10; 8-7 MAAC), 30, 30, 0, 60, Fairfield, (6-19; 4-11 MAAC), 21, 38, 0, 59
400591230, 2015-02-13, Brown, (10-14; 1-6 Ivy), 29, 35, 0, 64, Princeton, (11-11; 4-2 Ivy), 30, 45, 0, 75
400595700, 2015-02-13, Incarnate Word, (15-6; 7-4 Southland), 36, 41, 0, 77, Cent Arkansas, (1-21; 1-10 Southland), 30, 37, 0, 67
400597743, 2015-02-13, Cleveland State, (15-11; 9-3 Horizon), 27, 38, 0, 65, Detroit, (12-15; 5-7 Horizon), 35, 31, 0, 66
400593309, 2015-02-13, Arizona, (21-3; 9-2 Pac-12), 43, 43, 0, 86, Washington, (14-10; 3-9 Pac-12), 24, 38, 0, 62
400586283, 2015-02-13, Iona, (20-6; 13-2 MAAC), 37, 33, 0, 70, Manhattan, (12-12; 9-6 MAAC), 30, 37, 0, 67
400593310, 2015-02-13, Arizona State, (12-12; 4-7 Pac-12), 34, 37, 0, 71, Washington St, (11-13; 5-7 Pac-12), 29, 45, 0, 74
400599489, 2015-02-14, UNC, (18-7; 8-4 ACC), 34, 42, 0, 76, Pitt, (17-9; 6-6 ACC), 48, 41, 0, 89
400595517, 2015-02-14, OSU, (19-7; 8-5 Big Ten), 24, 32, 0, 56, Michigan State, (17-8; 8-4 Big Ten), 33, 26, 0, 59
400586827, 2015-02-14, Memphis, (15-10; 7-5 American), 31, 44, 0, 75, USF, (7-19; 1-12 American), 21, 27, 0, 48
400587980, 2015-02-14, VT, (10-15; 2-10 ACC), 22, 32, 0, 54, Clemson, (15-10; 7-6 ACC), 41, 34, 0, 75
400591750, 2015-02-14, Cent Conn St, (3-24; 1-13 NEC), 30, 22, 0, 52, Robert Morris, (13-13; 9-5 NEC), 27, 26, 0, 53
400595318, 2015-02-14, Georgia State, (17-8; 10-4 Sun Belt), 29, 24, 0, 53, Texas State, (11-13; 5-10 Sun Belt), 21, 20, 0, 41
400588456, 2015-02-14, St John's, (17-8; 6-6 Big East), 40, 38, 0, 78, Xavier, (16-10; 7-7 Big East), 33, 37, 0, 70
400591196, 2015-02-14, St Bonaventure, (13-10; 6-6 A 10), 27, 34, 0, 61, Dayton, (19-5; 9-3 A 10), 35, 40, 0, 75
400585837, 2015-02-14, Baylor, (18-7; 6-6 Big 12), 33, 31, 0, 64, Kansas, (21-4; 10-2 Big 12), 27, 47, 0, 74
400587188, 2015-02-14, Loyola (MD), (10-15; 6-8 Patriot), 32, 28, 0, 60, Boston U, (11-14; 7-7 Patriot), 32, 41, 0, 73
400588455, 2015-02-14, Marquette, (11-14; 3-10 Big East), 29, 41, 0, 70, Creighton, (12-14; 3-10 Big East), 37, 40, 0, 77
400589408, 2015-02-14, Gardner-Webb, (16-11; 8-6 Big South), 24, 44, 0, 68, Winthrop, (14-11; 9-5 Big South), 40, 31, 0, 71
400591785, 2015-02-14, LIU Brooklyn, (12-13; 8-6 NEC), 32, 35, 12, 79, St Francis (PA), (14-11; 8-6 NEC), 31, 36, 7, 74
400596482, 2015-02-14, Binghamton, (4-24; 3-10 Am. East), 23, 25, 0, 48, UNH, (16-10; 9-4 Am. East), 30, 36, 0, 66
400597390, 2015-02-14, South Carolina, (12-12; 3-9 SEC), 18, 25, 0, 43, Kentucky, (25-0; 12-0 SEC), 43, 34, 0, 77
400599722, 2015-02-14, VCU, (19-6; 9-3 A 10), 38, 41, 0, 79, G Washington, (17-8; 7-5 A 10), 38, 28, 0, 66
400586828, 2015-02-14, ECU, (11-14; 4-8 American), 18, 35, 0, 53, Temple, (19-7; 10-3 American), 34, 32, 0, 66
400586829, 2015-02-14, Tulane, (14-10; 5-7 American), 19, 31, 0, 50, Cincinnati, (17-8; 8-5 American), 13, 36, 0, 49
400587005, 2015-02-14, W Illinois, (8-15; 3-9 Summit), 25, 33, 0, 58, Omaha, (9-16; 3-10 Summit), 29, 48, 0, 77
400587185, 2015-02-14, Lafayette, (14-11; 6-8 Patriot), 33, 44, 0, 77, American U, (14-12; 7-7 Patriot), 45, 43, 0, 88
400587186, 2015-02-14, Navy, (10-16; 6-8 Patriot), 24, 46, 0, 70, Colgate, (12-15; 9-5 Patriot), 35, 34, 0, 69
400587555, 2015-02-14, Cent Michigan, (18-5; 8-4 MAC), 32, 43, 0, 75, Buffalo, (15-9; 6-6 MAC), 45, 29, 0, 74
400588766, 2015-02-14, Jacksonville, (8-19; 2-8 A-Sun), 32, 57, 0, 89, USC Upstate, (19-8; 6-4 A-Sun), 42, 28, 0, 70
400588768, 2015-02-14, North Florida, (16-11; 8-2 A-Sun), 25, 42, 0, 67, Kennesaw St, (9-18; 3-7 A-Sun), 27, 24, 0, 51
400591197, 2015-02-14, Davidson, (17-6; 8-4 A 10), 39, 38, 0, 77, La Salle, (14-11; 6-6 A 10), 35, 34, 0, 69
400591679, 2015-02-14, UNLV, (14-11; 5-7 MW), 26, 49, 0, 75, Air Force, (12-13; 5-9 MW), 25, 51, 0, 76
400591727, 2015-02-14, Bryant, (12-13; 9-5 NEC), 31, 37, 0, 68, Mt St Mary's, (12-13; 8-6 NEC), 38, 37, 0, 75
400596497, 2015-02-14, Hartford, (12-13; 5-7 Am. East), 27, 36, 0, 63, UMass Lowell, (11-15; 5-8 Am. East), 36, 33, 0, 69
400596529, 2015-02-14, Maine, (3-22; 2-10 Am. East), 25, 27, 0, 52, Stony Brook, (17-10; 8-4 Am. East), 42, 38, 0, 80
400597389, 2015-02-14, Auburn, (12-13; 4-8 SEC), 29, 40, 0, 69, Georgia, (16-8; 7-5 SEC), 28, 40, 0, 68
400597726, 2015-02-14, UMBC, (3-22; 1-11 Am. East), 32, 19, 0, 51, UVM, (16-10; 11-2 Am. East), 38, 36, 0, 74
400599790, 2015-02-14, Saint Louis, (10-15; 2-10 A 10), 34, 34, 0, 68, URI, (17-6; 9-3 A 10), 46, 35, 0, 81
400599490, 2015-02-14, Wake Forest, (12-14; 4-9 ACC), 31, 29, 0, 60, UVA, (23-1; 11-1 ACC), 24, 37, 0, 61
400587553, 2015-02-14, Akron, (17-8; 8-4 MAC), 35, 40, 0, 75, E Michigan, (16-9; 5-7 MAC), 43, 35, 0, 78
400587981, 2015-02-14, FSU, (14-12; 6-7 ACC), 32, 25, 0, 57, Georgia Tech, (11-14; 2-11 ACC), 23, 30, 0, 53
400597865, 2015-02-14, Delaware, (7-18; 6-8 CAA), 43, 30, 0, 73, William & Mary, (16-9; 10-4 CAA), 28, 42, 0, 70
400586068, 2015-02-14, Montana State, (6-19; 3-10 Big Sky), 37, 43, 0, 80, North Dakota, (8-16; 4-9 Big Sky), 34, 44, 0, 78
400590822, 2015-02-14, UMKC, (11-15; 6-3 WAC), 32, 29, 0, 61, Chicago State, (6-20; 2-7 WAC), 28, 22, 0, 50
400591504, 2015-02-14, Charlotte, (11-14; 4-8 C-USA), 42, 47, 0, 89, UTSA, (13-11; 7-6 C-USA), 39, 42, 0, 81
400593311, 2015-02-14, Oregon, (18-8; 8-5 Pac-12), 40, 23, 0, 63, UCLA, (16-10; 8-5 Pac-12), 41, 31, 0, 72
400587187, 2015-02-14, Lehigh, (14-11; 8-6 Patriot), 18, 34, 0, 52, Holy Cross, (11-13; 6-8 Patriot), 30, 28, 0, 58
400595321, 2015-02-14, Appalachian St, (9-14; 6-8 Sun Belt), 26, 32, 0, 58, UL Monroe, (18-8; 12-3 Sun Belt), 38, 31, 0, 69
400587558, 2015-02-14, Ohio, (9-14; 4-8 MAC), 41, 25, 0, 66, Miami (OH), (9-16; 4-8 MAC), 38, 39, 0, 77
400589409, 2015-02-14, Liberty, (7-20; 1-13 Big South), 26, 30, 0, 56, Coast Carolina, (18-8; 9-5 Big South), 37, 59, 0, 96
400599488, 2015-02-14, NC State, (15-11; 6-7 ACC), 30, 44, 0, 74, Louisville, (20-5; 8-4 ACC), 31, 34, 0, 65
400585838, 2015-02-14, West Virginia, (19-6; 7-5 Big 12), 32, 27, 0, 59, Iowa State, (18-6; 8-4 Big 12), 36, 43, 0, 79
400586456, 2015-02-14, Drake, (8-18; 5-9 MVC), 25, 29, 0, 54, Indiana State, (13-13; 9-5 MVC), 34, 41, 0, 75
400587346, 2015-02-14, Saint Mary's, (19-6; 11-3 WCC), 31, 25, 13, 69, San Diego, (14-13; 7-8 WCC), 20, 36, 6, 62
400588457, 2015-02-14, Seton Hall, (15-10; 5-8 Big East), 25, 37, 0, 62, Providence, (18-8; 8-5 Big East), 32, 37, 0, 69
400589215, 2015-02-14, Furman, (7-18; 4-10 Southern), 24, 35, 0, 59, East Tenn St, (15-10; 8-7 Southern), 32, 34, 0, 66
400589410, 2015-02-14, High Point, (19-7; 10-4 Big South), 27, 36, 0, 63, Campbell, (9-18; 3-11 Big South), 24, 27, 0, 51
400591195, 2015-02-14, Duquesne, (8-15; 3-9 A 10), 30, 44, 0, 74, UMass, (16-9; 9-3 A 10), 39, 43, 0, 82
400591267, 2015-02-14, Cornell, (12-12; 4-4 Ivy), 24, 16, 0, 40, Harvard, (17-5; 7-1 Ivy), 21, 40, 0, 61
400591768, 2015-02-14, Fair Dickinson, (7-18; 2-12 NEC), 36, 35, 8, 79, Wagner, (9-16; 7-7 NEC), 53, 18, 12, 83
400597391, 2015-02-14, LSU, (18-7; 7-5 SEC), 47, 26, 0, 73, Tennessee, (14-10; 6-6 SEC), 20, 35, 0, 55
400597392, 2015-02-14, Miss St, (12-13; 5-7 SEC), 40, 37, 0, 77, Missouri, (7-18; 1-11 SEC), 29, 45, 0, 74
400598590, 2015-02-14, Howard, (13-12; 7-4 MEAC), 38, 39, 0, 77, Coppin State, (5-20; 4-8 MEAC), 31, 29, 0, 60
400599608, 2015-02-14, Richmond, (13-12; 6-6 A 10), 26, 36, 5, 67, George Mason, (8-16; 3-9 A 10), 26, 36, 9, 71
400603707, 2015-02-14, UNC Greensboro, (8-19; 4-10 Southern), 20, 30, 0, 50, Mercer, (15-12; 10-4 Southern), 31, 24, 0, 55
400586458, 2015-02-14, Evansville, (18-8; 8-6 MVC), 30, 42, 0, 72, S Illinois, (10-17; 3-11 MVC), 29, 35, 0, 64
400596027, 2015-02-14, Sacred Heart, (12-15; 6-8 NEC), 35, 27, 0, 62, St Francis (BKN), (18-9; 12-2 NEC), 31, 40, 0, 71
400598650, 2015-02-14, NC Central, (19-6; 11-0 MEAC), 33, 32, 0, 65, Bethune-Cookman, (8-17; 4-6 MEAC), 21, 30, 0, 51
400598651, 2015-02-14, Norfolk State, (16-11; 9-3 MEAC), 34, 36, 0, 70, Morgan State, (7-18; 5-6 MEAC), 28, 45, 0, 73
400587556, 2015-02-14, N Illinois, (10-13; 4-8 MAC), 41, 24, 0, 65, W Michigan, (15-10; 6-6 MAC), 37, 32, 0, 69
400587557, 2015-02-14, Bowling Green, (17-6; 9-3 MAC), 36, 43, 0, 79, Ball State, (7-16; 2-10 MAC), 25, 40, 0, 65
400595698, 2015-02-14, SE Louisiana, (8-16; 5-6 Southland), 31, 34, 0, 65, Nicholls State, (7-15; 4-8 Southland), 31, 28, 0, 59
400595699, 2015-02-14, SF Austin, (20-4; 10-1 Southland), 25, 38, 0, 63, Texas A&M-CC, (13-11; 8-4 Southland), 35, 36, 0, 71
400598649, 2015-02-14, Delaware State, (12-13; 6-4 MEAC), 44, 47, 0, 91, MD-E Shore, (14-13; 7-5 MEAC), 36, 49, 0, 85
400595697, 2015-02-14, Northwestern St, (13-10; 8-4 Southland), 33, 42, 0, 75, McNeese State, (9-14; 3-9 Southland), 35, 37, 0, 72
400587007, 2015-02-14, North Dakota St, (18-8; 10-3 Summit), 24, 34, 0, 58, South Dakota St, (19-8; 10-3 Summit), 29, 39, 0, 68
400588765, 2015-02-14, FGCU, (19-7; 9-1 A-Sun), 34, 42, 0, 76, Lipscomb, (11-14; 5-5 A-Sun), 30, 44, 0, 74
400589217, 2015-02-14, Wofford, (21-6; 12-2 Southern), 34, 41, 0, 75, W Carolina, (13-14; 8-7 Southern), 23, 32, 0, 55
400589411, 2015-02-14, Charleston So, (16-9; 10-4 Big South), 39, 26, 0, 65, Longwood, (7-20; 3-11 Big South), 34, 30, 0, 64
400593312, 2015-02-14, Oregon State, (16-9; 7-6 Pac-12), 28, 27, 0, 55, USC, (10-15; 2-11 Pac-12), 26, 42, 0, 68
400586071, 2015-02-14, Portland State, (12-11; 6-7 Big Sky), 26, 42, 0, 68, E Washington, (19-6; 10-2 Big Sky), 32, 34, 0, 66
400595317, 2015-02-14, UT-Arlington, (14-10; 8-6 Sun Belt), 29, 62, 0, 91, South Alabama, (9-17; 7-8 Sun Belt), 49, 48, 0, 97
400595319, 2015-02-14, LA-Lafayette, (14-12; 8-7 Sun Belt), 41, 33, 10, 84, Troy, (9-15; 4-11 Sun Belt), 35, 39, 6, 80
400591076, 2015-02-14, Alcorn State, (5-19; 4-8 SWAC), 30, 30, 0, 60, Miss Valley St, (5-20; 4-8 SWAC), 38, 38, 0, 76
400591507, 2015-02-14, W Kentucky, (16-8; 9-3 C-USA), 43, 39, 0, 82, Marshall, (9-16; 5-7 C-USA), 47, 40, 0, 87
400588458, 2015-02-14, Villanova, (23-2; 10-2 Big East), 27, 41, 0, 68, Butler, (18-7; 8-4 Big East), 22, 43, 0, 65
400586457, 2015-02-14, Wichita State, (23-3; 13-1 MVC), 27, 41, 0, 68, Illinois State, (15-11; 7-7 MVC), 21, 41, 0, 62
400585839, 2015-02-14, Oklahoma State, (17-8; 7-6 Big 12), 28, 27, 0, 55, TCU, (15-10; 2-10 Big 12), 26, 44, 0, 70
400587004, 2015-02-14, IUPUI, (9-17; 5-7 Summit), 20, 34, 0, 54, Denver, (10-15; 4-8 Summit), 30, 23, 0, 53
400589213, 2015-02-14, Samford, (12-16; 5-10 Southern), 32, 40, 0, 72, Chattanooga, (18-9; 11-3 Southern), 32, 47, 0, 79
400591319, 2015-02-14, Yale, (18-7; 7-1 Ivy), 39, 42, 0, 81, Princeton, (11-12; 4-3 Ivy), 28, 45, 0, 73
400591677, 2015-02-14, San Jose State, (2-22; 0-12 MW), 29, 31, 0, 60, Wyoming, (20-6; 9-4 MW), 39, 38, 0, 77
400599487, 2015-02-14, Duke, (22-3; 9-3 ACC), 36, 44, 0, 80, Syracuse, (16-9; 7-5 ACC), 39, 33, 0, 72
400595320, 2015-02-14, Ga Southern, (18-5; 11-3 Sun Belt), 35, 29, 8, 72, AR-Little Rock, (10-15; 5-10 Sun Belt), 26, 38, 6, 70
400598653, 2015-02-14, S Carolina St, (10-17; 7-5 MEAC), 38, 18, 0, 56, Savannah State, (6-18; 2-8 MEAC), 18, 35, 0, 53
400598671, 2015-02-14, NC A&T, (6-20; 3-8 MEAC), 17, 33, 0, 50, Florida A&M, (1-23; 1-10 MEAC), 21, 36, 0, 57
400597393, 2015-02-14, Florida, (12-13; 5-7 SEC), 28, 34, 0, 62, Texas A&M, (17-7; 8-4 SEC), 32, 31, 0, 63
400598799, 2015-02-14, Alabama A&M, (7-15; 6-6 SWAC), 39, 41, 0, 80, Alabama State, (14-7; 10-2 SWAC), 35, 36, 0, 71
400588767, 2015-02-14, Stetson, (8-18; 2-8 A-Sun), 25, 32, 0, 57, N Kentucky, (11-14; 5-5 A-Sun), 42, 40, 0, 82
400591231, 2015-02-14, Brown, (11-14; 2-6 Ivy), 29, 42, 0, 71, Penn, (7-14; 2-5 Ivy), 30, 25, 0, 55
400591252, 2015-02-14, Columbia, (11-11; 3-5 Ivy), 26, 23, 0, 49, Dartmouth, (9-13; 2-6 Ivy), 28, 33, 0, 61
400591505, 2015-02-14, FIU, (12-13; 5-7 C-USA), 15, 27, 0, 42, LA Tech, (20-6; 11-2 C-USA), 26, 49, 0, 75
400591680, 2015-02-14, Boise State, (18-7; 8-4 MW), 42, 22, 0, 64, Fresno State, (12-13; 7-5 MW), 40, 30, 0, 70
400596428, 2015-02-14, Austin Peay, (7-19; 2-10 OVC), 30, 31, 0, 61, UT Martin, (16-9; 8-4 OVC), 28, 39, 0, 67
400596429, 2015-02-14, Morehead State, (12-16; 7-6 OVC), 27, 30, 0, 57, Belmont, (16-10; 8-5 OVC), 25, 33, 0, 58
400596430, 2015-02-14, Murray State, (23-4; 13-0 OVC), 38, 47, 9, 94, SE Missouri St, (12-14; 6-7 OVC), 43, 42, 7, 92
400597897, 2015-02-14, JMU, (16-11; 9-5 CAA), 38, 48, 0, 86, Elon, (11-16; 3-11 CAA), 32, 43, 0, 75
400601255, 2015-02-14, Monmouth, (14-12; 10-5 MAAC), 34, 49, 0, 83, Siena, (10-15; 7-9 MAAC), 31, 33, 0, 64
400589412, 2015-02-14, Radford, (19-8; 10-4 Big South), 26, 36, 0, 62, Presbyterian, (9-18; 5-9 Big South), 33, 23, 0, 56
400587345, 2015-02-14, Pepperdine, (15-11; 8-7 WCC), 30, 18, 0, 48, Gonzaga, (26-1; 14-0 WCC), 30, 26, 0, 56
400585841, 2015-02-14, Oklahoma, (17-8; 8-5 Big 12), 28, 28, 0, 56, Kansas State, (13-13; 6-7 Big 12), 27, 32, 0, 59
400585840, 2015-02-14, Texas Tech, (12-14; 2-11 Big 12), 19, 22, 0, 41, Texas, (17-8; 6-6 Big 12), 29, 27, 0, 56
400587006, 2015-02-14, South Dakota, (13-14; 7-6 Summit), 41, 42, 0, 83, Oral Roberts, (14-12; 7-5 Summit), 33, 37, 0, 70
400590824, 2015-02-14, Seattle, (11-13; 4-6 WAC), 27, 30, 0, 57, UT Pan American, (9-17; 3-7 WAC), 35, 33, 0, 68
400591506, 2015-02-14, FAU, (8-15; 1-11 C-USA), 24, 30, 0, 54, Southern Miss, (7-17; 2-11 C-USA), 28, 34, 0, 62
400591508, 2015-02-14, Mid Tennessee, (13-13; 6-7 C-USA), 37, 19, 0, 56, North Texas, (11-13; 5-7 C-USA), 18, 39, 0, 57
400591510, 2015-02-14, UAB, (13-13; 9-4 C-USA), 23, 36, 14, 73, Rice, (9-15; 6-6 C-USA), 35, 24, 23, 82
400591678, 2015-02-14, Colorado State, (21-5; 8-5 MW), 26, 37, 0, 63, San Diego State, (20-6; 10-3 MW), 37, 35, 0, 72
400595701, 2015-02-14, Sam Houston, (20-5; 11-1 Southland), 55, 32, 0, 87, Houston Baptist, (11-11; 6-6 Southland), 27, 37, 0, 64
400595987, 2015-02-14, UC Irvine, (14-10; 7-3 Big West), 34, 29, 0, 63, UC Riverside, (12-13; 5-6 Big West), 32, 38, 0, 70
400596431, 2015-02-14, E Illinois, (15-11; 8-5 OVC), 27, 36, 0, 63, SIU-ED, (10-14; 6-7 OVC), 45, 35, 0, 80
400597394, 2015-02-14, Vanderbilt, (14-11; 4-8 SEC), 32, 44, 0, 76, Alabama, (15-10; 5-7 SEC), 33, 35, 0, 68
400597927, 2015-02-14, Northeastern, (17-10; 9-5 CAA), 31, 30, 0, 61, UNC-Wilmington, (15-10; 10-4 CAA), 30, 36, 0, 66
400595518, 2015-02-14, Maryland, (21-5; 9-4 Big Ten), 33, 43, 0, 76, Penn State, (15-11; 3-10 Big Ten), 34, 39, 0, 73
400591029, 2015-02-14, Southern, (12-14; 9-3 SWAC), 31, 43, 0, 74, AR-Pine Bluff, (8-18; 5-7 SWAC), 21, 35, 0, 56
400596432, 2015-02-14, Tenn Tech, (12-14; 4-9 OVC), 26, 42, 0, 68, Jacksonville St, (11-17; 4-9 OVC), 36, 46, 0, 82
400598811, 2015-02-14, Texas Southern, (12-12; 9-2 SWAC), 41, 40, 0, 81, Grambling St, (2-20; 0-12 SWAC), 21, 37, 0, 58
400591053, 2015-02-14, PV A&M, (8-16; 6-5 SWAC), 36, 25, 0, 61, Jackson State, (8-17; 6-6 SWAC), 28, 27, 0, 55
400597395, 2015-02-14, Arkansas, (20-5; 9-3 SEC), 40, 31, 0, 71, Ole Miss, (17-8; 8-4 SEC), 36, 34, 0, 70
400586830, 2015-02-14, UConn, (14-10; 7-5 American), 26, 29, 0, 55, SMU, (21-5; 12-2 American), 41, 32, 0, 73
400586069, 2015-02-14, N Arizona, (13-12; 8-4 Big Sky), 24, 37, 0, 61, Weber State, (10-14; 5-8 Big Sky), 15, 39, 0, 54
400586072, 2015-02-14, Southern Utah, (7-16; 4-8 Big Sky), 37, 34, 0, 71, Idaho State, (6-19; 3-10 Big Sky), 30, 37, 0, 67
400586073, 2015-02-14, Montana, (14-10; 10-3 Big Sky), 33, 24, 26, 83, N Colorado, (12-12; 7-6 Big Sky), 24, 33, 24, 81
400587344, 2015-02-14, Pacific, (10-16; 2-12 WCC), 30, 29, 0, 59, BYU, (20-8; 10-5 WCC), 33, 51, 0, 84
400590821, 2015-02-14, Utah Valley, (9-15; 3-6 WAC), 33, 24, 0, 57, Grand Canyon, (15-11; 6-3 WAC), 47, 36, 0, 83
400590823, 2015-02-14, CSU Bakersfield, (10-16; 5-5 WAC), 31, 27, 0, 58, New Mexico St, (17-10; 9-1 WAC), 35, 39, 0, 74
400591509, 2015-02-14, Old Dominion, (18-6; 7-5 C-USA), 19, 28, 0, 47, UTEP, (18-7; 10-3 C-USA), 28, 34, 0, 62
400596433, 2015-02-14, E Kentucky, (16-9; 8-4 OVC), 26, 43, 0, 69, Tennessee St, (5-22; 2-10 OVC), 19, 22, 0, 41
400587343, 2015-02-14, Loyola Mary, (8-19; 4-11 WCC), 26, 37, 0, 63, Portland, (16-10; 7-7 WCC), 34, 32, 0, 66
400591681, 2015-02-14, New Mexico, (14-11; 6-7 MW), 31, 28, 4, 63, Nevada, (8-16; 4-8 MW), 19, 40, 7, 66
400595988, 2015-02-14, LBSU, (13-14; 7-4 Big West), 32, 26, 0, 58, Cal Poly, (12-11; 5-6 Big West), 36, 35, 0, 71
400595989, 2015-02-14, UCSB, (13-11; 6-4 Big West), 29, 36, 0, 65, CS Northridge, (6-21; 2-10 Big West), 32, 25, 0, 57
400586070, 2015-02-14, Sacramento St, (16-8; 10-3 Big Sky), 33, 25, 0, 58, Idaho, (11-12; 6-6 Big Sky), 37, 32, 0, 69
400595990, 2015-02-14, CS Fullerton, (9-16; 1-9 Big West), 38, 23, 0, 61, Hawaii, (18-9; 6-5 Big West), 40, 41, 0, 81
400597848, 2015-02-15, Towson, (12-15; 5-9 CAA), 27, 26, 0, 53, Charleston, (7-20; 2-12 CAA), 22, 28, 0, 50
400595519, 2015-02-15, Illinois, (17-9; 7-6 Big Ten), 24, 25, 0, 49, Wisconsin, (23-2; 11-1 Big Ten), 32, 36, 0, 68
400586286, 2015-02-15, Fairfield, (6-20; 4-12 MAAC), 33, 37, 0, 70, Manhattan, (13-12; 10-6 MAAC), 33, 46, 0, 79
400586287, 2015-02-15, St Peter's, (13-14; 7-9 MAAC), 18, 37, 0, 55, Canisius, (13-12; 8-8 MAAC), 33, 36, 0, 69
400586459, 2015-02-15, Loyola (CHI), (16-10; 6-8 MVC), 32, 26, 0, 58, Bradley, (8-19; 3-11 MVC), 22, 31, 0, 53
400586831, 2015-02-15, Houston, (9-15; 1-11 American), 33, 21, 0, 54, UCF, (11-13; 4-9 American), 32, 24, 0, 56
400597804, 2015-02-15, Valparaiso, (24-4; 11-2 Horizon), 23, 39, 0, 62, Milwaukee, (10-16; 5-7 Horizon), 28, 27, 0, 55
400601256, 2015-02-15, Rider, (18-9; 12-4 MAAC), 33, 36, 0, 69, Niagara, (4-21; 3-13 MAAC), 33, 27, 0, 60
400599595, 2015-02-15, Saint Joe's, (11-13; 5-7 A 10), 26, 29, 0, 55, Fordham, (7-16; 2-10 A 10), 31, 38, 0, 69
400595520, 2015-02-15, Iowa, (15-10; 6-6 Big Ten), 24, 30, 7, 61, Northwestern, (11-14; 2-10 Big Ten), 27, 27, 12, 66
400597744, 2015-02-15, UIC, (7-20; 3-9 Horizon), 34, 25, 0, 59, Cleveland State, (16-11; 10-3 Horizon), 30, 37, 0, 67
400597763, 2015-02-15, Detroit, (12-16; 5-8 Horizon), 33, 45, 0, 78, Oakland, (13-14; 8-4 Horizon), 46, 37, 0, 83
400597828, 2015-02-15, Youngstown St, (11-17; 2-11 Horizon), 36, 38, 0, 74, Wright State, (11-15; 3-9 Horizon), 34, 35, 0, 69
400586460, 2015-02-15, Northern Iowa, (24-2; 13-1 MVC), 42, 26, 0, 68, Missouri State, (9-17; 3-11 MVC), 20, 37, 0, 57
400586288, 2015-02-15, Iona, (21-6; 14-2 MAAC), 26, 34, 0, 60, Quinnipiac, (14-11; 8-8 MAAC), 31, 26, 0, 57
400587189, 2015-02-15, Bucknell, (15-12; 10-4 Patriot), 34, 44, 0, 78, Army, (14-11; 5-9 Patriot), 29, 46, 0, 75
400593313, 2015-02-15, Stanford, (16-9; 7-6 Pac-12), 23, 35, 0, 58, Colorado, (12-12; 5-7 Pac-12), 29, 35, 0, 64
400597881, 2015-02-15, Hofstra, (17-10; 8-6 CAA), 41, 40, 0, 81, Drexel, (10-15; 8-6 CAA), 25, 32, 0, 57
400595521, 2015-02-15, Nebraska, (13-12; 5-8 Big Ten), 20, 34, 0, 54, Purdue, (17-9; 9-4 Big Ten), 26, 40, 0, 66
400589214, 2015-02-15, VMI, (10-16; 6-9 Southern), 32, 52, 0, 84, The Citadel, (9-16; 4-10 Southern), 36, 33, 0, 69
400593314, 2015-02-15, Arizona State, (13-12; 5-7 Pac-12), 30, 48, 0, 78, Washington, (14-11; 3-10 Pac-12), 29, 39, 0, 68
400593315, 2015-02-15, Arizona, (22-3; 10-2 Pac-12), 53, 33, 0, 86, Washington St, (11-14; 5-8 Pac-12), 19, 40, 0, 59
400595522, 2015-02-15, Minnesota, (16-10; 5-8 Big Ten), 38, 33, 0, 71, Indiana, (18-8; 8-5 Big Ten), 44, 46, 0, 90
400593316, 2015-02-15, Cal, (16-10; 6-7 Pac-12), 34, 27, 0, 61, Utah, (20-4; 10-2 Pac-12), 40, 36, 0, 76
400587982, 2015-02-15, Miami (FL), (21-12; 10-8 ACC),  ,  , 0, 0, Boston College, (13-19; 4-14 ACC),  ,  , 0, 0
400762834, 2015-02-16, Miami (FL), (16-9; 6-6 ACC), 28, 38, 23, 89, Boston College, (9-15; 1-11 ACC), 30, 36, 20, 86
400591030, 2015-02-16, Southern, (13-14; 10-3 SWAC), 29, 39, 0, 68, Miss Valley St, (5-21; 4-9 SWAC), 28, 28, 0, 56
400598812, 2015-02-16, PV A&M, (9-16; 7-5 SWAC), 43, 52, 0, 95, Grambling St, (2-21; 0-13 SWAC), 19, 25, 0, 44
400598655, 2015-02-16, Howard, (13-13; 7-5 MEAC), 28, 32, 0, 60, MD-E Shore, (15-13; 8-5 MEAC), 36, 35, 0, 71
400587983, 2015-02-16, Pitt, (17-10; 6-7 ACC), 15, 34, 0, 49, UVA, (24-1; 12-1 ACC), 25, 36, 0, 61
400588459, 2015-02-16, Seton Hall, (15-11; 5-9 Big East), 20, 34, 0, 54, Villanova, (24-2; 11-2 Big East), 36, 44, 0, 80
400586290, 2015-02-16, Marist, (5-21; 4-12 MAAC), 30, 35, 0, 65, Monmouth, (15-12; 11-5 MAAC), 24, 45, 0, 69
400587984, 2015-02-16, Clemson, (15-11; 7-7 ACC), 21, 31, 0, 52, Georgia Tech, (12-14; 3-11 ACC), 23, 40, 0, 63
400598839, 2015-02-16, Non D-I School, NA, 31, 24, 0, 55, NJIT, (16-11; 10-2 home), 46, 43, 0, 89
400606913, 2015-02-16, Tenn Tech, (12-15; 4-9 OVC), 41, 38, 0, 79, East Tenn St, (16-10; 8-7 Southern), 47, 40, 0, 87
400595702, 2015-02-16, Abil Christian, (9-16; 3-9 Southland), 20, 29, 0, 49, Sam Houston, (21-5; 12-1 Southland), 37, 34, 0, 71
400595703, 2015-02-16, Cent Arkansas, (1-22; 1-11 Southland), 34, 36, 0, 70, Northwestern St, (14-10; 9-4 Southland), 49, 37, 0, 86
400598679, 2015-02-16, Coppin State, (6-20; 5-8 MEAC), 48, 48, 0, 96, Delaware State, (12-14; 6-5 MEAC), 36, 56, 0, 92
400598656, 2015-02-16, NC A&T, (6-21; 3-9 MEAC), 27, 29, 0, 56, Bethune-Cookman, (9-17; 5-6 MEAC), 42, 35, 0, 77
400589413, 2015-02-16, Coast Carolina, (19-8; 10-5 Big South), 25, 40, 0, 65, Radford, (19-9; 10-5 Big South), 30, 29, 0, 59
400595704, 2015-02-16, Houston Baptist, (11-12; 6-7 Southland), 25, 39, 0, 64, Lamar, (13-12; 7-6 Southland), 38, 34, 0, 72
400595705, 2015-02-16, SF Austin, (21-4; 11-1 Southland), 41, 49, 0, 90, Incarnate Word, (15-7; 7-5 Southland), 30, 46, 0, 76
400595706, 2015-02-16, SE Louisiana, (8-17; 5-7 Southland), 39, 30, 0, 69, McNeese State, (10-14; 4-9 Southland), 38, 36, 0, 74
400595707, 2015-02-16, New Orleans, (7-14; 3-9 Southland), 27, 26, 0, 53, Texas A&M-CC, (14-11; 9-4 Southland), 23, 32, 0, 55
400598654, 2015-02-16, NC Central, (20-6; 12-0 MEAC), 43, 30, 0, 73, Florida A&M, (1-24; 1-11 MEAC), 24, 24, 0, 48
400585842, 2015-02-16, Kansas, (21-5; 10-3 Big 12), 30, 31, 0, 61, West Virginia, (20-6; 8-5 Big 12), 33, 29, 0, 62
400598657, 2015-02-16, Hampton, (11-14; 7-5 MEAC), 52, 41, 0, 93, Morgan State, (7-19; 5-7 MEAC), 20, 45, 0, 65
400591054, 2015-02-16, Texas Southern, (13-12; 10-2 SWAC), 32, 32, 7, 71, Jackson State, (8-18; 6-7 SWAC), 32, 32, 6, 70
400588460, 2015-02-16, Butler, (19-7; 9-4 Big East), 25, 33, 0, 58, Creighton, (12-15; 3-11 Big East), 29, 27, 0, 56
400591077, 2015-02-16, Alcorn State, (6-26; 4-14 SWAC),  ,  , 0, 0, AR-Pine Bluff, (12-20; 9-9 SWAC),  ,  , 0, 0
400597396, 2015-02-17, Kentucky, (26-0; 13-0 SEC), 35, 31, 0, 66, Tennessee, (14-11; 6-7 SEC), 31, 17, 0, 48
400587985, 2015-02-17, Wake Forest, (12-15; 4-10 ACC), 41, 34, 0, 75, Notre Dame, (23-4; 11-3 ACC), 43, 45, 0, 88
400585843, 2015-02-17, Baylor, (19-7; 7-6 Big 12), 34, 20, 0, 54, Texas Tech, (12-15; 2-12 Big 12), 26, 23, 0, 49
400586832, 2015-02-17, Houston, (9-16; 1-12 American), 41, 26, 0, 67, USF, (8-19; 2-12 American), 36, 33, 0, 69
400588461, 2015-02-17, St John's, (17-9; 6-7 Big East), 23, 34, 0, 57, Georgetown, (17-8; 9-5 Big East), 33, 46, 0, 79
400596466, 2015-02-17, Stony Brook, (18-10; 9-4 Am. East), 29, 30, 0, 59, Albany, (18-8; 12-1 Am. East), 31, 25, 0, 56
400596498, 2015-02-17, UMBC, (3-23; 1-12 Am. East), 18, 34, 0, 52, Hartford, (13-13; 6-7 Am. East), 23, 32, 0, 55
400597397, 2015-02-17, South Carolina, (13-12; 4-9 SEC), 41, 23, 0, 64, Georgia, (16-9; 7-6 SEC), 23, 35, 0, 58
400597745, 2015-02-17, Cleveland State, (18-14; 11-5 Horizon), -, -, 0, 0, W Carolina, (15-17; 9-9 Southern), -, -, 0, 0
400599948, 2015-02-17, Saint Louis, (10-16; 2-11 A 10), 22, 32, 0, 54, VCU, (20-6; 10-3 A 10), 34, 40, 0, 74
400587008, 2015-02-17, Avila,  , 29, 31, 0, 60, South Dakota, (14-14; 7-6 Summit), 43, 41, 0, 84
400589414, 2015-02-17, Longwood, (8-20; 4-11 Big South), 39, 39, 0, 78, Liberty, (7-21; 1-14 Big South), 26, 46, 0, 72
400586462, 2015-02-17, Wichita State, (24-3; 14-1 MVC), 41, 43, 0, 84, S Illinois, (10-18; 3-12 MVC), 28, 34, 0, 62
400586461, 2015-02-17, Drake, (8-19; 5-10 MVC), 23, 29, 0, 52, Evansville, (19-8; 9-6 MVC), 30, 31, 0, 61
400762917, 2015-02-17, Alcorn State, (5-20; 4-9 SWAC), 26, 44, 0, 70, AR-Pine Bluff, (9-18; 6-7 SWAC), 21, 53, 0, 74
400585844, 2015-02-17, Texas, (17-9; 6-7 Big 12), 32, 37, 0, 69, Oklahoma, (18-8; 9-5 Big 12), 33, 38, 0, 71
400595523, 2015-02-17, Michigan State, (18-8; 9-4 Big Ten), 38, 42, 0, 80, Michigan, (13-13; 6-8 Big Ten), 23, 44, 0, 67
400597398, 2015-02-17, Alabama, (16-10; 6-7 SEC), 33, 46, 0, 79, Auburn, (12-14; 4-9 SEC), 36, 32, 0, 68
400597399, 2015-02-17, LSU, (18-8; 7-6 SEC), 36, 26, 0, 62, Texas A&M, (18-7; 9-4 SEC), 31, 37, 0, 68
400591683, 2015-02-17, San Diego State, (21-6; 11-3 MW), 31, 32, 0, 63, New Mexico, (14-12; 6-8 MW), 18, 28, 0, 46
400591682, 2015-02-17, Wyoming, (21-6; 10-4 MW), 13, 51, 0, 64, Nevada, (8-17; 4-9 MW), 27, 31, 0, 58
400595991, 2015-02-17, Non D-I School, NA, 26, 35, 0, 61, CS Northridge, (7-21; 2-10 Big West), 43, 46, 0, 89
400596434, 2015-02-17, Austin Peay, (8-22; 3-13 OVC),  ,  , 0, 0, E Kentucky, (19-11; 11-5 OVC),  ,  , 0, 0
400595524, 2015-02-18, Wisconsin, (24-2; 12-1 Big Ten), 31, 24, 0, 55, Penn State, (15-12; 3-11 Big Ten), 24, 23, 0, 47
400587986, 2015-02-18, Louisville, (20-6; 8-5 ACC), 32, 27, 0, 59, Syracuse, (17-9; 8-5 ACC), 28, 41, 0, 69
400586833, 2015-02-18, ECU, (11-15; 4-9 American), 19, 39, 0, 58, Tulsa, (18-7; 11-2 American), 35, 34, 0, 69
400586834, 2015-02-18, Xavier, (17-10; 7-7 Big East), 36, 23, 0, 59, Cincinnati, (17-9; 8-5 American), 24, 33, 0, 57
400587190, 2015-02-18, Army, (14-12; 5-10 Patriot), 36, 33, 0, 69, Colgate, (13-15; 10-5 Patriot), 46, 38, 0, 84
400587191, 2015-02-18, Boston U, (12-14; 8-7 Patriot), 27, 34, 0, 61, American U, (14-13; 7-8 Patriot), 15, 38, 0, 53
400587192, 2015-02-18, Holy Cross, (11-14; 6-9 Patriot), 40, 41, 0, 81, Lafayette, (15-11; 7-8 Patriot), 44, 45, 0, 89
400587193, 2015-02-18, Lehigh, (15-11; 9-6 Patriot), 20, 39, 0, 59, Navy, (10-17; 6-9 Patriot), 26, 27, 0, 53
400587194, 2015-02-18, Loyola (MD), (10-16; 6-9 Patriot), 24, 26, 0, 50, Bucknell, (16-12; 11-4 Patriot), 25, 36, 0, 61
400587559, 2015-02-18, Miami (OH), (10-16; 5-8 MAC), 31, 36, 0, 67, Bowling Green, (17-7; 9-4 MAC), 33, 23, 0, 56
400587560, 2015-02-18, N Illinois, (10-14; 4-9 MAC), 30, 36, 0, 66, Cent Michigan, (19-5; 9-4 MAC), 41, 27, 0, 68
400587561, 2015-02-18, Buffalo, (16-9; 7-6 MAC), 38, 40, 0, 78, E Michigan, (16-10; 5-8 MAC), 31, 32, 0, 63
400587562, 2015-02-18, Ohio, (9-15; 4-9 MAC), 36, 33, 0, 69, W Michigan, (16-10; 7-6 MAC), 38, 42, 0, 80
400587563, 2015-02-18, Toledo, (17-9; 9-4 MAC), 38, 30, 0, 68, Akron, (17-9; 8-5 MAC), 36, 30, 0, 66
400587564, 2015-02-18, Ball State, (7-17; 2-11 MAC), 25, 28, 0, 53, Kent State, (18-8; 9-4 MAC), 32, 26, 0, 58
400587987, 2015-02-18, VT, (10-16; 2-11 ACC), 26, 26, 0, 52, Miami (FL), (17-9; 7-6 ACC), 29, 47, 0, 76
400589415, 2015-02-18, Gardner-Webb, (16-12; 8-7 Big South), 25, 37, 0, 62, High Point, (20-7; 11-4 Big South), 37, 46, 0, 83
400589416, 2015-02-18, UNC Asheville, (13-13; 9-6 Big South), 35, 35, 0, 70, Winthrop, (15-11; 10-5 Big South), 46, 45, 0, 91
400591198, 2015-02-18, Duquesne, (8-16; 3-10 A 10), 27, 45, 0, 72, La Salle, (15-11; 7-6 A 10), 43, 44, 0, 87
400591199, 2015-02-18, Davidson, (18-6; 9-4 A 10), 23, 42, 0, 65, G Washington, (17-9; 7-6 A 10), 31, 32, 0, 63
400596483, 2015-02-18, UVM, (16-11; 11-3 Am. East), 27, 28, 0, 55, Binghamton, (5-24; 4-10 Am. East), 23, 34, 0, 57
400596530, 2015-02-18, Maine, (3-23; 2-11 Am. East), 31, 40, 0, 71, UMass Lowell, (12-15; 6-8 Am. East), 33, 49, 0, 82
400597400, 2015-02-18, Vanderbilt, (14-12; 4-9 SEC), 25, 22, 0, 47, Florida, (13-13; 6-7 SEC), 19, 31, 0, 50
400597815, 2015-02-18, Oakland, (14-14; 9-4 Horizon), 43, 33, 0, 76, Wright State, (11-16; 3-10 Horizon), 33, 34, 0, 67
400597849, 2015-02-18, Elon, (11-17; 3-12 CAA), 30, 33, 0, 63, Charleston, (8-20; 3-12 CAA), 35, 42, 0, 77
400597882, 2015-02-18, Drexel, (10-16; 8-7 CAA), 29, 49, 0, 78, JMU, (17-11; 10-5 CAA), 33, 49, 0, 82
400597909, 2015-02-18, Hofstra, (18-10; 9-6 CAA), 37, 50, 0, 87, Towson, (12-16; 5-10 CAA), 40, 42, 0, 82
400597935, 2015-02-18, William & Mary, (16-10; 10-5 CAA), 28, 36, 0, 64, Northeastern, (18-10; 10-5 CAA), 37, 38, 0, 75
400599596, 2015-02-18, Fordham, (8-16; 3-10 A 10), 30, 50, 0, 80, George Mason, (8-17; 3-10 A 10), 34, 34, 0, 68
400599781, 2015-02-18, UMass, (16-10; 9-4 A 10), 23, 36, 0, 59, URI, (18-6; 10-3 A 10), 28, 47, 0, 75
400599795, 2015-02-18, Richmond, (14-12; 7-6 A 10), 32, 39, 0, 71, St Bonaventure, (13-11; 6-7 A 10), 23, 33, 0, 56
400589417, 2015-02-18, Presbyterian, (9-19; 5-10 Big South), 23, 26, 0, 49, Charleston So, (17-9; 11-4 Big South), 30, 45, 0, 75
400586465, 2015-02-18, Northern Iowa, (25-2; 14-1 MVC), 30, 28, 0, 58, Loyola (CHI), (16-11; 6-9 MVC), 18, 21, 0, 39
400585846, 2015-02-18, Kansas State, (13-14; 6-8 Big 12), 15, 40, 0, 55, TCU, (16-10; 3-10 Big 12), 35, 34, 0, 69
400586464, 2015-02-18, Indiana State, (13-14; 9-6 MVC), 27, 29, 0, 56, Missouri State, (10-17; 4-11 MVC), 28, 32, 0, 60
400587009, 2015-02-18, South Dakota St, (20-8; 11-3 Summit), 41, 38, 0, 79, W Illinois, (8-16; 3-10 Summit), 36, 41, 0, 77
400597764, 2015-02-18, Detroit, (12-17; 5-9 Horizon), 34, 42, 0, 76, Green Bay, (21-6; 10-3 Horizon), 47, 49, 0, 96
400587989, 2015-02-18, UNC, (18-8; 8-5 ACC), 42, 39, 9, 90, Duke, (23-3; 10-3 ACC), 49, 32, 11, 92
400585845, 2015-02-18, Iowa State, (19-6; 9-4 Big 12), 33, 37, 0, 70, Oklahoma State, (17-9; 7-7 Big 12), 33, 32, 0, 65
400597401, 2015-02-18, Missouri, (7-19; 1-12 SEC), 29, 40, 0, 69, Arkansas, (21-5; 10-3 SEC), 37, 47, 0, 84
400586463, 2015-02-18, Illinois State, (16-11; 8-7 MVC), 28, 32, 0, 60, Bradley, (8-20; 3-12 MVC), 22, 25, 0, 47
400587988, 2015-02-18, Boston College, (9-16; 1-12 ACC), 32, 28, 0, 60, FSU, (15-12; 7-7 ACC), 27, 42, 0, 69
400588462, 2015-02-18, Providence, (19-8; 9-5 Big East), 41, 43, 0, 84, DePaul, (12-15; 6-8 Big East), 26, 31, 0, 57
400593317, 2015-02-18, UCLA, (16-11; 8-6 Pac-12), 36, 30, 0, 66, Arizona State, (14-12; 6-7 Pac-12), 32, 36, 0, 68
400595525, 2015-02-18, Northwestern, (12-14; 3-10 Big Ten), 36, 36, 0, 72, Minnesota, (16-11; 5-9 Big Ten), 36, 30, 0, 66
400590825, 2015-02-18, UMKC, (11-16; 6-4 WAC), 31, 25, 0, 56, Seattle, (12-13; 5-6 WAC), 41, 33, 0, 74
400591684, 2015-02-18, Colorado State, (22-5; 9-5 MW), 37, 44, 0, 81, Fresno State, (12-14; 7-6 MW), 32, 41, 0, 73
400591685, 2015-02-18, Utah State, (15-10; 8-5 MW), 40, 36, 0, 76, San Jose State, (2-23; 0-13 MW), 27, 27, 0, 54
400591686, 2015-02-18, Boise State, (19-7; 9-4 MW), 21, 32, 0, 53, UNLV, (14-12; 5-8 MW), 26, 22, 0, 48
400593318, 2015-02-18, Colorado, (12-13; 5-8 Pac-12), 22, 38, 0, 60, Oregon, (19-8; 9-5 Pac-12), 39, 34, 0, 73
400591514, 2015-02-19, Marshall, (9-17; 5-8 C-USA), 26, 25, 0, 51, Mid Tennessee, (14-13; 7-7 C-USA), 34, 56, 0, 90
400591515, 2015-02-19, Southern Miss, (7-18; 2-12 C-USA), 19, 19, 0, 38, Old Dominion, (19-6; 8-5 C-USA), 24, 40, 0, 64
400591200, 2015-02-19, Saint Joe's, (11-14; 5-8 A 10), 36, 28, 0, 64, Dayton, (20-5; 10-3 A 10), 36, 32, 0, 68
400595527, 2015-02-19, Nebraska, (13-13; 5-9 Big Ten), 33, 32, 0, 65, Maryland, (22-5; 10-4 Big Ten), 34, 35, 0, 69
400586835, 2015-02-19, Temple, (19-8; 10-4 American), 33, 25, 0, 58, SMU, (22-5; 13-2 American), 25, 42, 0, 67
400586236, 2015-02-19, Monmouth, (16-12; 12-5 MAAC), 25, 38, 0, 63, St Peter's, (13-15; 7-10 MAAC), 23, 35, 0, 58
400586837, 2015-02-19, UCF, (12-13; 5-9 American), 34, 35, 0, 69, Tulane, (14-11; 5-8 American), 24, 31, 0, 55
400588769, 2015-02-19, N Kentucky, (11-15; 5-6 A-Sun), 26, 42, 7, 75, Jacksonville, (9-19; 3-8 A-Sun), 37, 31, 15, 83
400588770, 2015-02-19, Lipscomb, (11-15; 5-6 A-Sun), 44, 34, 0, 78, North Florida, (17-11; 9-2 A-Sun), 42, 51, 0, 93
400588771, 2015-02-19, USC Upstate, (20-8; 7-4 A-Sun), 39, 34, 0, 73, Stetson, (8-19; 2-9 A-Sun), 26, 28, 0, 54
400588772, 2015-02-19, Kennesaw St, (9-19; 3-8 A-Sun), 31, 22, 0, 53, FGCU, (20-7; 10-1 A-Sun), 23, 31, 0, 54
400589219, 2015-02-19, Mercer, (15-13; 10-5 Southern), 35, 26, 0, 61, Chattanooga, (19-9; 12-3 Southern), 35, 39, 0, 74
400589220, 2015-02-19, The Citadel, (10-16; 5-10 Southern), 26, 22, 14, 62, Furman, (7-19; 4-11 Southern), 23, 25, 8, 56
400589221, 2015-02-19, UNC Greensboro, (8-20; 4-11 Southern), 35, 27, 0, 62, Wofford, (22-6; 13-2 Southern), 25, 52, 0, 77
400589418, 2015-02-19, Campbell, (9-19; 3-12 Big South), 23, 34, 0, 57, Coast Carolina, (20-8; 11-5 Big South), 47, 34, 0, 81
400591511, 2015-02-19, LA Tech, (21-6; 12-2 C-USA), 33, 40, 10, 83, Charlotte, (11-15; 4-9 C-USA), 29, 44, 9, 82
400591513, 2015-02-19, North Texas, (12-13; 6-7 C-USA), 38, 41, 0, 79, FAU, (8-16; 1-12 C-USA), 31, 41, 0, 72
400591728, 2015-02-19, Bryant, (13-13; 10-5 NEC), 26, 40, 0, 66, Wagner, (9-17; 7-8 NEC), 35, 30, 0, 65
400591769, 2015-02-19, Fair Dickinson, (7-19; 2-13 NEC), 26, 28, 0, 54, St Francis (BKN), (19-9; 13-2 NEC), 33, 37, 0, 70
400591786, 2015-02-19, LIU Brooklyn, (12-14; 8-7 NEC), 30, 35, 0, 65, Mt St Mary's, (13-13; 9-6 NEC), 38, 44, 0, 82
400591818, 2015-02-19, Robert Morris, (13-14; 9-6 NEC), 27, 49, 0, 76, Sacred Heart, (13-15; 7-8 NEC), 29, 51, 0, 80
400595526, 2015-02-19, Purdue, (18-9; 10-4 Big Ten), 27, 40, 0, 67, Indiana, (18-9; 8-6 Big Ten), 29, 34, 0, 63
400597866, 2015-02-19, UNC-Wilmington, (15-11; 10-5 CAA), 35, 24, 0, 59, Delaware, (8-18; 7-8 CAA), 25, 45, 0, 70
400600754, 2015-02-19, Canisius, (14-12; 9-8 MAAC), 29, 28, 12, 69, Siena, (10-16; 7-10 MAAC), 29, 28, 6, 63
400601220, 2015-02-19, Niagara, (5-21; 4-13 MAAC), 26, 29, 0, 55, Fairfield, (6-21; 4-13 MAAC), 16, 37, 0, 53
400601258, 2015-02-19, Quinnipiac, (14-12; 8-9 MAAC), 31, 52, 0, 83, Rider, (19-9; 13-4 MAAC), 41, 53, 0, 94
400595323, 2015-02-19, South Alabama, (9-18; 7-9 Sun Belt), 28, 23, 0, 51, Georgia State, (18-8; 11-4 Sun Belt), 36, 43, 0, 79
400595322, 2015-02-19, Troy, (10-15; 5-11 Sun Belt), 32, 33, 0, 65, Ga Southern, (18-6; 11-4 Sun Belt), 29, 33, 0, 62
400587011, 2015-02-19, IUPUI, (9-18; 5-8 Summit), 22, 26, 0, 48, North Dakota St, (19-8; 11-3 Summit), 24, 33, 0, 57
400587012, 2015-02-19, Oral Roberts, (15-12; 8-5 Summit), 43, 38, 0, 81, Omaha, (9-17; 3-11 Summit), 40, 38, 0, 78
400591512, 2015-02-19, Rice, (9-16; 6-7 C-USA), 27, 29, 0, 56, FIU, (13-13; 6-7 C-USA), 33, 27, 0, 60
400591516, 2015-02-19, W Kentucky, (16-9; 9-4 C-USA), 31, 35, 0, 66, UAB, (14-13; 10-4 C-USA), 28, 43, 0, 71
400595528, 2015-02-19, Rutgers, (10-17; 2-12 Big Ten), 24, 23, 0, 47, Iowa, (16-10; 7-6 Big Ten), 42, 39, 0, 81
400596435, 2015-02-19, E Kentucky, (16-10; 8-5 OVC), 35, 26, 0, 61, Belmont, (17-10; 9-5 OVC), 29, 37, 0, 66
400596436, 2015-02-19, SE Missouri St, (12-15; 6-8 OVC), 34, 38, 0, 72, SIU-ED, (11-14; 7-7 OVC), 32, 43, 0, 75
400596437, 2015-02-19, UT Martin, (17-9; 9-4 OVC), 33, 31, 11, 75, E Illinois, (15-12; 8-6 OVC), 28, 36, 9, 73
400597792, 2015-02-19, Milwaukee, (11-16; 6-7 Horizon), 31, 40, 0, 71, UIC, (7-21; 3-10 Horizon), 26, 34, 0, 60
400595326, 2015-02-19, Appalachian St, (9-15; 6-9 Sun Belt), 34, 34, 0, 68, UT-Arlington, (15-10; 9-6 Sun Belt), 32, 49, 0, 81
400595325, 2015-02-19, Texas State, (11-14; 5-11 Sun Belt), 20, 22, 0, 42, LA-Lafayette, (15-12; 9-7 Sun Belt), 30, 34, 0, 64
400586076, 2015-02-19, Idaho, (11-13; 6-7 Big Sky), 29, 36, 0, 65, N Arizona, (14-12; 9-4 Big Sky), 38, 34, 0, 72
400593319, 2015-02-19, USC, (10-16; 2-12 Pac-12), 31, 26, 0, 57, Arizona, (23-3; 11-2 Pac-12), 49, 38, 0, 87
400586078, 2015-02-19, E Washington, (20-6; 11-2 Big Sky), 34, 44, 0, 78, Southern Utah, (7-17; 4-9 Big Sky), 38, 37, 0, 75
400586079, 2015-02-19, Idaho State, (6-20; 3-11 Big Sky), 30, 47, 0, 77, Montana, (15-10; 11-3 Big Sky), 44, 44, 0, 88
400586836, 2015-02-19, UConn, (14-11; 7-6 American), 33, 39, 0, 72, Memphis, (16-10; 8-5 American), 39, 36, 0, 75
400587010, 2015-02-19, IPFW, (15-11; 8-5 Summit), 28, 35, 0, 63, Denver, (10-16; 4-9 Summit), 23, 24, 0, 47
400587351, 2015-02-19, Santa Clara, (11-16; 5-10 WCC), 24, 31, 0, 55, Pepperdine, (16-11; 9-7 WCC), 28, 36, 0, 64
400590828, 2015-02-19, UT Pan American, (9-18; 3-8 WAC), 34, 25, 0, 59, Grand Canyon, (16-11; 7-3 WAC), 27, 37, 0, 64
400591751, 2015-02-19, St Francis (PA), (14-12; 8-7 NEC), 30, 20, 0, 50, Cent Conn St, (4-24; 2-13 NEC), 34, 19, 0, 53
400595324, 2015-02-19, Arkansas State, (9-15; 4-11 Sun Belt), 26, 31, 0, 57, AR-Little Rock, (11-15; 6-10 Sun Belt), 36, 34, 0, 70
400597402, 2015-02-19, Ole Miss, (18-8; 9-4 SEC), 27, 44, 0, 71, Miss St, (12-14; 5-8 SEC), 32, 33, 0, 65
400586075, 2015-02-19, Weber State, (11-14; 6-8 Big Sky), 36, 38, 0, 74, Montana State, (6-20; 3-11 Big Sky), 32, 39, 0, 71
400590826, 2015-02-19, New Mexico St, (18-10; 10-1 WAC), 25, 26, 0, 51, Utah Valley, (9-16; 3-7 WAC), 19, 19, 0, 38
400587347, 2015-02-19, San Diego, (14-14; 7-9 WCC), 28, 34, 0, 62, BYU, (21-8; 11-5 WCC), 33, 42, 0, 75
400590827, 2015-02-19, Chicago State, (6-21; 2-8 WAC), 23, 28, 0, 51, CSU Bakersfield, (11-16; 6-5 WAC), 28, 36, 0, 64
400595992, 2015-02-19, Cal Poly, (13-11; 6-6 Big West), 25, 40, 0, 65, CS Fullerton, (9-17; 1-10 Big West), 23, 31, 0, 54
400595993, 2015-02-19, UC Davis, (20-4; 10-1 Big West), 27, 38, 0, 65, LBSU, (13-15; 7-5 Big West), 16, 42, 0, 58
400595994, 2015-02-19, UCSB, (13-12; 6-5 Big West), 29, 33, 0, 62, UC Riverside, (13-13; 6-6 Big West), 31, 33, 0, 64
400586074, 2015-02-19, North Dakota, (8-17; 4-10 Big Sky), 29, 41, 0, 70, Portland State, (13-11; 7-7 Big Sky), 36, 44, 0, 80
400586077, 2015-02-19, N Colorado, (12-13; 7-7 Big Sky), 22, 37, 0, 59, Sacramento St, (17-8; 11-3 Big Sky), 29, 37, 0, 66
400595995, 2015-02-19, Hawaii, (18-10; 6-6 Big West), 29, 31, 0, 60, UC Irvine, (15-10; 8-3 Big West), 29, 46, 0, 75
400587348, 2015-02-19, Gonzaga, (27-1; 15-0 WCC), 45, 41, 0, 86, Pacific, (10-17; 2-13 WCC), 37, 37, 0, 74
400593320, 2015-02-19, Utah, (21-4; 11-2 Pac-12), 16, 31, 0, 47, Oregon State, (16-10; 7-7 Pac-12), 14, 23, 0, 37
400587349, 2015-02-19, Portland, (16-11; 7-8 WCC), 28, 23, 0, 51, Saint Mary's, (20-6; 12-3 WCC), 30, 38, 0, 68
400587350, 2015-02-19, San Francisco, (11-16; 5-10 WCC), 39, 33, 0, 72, Loyola Mary, (8-20; 4-12 WCC), 20, 25, 0, 45
400764234, 2015-02-19, Morehead State, (17-17; 10-6 OVC),  ,  , 0, 0, Tennessee St, (5-26; 2-14 OVC),  ,  , 0, 0
400591268, 2015-02-20, Cornell, (12-13; 4-5 Ivy), 18, 33, 0, 51, Yale, (19-7; 8-1 Ivy), 25, 37, 0, 62
400591287, 2015-02-20, Princeton, (12-12; 5-3 Ivy), 27, 36, 0, 63, Dartmouth, (9-14; 2-7 Ivy), 32, 24, 0, 56
400591300, 2015-02-20, Penn, (7-15; 2-6 Ivy), 24, 22, 0, 46, Harvard, (18-5; 8-1 Ivy), 31, 38, 0, 69
400596467, 2015-02-20, Hartford, (13-14; 6-8 Am. East), 25, 39, 0, 64, Albany, (19-8; 13-1 Am. East), 25, 45, 0, 70
400597746, 2015-02-20, Cleveland State, (17-11; 11-3 Horizon), 32, 23, 11, 66, Green Bay, (21-7; 10-4 Horizon), 33, 22, 6, 61
400591232, 2015-02-20, Columbia, (12-11; 4-5 Ivy), 48, 28, 0, 76, Brown, (11-15; 2-7 Ivy), 28, 31, 0, 59
400601222, 2015-02-20, Iona, (22-6; 15-2 MAAC), 34, 38, 0, 72, Marist, (5-22; 4-13 MAAC), 35, 33, 0, 68
400586838, 2015-02-21, USF, (8-20; 2-13 American), 25, 35, 0, 60, ECU, (12-15; 5-9 American), 35, 38, 0, 73
400595529, 2015-02-21, Minnesota, (16-12; 5-10 Big Ten), 27, 26, 0, 53, Wisconsin, (25-2; 13-1 Big Ten), 35, 28, 0, 63
400587991, 2015-02-21, Georgia Tech, (12-15; 3-12 ACC), 29, 31, 0, 60, UNC, (19-8; 9-5 ACC), 43, 46, 0, 89
400585847, 2015-02-21, Oklahoma, (19-8; 10-5 Big 12), 30, 37, 12, 79, Texas Tech, (12-16; 2-13 Big 12), 29, 38, 8, 75
400599782, 2015-02-21, UMass, (16-11; 9-5 A 10), 30, 42, 0, 72, VCU, (21-6; 11-3 A 10), 35, 43, 0, 78
400587990, 2015-02-21, Pitt, (18-10; 7-7 ACC), 31, 34, 0, 65, Syracuse, (17-10; 8-6 ACC), 25, 36, 0, 61
400588465, 2015-02-21, Seton Hall, (15-12; 5-10 Big East), 40, 32, 0, 72, St John's, (18-9; 7-7 Big East), 41, 44, 0, 85
400597403, 2015-02-21, Texas A&M, (19-7; 10-4 SEC), 34, 28, 0, 62, South Carolina, (13-13; 4-10 SEC), 21, 31, 0, 52
400597867, 2015-02-21, Elon, (12-17; 4-12 CAA), 36, 38, 9, 83, Delaware, (8-19; 7-9 CAA), 38, 36, 1, 75
400585848, 2015-02-21, Kansas State, (13-15; 6-9 Big 12), 25, 17, 0, 42, Baylor, (20-7; 8-6 Big 12), 39, 30, 0, 69
400588775, 2015-02-21, Kennesaw St, (10-19; 4-8 A-Sun), 36, 25, 0, 61, Stetson, (8-20; 2-10 A-Sun), 28, 28, 0, 56
400596531, 2015-02-21, Maine, (3-24; 2-12 Am. East), 35, 31, 0, 66, UMBC, (4-23; 2-12 Am. East), 31, 42, 0, 73
400597404, 2015-02-21, Florida, (13-14; 6-8 SEC), 26, 37, 0, 63, LSU, (19-8; 8-6 SEC), 33, 37, 0, 70
400600755, 2015-02-21, Canisius, (15-12; 10-8 MAAC), 22, 43, 0, 65, Quinnipiac, (14-13; 8-10 MAAC), 29, 34, 0, 63
400586467, 2015-02-21, S Illinois, (10-19; 3-13 MVC), 23, 35, 0, 58, Indiana State, (14-14; 10-6 MVC), 37, 41, 0, 78
400587992, 2015-02-21, Miami (FL), (17-10; 7-7 ACC), 29, 24, 0, 53, Louisville, (21-6; 9-5 ACC), 19, 36, 0, 55
400585849, 2015-02-21, Iowa State, (20-6; 10-4 Big 12), 35, 50, 0, 85, Texas, (17-10; 6-8 Big 12), 31, 46, 0, 77
400588463, 2015-02-21, Butler, (19-8; 9-5 Big East), 22, 34, 0, 56, Xavier, (18-10; 8-7 Big East), 33, 40, 0, 73
400585850, 2015-02-21, West Virginia, (21-6; 9-5 Big 12), 25, 48, 0, 73, Oklahoma State, (17-10; 7-8 Big 12), 25, 38, 0, 63
400586289, 2015-02-21, Niagara, (6-21; 5-13 MAAC), 35, 30, 0, 65, Rider, (19-10; 13-5 MAAC), 35, 26, 0, 61
400587565, 2015-02-21, Kent State, (19-8; 10-4 MAC), 36, 28, 0, 64, Ohio, (9-16; 4-10 MAC), 25, 26, 0, 51
400587568, 2015-02-21, Buffalo, (17-9; 8-6 MAC), 36, 32, 0, 68, Bowling Green, (17-8; 9-5 MAC), 22, 34, 0, 56
400587570, 2015-02-21, Toledo, (18-9; 10-4 MAC), 42, 55, 0, 97, W Michigan, (16-11; 7-7 MAC), 38, 49, 0, 87
400588773, 2015-02-21, Lipscomb, (12-15; 6-6 A-Sun), 37, 50, 0, 87, Jacksonville, (9-20; 3-9 A-Sun), 40, 43, 0, 83
400591201, 2015-02-21, Dayton, (20-6; 10-4 A 10), 42, 31, 0, 73, Duquesne, (9-16; 4-10 A 10), 41, 42, 0, 83
400591770, 2015-02-21, Fair Dickinson, (7-20; 2-14 NEC), 24, 40, 0, 64, Mt St Mary's, (14-13; 10-6 NEC), 38, 37, 0, 75
400596439, 2015-02-21, Austin Peay, (7-20; 2-11 OVC), 25, 29, 0, 54, Murray State, (24-4; 14-0 OVC), 47, 42, 0, 89
400597928, 2015-02-21, UNC-Wilmington, (16-11; 11-5 CAA), 34, 39, 0, 73, Towson, (12-17; 5-11 CAA), 30, 39, 0, 69
400595329, 2015-02-21, Appalachian St, (9-16; 6-10 Sun Belt), 13, 30, 0, 43, Georgia State, (19-8; 12-4 Sun Belt), 44, 43, 0, 87
400601221, 2015-02-21, St Peter's, (13-16; 7-11 MAAC), 26, 17, 0, 43, Fairfield, (7-21; 5-13 MAAC), 27, 30, 0, 57
400588464, 2015-02-21, Villanova, (25-2; 12-2 Big East), 43, 44, 0, 87, Marquette, (11-15; 3-11 Big East), 34, 42, 0, 76
400597405, 2015-02-21, Missouri, (7-20; 1-13 SEC), 29, 24, 0, 53, Vanderbilt, (15-12; 5-9 SEC), 37, 39, 0, 76
400587013, 2015-02-21, IPFW, (15-12; 8-6 Summit), 29, 33, 0, 62, North Dakota St, (20-8; 12-3 Summit), 34, 32, 0, 66
400587014, 2015-02-21, IUPUI, (9-19; 5-9 Summit), 37, 25, 0, 62, South Dakota, (15-14; 8-6 Summit), 40, 37, 0, 77
400591520, 2015-02-21, LA Tech, (21-7; 12-3 C-USA), 21, 32, 0, 53, Old Dominion, (20-6; 9-5 C-USA), 39, 33, 0, 72
400591687, 2015-02-21, Nevada, (8-18; 4-10 MW), 26, 20, 0, 46, Boise State, (20-7; 10-4 MW), 44, 34, 0, 78
400595530, 2015-02-21, Penn State, (15-13; 3-12 Big Ten), 20, 19, 0, 39, Northwestern, (13-14; 4-10 Big Ten), 28, 32, 0, 60
400591752, 2015-02-21, Sacred Heart, (13-16; 7-9 NEC), 32, 34, 7, 73, Cent Conn St, (5-24; 3-13 NEC), 26, 40, 10, 76
400585851, 2015-02-21, TCU, (16-11; 3-11 Big 12), 29, 43, 0, 72, Kansas, (22-5; 11-3 Big 12), 35, 46, 0, 81
400587994, 2015-02-21, Notre Dame, (24-4; 12-3 ACC), 37, 50, 0, 87, Boston College, (9-17; 1-13 ACC), 32, 38, 0, 70
400586466, 2015-02-21, Bradley, (8-21; 3-13 MVC), 23, 16, 0, 39, Northern Iowa, (26-2; 15-1 MVC), 27, 29, 0, 56
400597406, 2015-02-21, Arkansas, (22-5; 11-3 SEC), 32, 33, 0, 65, Miss St, (12-15; 5-9 SEC), 33, 28, 0, 61
400587354, 2015-02-21, San Francisco, (12-16; 6-10 WCC), 31, 25, 0, 56, Pepperdine, (16-12; 9-8 WCC), 19, 35, 0, 54
400589420, 2015-02-21, Charleston So, (18-9; 12-4 Big South), 39, 47, 0, 86, Campbell, (9-20; 3-13 Big South), 32, 25, 0, 57
400591729, 2015-02-21, Robert Morris, (14-14; 10-6 NEC), 31, 45, 0, 76, Bryant, (13-14; 10-6 NEC), 36, 34, 0, 70
400596037, 2015-02-21, St Francis (PA), (14-13; 8-8 NEC), 27, 27, 0, 54, St Francis (BKN), (20-9; 14-2 NEC), 28, 38, 0, 66
400597883, 2015-02-21, Drexel, (10-17; 8-8 CAA), 26, 36, 11, 73, Northeastern, (19-10; 11-5 CAA), 33, 29, 21, 83
400598572, 2015-02-21, Norfolk State, (17-11; 10-3 MEAC), 39, 60, 0, 99, Coppin State, (6-21; 5-9 MEAC), 36, 45, 0, 81
400599609, 2015-02-21, URI, (19-6; 11-3 A 10), 41, 30, 0, 71, George Mason, (8-18; 3-11 A 10), 27, 29, 0, 56
400599723, 2015-02-21, G Washington, (17-10; 7-7 A 10), 25, 23, 0, 48, Richmond, (15-12; 8-6 A 10), 27, 29, 0, 56
400586084, 2015-02-21, E Washington, (20-7; 11-3 Big Sky), 32, 37, 0, 69, N Arizona, (15-12; 10-4 Big Sky), 29, 44, 0, 73
400587993, 2015-02-21, Clemson, (15-12; 7-8 ACC), 27, 29, 0, 56, Duke, (24-3; 11-3 ACC), 42, 36, 0, 78
400598659, 2015-02-21, Morgan State, (7-20; 5-8 MEAC), 34, 25, 0, 59, NC Central, (21-6; 13-0 MEAC), 44, 30, 0, 74
400587569, 2015-02-21, Ball State, (7-18; 2-12 MAC), 36, 24, 0, 60, Cent Michigan, (20-5; 10-4 MAC), 41, 42, 0, 83
400589224, 2015-02-21, VMI, (11-16; 7-9 Southern), 46, 40, 27, 113, W Carolina, (13-15; 8-8 Southern), 39, 47, 25, 111
400589421, 2015-02-21, Radford, (20-9; 11-5 Big South), 38, 37, 0, 75, UNC Asheville, (13-14; 9-7 Big South), 25, 43, 0, 68
400591787, 2015-02-21, Wagner, (10-17; 8-8 NEC), 33, 27, 0, 60, LIU Brooklyn, (12-15; 8-8 NEC), 19, 28, 0, 47
400596542, 2015-02-21, UNH, (17-10; 10-4 Am. East), 36, 40, 0, 76, UMass Lowell, (12-16; 6-9 Am. East), 26, 34, 0, 60
400598661, 2015-02-21, Florida A&M, (1-25; 1-12 MEAC), 30, 27, 0, 57, Bethune-Cookman, (10-17; 6-6 MEAC), 38, 26, 0, 64
400586082, 2015-02-21, Idaho State, (6-21; 3-12 Big Sky), 31, 22, 0, 53, Montana State, (7-20; 4-11 Big Sky), 24, 43, 0, 67
400589422, 2015-02-21, Winthrop, (16-11; 11-5 Big South), 32, 51, 0, 83, Longwood, (8-21; 4-12 Big South), 28, 31, 0, 59
400595709, 2015-02-21, Texas A&M-CC, (14-12; 9-5 Southland), 26, 42, 0, 68, Incarnate Word, (16-7; 8-5 Southland), 29, 45, 0, 74
400595330, 2015-02-21, AR-Little Rock, (12-15; 7-10 Sun Belt), 25, 38, 0, 63, Troy, (10-16; 5-12 Sun Belt), 15, 43, 0, 58
400591517, 2015-02-21, Southern Miss, (7-19; 2-13 C-USA), 21, 22, 0, 43, Charlotte, (12-15; 5-9 C-USA), 36, 35, 0, 71
400595708, 2015-02-21, Sam Houston, (22-5; 13-1 Southland), 40, 30, 0, 70, Cent Arkansas, (1-23; 1-12 Southland), 17, 25, 0, 42
400596441, 2015-02-21, Tennessee St, (5-23; 2-11 OVC), 27, 23, 0, 50, Jacksonville St, (12-17; 5-9 OVC), 28, 27, 0, 55
400587355, 2015-02-21, Santa Clara, (12-16; 6-10 WCC), 35, 35, 0, 70, Loyola Mary, (8-21; 4-13 WCC), 21, 42, 0, 63
400587995, 2015-02-21, VT, (10-17; 2-12 ACC), 25, 28, 0, 53, NC State, (16-11; 7-7 ACC), 32, 37, 0, 69
400591233, 2015-02-21, Cornell, (12-14; 4-6 Ivy), 34, 22, 0, 56, Brown, (12-15; 3-7 Ivy), 23, 34, 0, 57
400591518, 2015-02-21, North Texas, (13-13; 7-7 C-USA), 29, 41, 0, 70, FIU, (13-14; 6-8 C-USA), 25, 31, 0, 56
400591688, 2015-02-21, Air Force, (12-14; 5-10 MW), 26, 27, 0, 53, Colorado State, (23-5; 10-5 MW), 39, 27, 0, 66
400591689, 2015-02-21, UNLV, (15-12; 6-8 MW), 39, 37, 0, 76, New Mexico, (14-13; 6-9 MW), 34, 34, 0, 68
400598663, 2015-02-21, MD-E Shore, (16-13; 9-5 MEAC), 41, 27, 0, 68, S Carolina St, (10-18; 7-6 MEAC), 34, 22, 0, 56
400598664, 2015-02-21, Howard, (14-13; 8-5 MEAC), 23, 27, 0, 50, Savannah State, (6-19; 2-9 MEAC), 30, 18, 0, 48
400598823, 2015-02-21, Miss Valley St, (5-22; 4-10 SWAC), 36, 38, 0, 74, PV A&M, (10-16; 8-5 SWAC), 47, 37, 0, 84
400591055, 2015-02-21, Grambling St, (2-22; 0-14 SWAC), 16, 17, 0, 33, Jackson State, (9-18; 7-7 SWAC), 36, 36, 0, 72
400593321, 2015-02-21, Cal, (16-11; 6-8 Pac-12), 23, 38, 0, 61, Stanford, (17-9; 8-6 Pac-12), 35, 37, 0, 72
400601533, 2015-02-21, Alabama A&M, (7-16; 6-7 SWAC), 33, 30, 0, 63, Southern, (14-14; 11-3 SWAC), 34, 38, 0, 72
400598677, 2015-02-21, Delaware State, (13-14; 7-5 MEAC), 27, 47, 0, 74, Hampton, (11-15; 7-6 MEAC), 36, 35, 0, 71
400601548, 2015-02-21, Alabama State, (15-7; 11-2 SWAC), 37, 34, 0, 71, Alcorn State, (5-21; 4-10 SWAC), 27, 40, 0, 67
400597407, 2015-02-21, Auburn, (12-15; 4-10 SEC), 26, 49, 0, 75, Kentucky, (27-0; 14-0 SEC), 52, 58, 0, 110
400588774, 2015-02-21, N Kentucky, (11-16; 5-7 A-Sun), 30, 39, 0, 69, North Florida, (18-11; 10-2 A-Sun), 35, 53, 0, 88
400588776, 2015-02-21, USC Upstate, (20-9; 7-5 A-Sun), 34, 38, 0, 72, FGCU, (21-7; 11-1 A-Sun), 44, 42, 0, 86
400589223, 2015-02-21, Mercer, (16-13; 11-5 Southern), 40, 22, 0, 62, Samford, (12-17; 5-11 Southern), 30, 31, 0, 61
400589225, 2015-02-21, The Citadel, (10-17; 5-11 Southern), 20, 32, 0, 52, Wofford, (23-6; 14-2 Southern), 35, 43, 0, 78
400589419, 2015-02-21, Liberty, (7-22; 1-15 Big South), 24, 43, 0, 67, Gardner-Webb, (17-12; 9-7 Big South), 35, 42, 0, 77
400589423, 2015-02-21, Presbyterian, (9-20; 5-11 Big South), 29, 29, 0, 58, High Point, (21-7; 12-4 Big South), 39, 28, 0, 67
400591202, 2015-02-21, Fordham, (8-17; 3-11 A 10), 25, 32, 0, 57, Davidson, (19-6; 10-4 A 10), 38, 38, 0, 76
400591253, 2015-02-21, Columbia, (13-11; 5-5 Ivy), 30, 26, 0, 56, Yale, (19-8; 8-2 Ivy), 22, 28, 0, 50
400591288, 2015-02-21, Penn, (7-16; 2-7 Ivy), 28, 34, 0, 62, Dartmouth, (10-14; 3-7 Ivy), 29, 38, 0, 67
400591301, 2015-02-21, Princeton, (12-13; 5-4 Ivy), 37, 18, 0, 55, Harvard, (19-5; 9-1 Ivy), 29, 34, 0, 63
400591519, 2015-02-21, Rice, (10-16; 7-7 C-USA), 39, 37, 0, 76, FAU, (8-17; 1-13 C-USA), 32, 37, 0, 69
400595710, 2015-02-21, McNeese State, (10-15; 4-10 Southland), 25, 28, 0, 53, Lamar, (14-12; 8-6 Southland), 23, 35, 0, 58
400595711, 2015-02-21, Nicholls State, (7-16; 4-9 Southland), 30, 41, 0, 71, SF Austin, (22-4; 12-1 Southland), 41, 45, 0, 86
400596484, 2015-02-21, Binghamton, (5-25; 4-11 Am. East), 27, 25, 0, 52, Stony Brook, (19-10; 10-4 Am. East), 32, 32, 0, 64
400597765, 2015-02-21, Detroit, (13-17; 6-9 Horizon), 40, 43, 0, 83, Youngstown St, (11-18; 2-12 Horizon), 35, 35, 0, 70
400599929, 2015-02-21, St Bonaventure, (14-11; 7-7 A 10), 30, 22, 18, 70, Saint Joe's, (11-15; 5-9 A 10), 29, 23, 8, 60
400601234, 2015-02-21, Manhattan, (14-12; 11-6 MAAC), 35, 45, 0, 80, Siena, (10-17; 7-11 MAAC), 33, 41, 0, 74
400595712, 2015-02-21, Northwestern St, (15-10; 10-4 Southland), 34, 53, 0, 87, New Orleans, (7-15; 3-10 Southland), 48, 36, 0, 84
400587567, 2015-02-21, Miami (OH), (11-16; 6-8 MAC), 23, 25, 9, 57, Akron, (17-10; 8-6 MAC), 22, 26, 4, 52
400595328, 2015-02-21, South Alabama, (9-19; 7-10 Sun Belt), 40, 34, 0, 74, Ga Southern, (19-6; 12-4 Sun Belt), 32, 48, 0, 80
400597408, 2015-02-21, Tennessee, (14-12; 6-8 SEC), 30, 27, 0, 57, Ole Miss, (19-8; 10-4 SEC), 27, 32, 0, 59
400586468, 2015-02-21, Loyola (CHI), (16-12; 6-10 MVC), 22, 38, 0, 60, Illinois State, (17-11; 9-7 MVC), 26, 41, 0, 67
400587015, 2015-02-21, Oral Roberts, (15-13; 8-6 Summit), 22, 30, 0, 52, South Dakota St, (21-8; 12-3 Summit), 45, 36, 0, 81
400587016, 2015-02-21, Denver, (11-16; 5-9 Summit), 24, 35, 0, 59, W Illinois, (8-17; 3-11 Summit), 20, 26, 0, 46
400588466, 2015-02-21, DePaul, (12-16; 6-9 Big East), 27, 36, 0, 63, Georgetown, (18-8; 10-5 Big East), 30, 38, 0, 68
400589222, 2015-02-21, East Tenn St, (16-11; 8-8 Southern), 30, 29, 0, 59, Chattanooga, (20-9; 13-3 Southern), 22, 45, 0, 67
400591521, 2015-02-21, Marshall, (9-18; 5-9 C-USA), 22, 32, 0, 54, UAB, (15-13; 11-4 C-USA), 31, 41, 0, 72
400595713, 2015-02-21, Abil Christian, (9-17; 3-10 Southland), 33, 21, 0, 54, SE Louisiana, (9-17; 6-7 Southland), 28, 27, 0, 55
400595996, 2015-02-21, UCSB, (14-12; 7-5 Big West), 49, 20, 0, 69, CS Fullerton, (9-18; 1-11 Big West), 30, 24, 0, 54
400596442, 2015-02-21, UT Martin, (17-10; 9-5 OVC), 36, 32, 0, 68, SIU-ED, (12-14; 8-7 OVC), 37, 39, 0, 76
400597409, 2015-02-21, Georgia, (17-9; 8-6 SEC), 24, 37, 5, 66, Alabama, (16-11; 6-8 SEC), 24, 37, 4, 65
400595327, 2015-02-21, UL Monroe, (18-9; 12-4 Sun Belt), 36, 32, 0, 68, Arkansas State, (10-15; 5-11 Sun Belt), 36, 34, 0, 70
400597824, 2015-02-21, Wright State, (11-17; 3-11 Horizon), 24, 24, 0, 48, Valparaiso, (25-4; 12-2 Horizon), 23, 32, 0, 55
400595331, 2015-02-21, LA-Lafayette, (16-12; 10-7 Sun Belt), 40, 41, 0, 81, UT-Arlington, (15-11; 9-7 Sun Belt), 27, 43, 0, 70
400596443, 2015-02-21, Belmont, (18-10; 10-5 OVC), 43, 45, 0, 88, Tenn Tech, (12-16; 4-10 OVC), 36, 46, 0, 82
400601536, 2015-02-21, AR-Pine Bluff, (9-19; 6-8 SWAC), 31, 19, 0, 50, Texas Southern, (14-12; 11-2 SWAC), 30, 26, 0, 56
400587566, 2015-02-21, E Michigan, (17-10; 6-8 MAC), 40, 33, 0, 73, N Illinois, (10-15; 4-10 MAC), 24, 41, 0, 65
400593322, 2015-02-21, UCLA, (16-12; 8-7 Pac-12), 18, 29, 0, 47, Arizona, (24-3; 12-2 Pac-12), 32, 25, 0, 57
400586081, 2015-02-21, Weber State, (11-15; 6-9 Big Sky), 29, 34, 0, 63, Montana, (16-10; 12-3 Big Sky), 36, 38, 0, 74
400586083, 2015-02-21, Idaho, (11-14; 6-8 Big Sky), 35, 34, 8, 77, Southern Utah, (8-17; 5-9 Big Sky), 32, 37, 10, 79
400590831, 2015-02-21, New Mexico St, (19-10; 11-1 WAC), 34, 38, 0, 72, Grand Canyon, (16-12; 7-4 WAC), 26, 29, 0, 55
400591522, 2015-02-21, UTSA, (13-12; 7-7 C-USA), 30, 32, 0, 62, UTEP, (19-7; 11-3 C-USA), 30, 39, 0, 69
400591690, 2015-02-21, Fresno State, (12-15; 7-7 MW), 30, 49, 0, 79, Utah State, (16-10; 9-5 MW), 34, 51, 0, 85
400590832, 2015-02-21, UT Pan American, (9-19; 3-9 WAC), 25, 24, 0, 49, Utah Valley, (10-16; 4-7 WAC), 33, 39, 0, 72
400586839, 2015-02-21, Cincinnati, (18-9; 9-5 American), 25, 38, 0, 63, Houston, (9-17; 1-13 American), 28, 25, 0, 53
400587353, 2015-02-21, Portland, (16-12; 7-9 WCC), 32, 33, 12, 77, Pacific, (11-17; 3-13 WCC), 26, 39, 14, 79
400590829, 2015-02-21, Chicago State, (6-22; 2-9 WAC), 11, 20, 0, 31, Seattle, (13-13; 6-6 WAC), 25, 32, 0, 57
400590830, 2015-02-21, UMKC, (11-17; 6-5 WAC), 29, 33, 0, 62, CSU Bakersfield, (12-16; 7-5 WAC), 25, 39, 0, 64
400591691, 2015-02-21, San Diego State, (22-6; 12-3 MW), 35, 39, 0, 74, San Jose State, (2-24; 0-14 MW), 36, 20, 0, 56
400595997, 2015-02-21, Cal Poly, (13-12; 6-7 Big West), 22, 22, 0, 44, UC Riverside, (14-13; 7-6 Big West), 30, 18, 0, 48
400595998, 2015-02-21, CS Northridge, (7-22; 2-11 Big West), 34, 24, 0, 58, UC Irvine, (16-10; 9-3 Big West), 41, 26, 0, 67
400595999, 2015-02-21, Hawaii, (18-11; 6-7 Big West), 39, 28, 0, 67, UC Davis, (21-4; 11-1 Big West), 36, 38, 0, 74
400587352, 2015-02-21, Gonzaga, (28-1; 16-0 WCC), 29, 41, 0, 70, Saint Mary's, (20-7; 12-4 WCC), 40, 20, 0, 60
400586080, 2015-02-21, North Dakota, (8-18; 4-11 Big Sky), 29, 37, 0, 66, Sacramento St, (18-8; 12-3 Big Sky), 32, 42, 0, 74
400586085, 2015-02-21, N Colorado, (12-14; 7-8 Big Sky), 35, 40, 0, 75, Portland State, (14-11; 8-7 Big Sky), 40, 51, 0, 91
400593323, 2015-02-21, Colorado, (12-14; 5-9 Pac-12), 12, 46, 0, 58, Oregon State, (17-10; 8-7 Pac-12), 34, 38, 0, 72
400597850, 2015-02-21, Charleston, (9-24; 3-15 CAA),  ,  , 0, 0, JMU, (19-13; 12-6 CAA),  ,  , 0, 0
400587195, 2015-02-22, American U, (14-14; 7-9 Patriot), 29, 34, 0, 63, Army, (15-12; 6-10 Patriot), 36, 36, 0, 72
400587196, 2015-02-22, Boston U, (12-15; 8-8 Patriot), 28, 41, 0, 69, Bucknell, (17-12; 12-4 Patriot), 38, 40, 0, 78
400587197, 2015-02-22, Colgate, (13-16; 10-6 Patriot), 39, 26, 13, 78, Loyola (MD), (11-16; 7-9 Patriot), 33, 32, 15, 80
400587199, 2015-02-22, Lafayette, (16-11; 8-8 Patriot), 32, 31, 0, 63, Lehigh, (15-12; 9-7 Patriot), 27, 34, 0, 61
400763914, 2015-02-22, Charleston, (8-21; 3-13 CAA), 28, 33, 0, 61, JMU, (18-11; 11-5 CAA), 32, 36, 0, 68
400595532, 2015-02-22, OSU, (19-8; 8-6 Big Ten), 23, 34, 0, 57, Michigan, (14-13; 7-8 Big Ten), 39, 25, 0, 64
400587198, 2015-02-22, Holy Cross, (11-15; 6-10 Patriot), 27, 43, 0, 70, Navy, (11-17; 7-9 Patriot), 40, 44, 0, 84
400589226, 2015-02-22, Furman, (7-20; 4-12 Southern), 25, 24, 0, 49, UNC Greensboro, (9-20; 5-11 Southern), 41, 43, 0, 84
400591523, 2015-02-22, W Kentucky, (16-10; 9-5 C-USA), 35, 31, 0, 66, Mid Tennessee, (15-13; 8-7 C-USA), 38, 30, 0, 68
400586469, 2015-02-22, Missouri State, (10-18; 4-12 MVC), 14, 29, 0, 43, Drake, (9-19; 6-10 MVC), 35, 43, 0, 78
400586842, 2015-02-22, Memphis, (17-10; 9-5 American), 31, 28, 16, 75, UCF, (12-14; 5-10 American), 28, 31, 6, 65
400599773, 2015-02-22, La Salle, (15-12; 7-7 A 10), 25, 33, 6, 64, Saint Louis, (11-16; 3-11 A 10), 19, 39, 10, 68
400593324, 2015-02-22, Utah, (21-5; 11-3 Pac-12), 27, 31, 0, 58, Oregon, (20-8; 10-5 Pac-12), 32, 37, 0, 69
400595533, 2015-02-22, Iowa, (17-10; 8-6 Big Ten), 42, 32, 0, 74, Nebraska, (13-14; 5-10 Big Ten), 16, 30, 0, 46
400597793, 2015-02-22, UIC, (7-22; 3-11 Horizon), 27, 29, 0, 56, Oakland, (15-14; 10-4 Horizon), 45, 36, 0, 81
400597747, 2015-02-22, Cleveland State, (17-12; 11-4 Horizon), 29, 31, 0, 60, Milwaukee, (12-16; 7-7 Horizon), 33, 33, 0, 66
400586470, 2015-02-22, Evansville, (19-9; 9-7 MVC), 14, 29, 0, 43, Wichita State, (25-3; 15-1 MVC), 30, 32, 0, 62
400586840, 2015-02-22, Tulane, (14-12; 5-9 American), 27, 33, 0, 60, UConn, (15-11; 8-6 American), 34, 33, 0, 67
400601223, 2015-02-22, Monmouth, (16-13; 12-6 MAAC), 40, 28, 0, 68, Iona, (23-6; 16-2 MAAC), 26, 43, 0, 69
400597910, 2015-02-22, William & Mary, (17-10; 11-5 CAA), 41, 39, 0, 80, Hofstra, (18-11; 9-7 CAA), 34, 44, 0, 78
400595534, 2015-02-22, Indiana, (19-9; 9-6 Big Ten), 40, 44, 0, 84, Rutgers, (10-18; 2-13 Big Ten), 30, 24, 0, 54
400586841, 2015-02-22, Temple, (19-9; 10-5 American), 22, 17, 0, 39, Tulsa, (19-7; 12-2 American), 26, 29, 0, 55
400587996, 2015-02-22, FSU, (15-13; 7-8 ACC), 21, 20, 0, 41, UVA, (25-1; 13-1 ACC), 22, 29, 0, 51
400596440, 2015-02-22, SE Missouri St, (12-16; 6-9 OVC), 41, 24, 0, 65, E Illinois, (16-12; 9-6 OVC), 35, 38, 0, 73
400595531, 2015-02-22, Michigan State, (19-8; 10-4 Big Ten), 26, 34, 0, 60, Illinois, (17-10; 7-7 Big Ten), 22, 31, 0, 53
400593325, 2015-02-22, Washington, (15-11; 4-10 Pac-12), 37, 50, 0, 87, Washington St, (11-15; 5-9 Pac-12), 41, 43, 0, 84
400593326, 2015-02-22, USC, (10-17; 2-13 Pac-12), 24, 35, 0, 59, Arizona State, (15-12; 7-7 Pac-12), 27, 37, 0, 64
400587997, 2015-02-23, Louisville, (22-6; 10-5 ACC), 17, 35, 0, 52, Georgia Tech, (12-16; 3-13 ACC), 24, 27, 0, 51
400589424, 2015-02-23, Coast Carolina, (21-8; 12-5 Big South), 31, 41, 0, 72, Longwood, (8-22; 4-13 Big South), 31, 28, 0, 59
400598667, 2015-02-23, Delaware State, (13-15; 7-6 MEAC), 35, 36, 0, 71, Norfolk State, (18-11; 11-3 MEAC), 30, 51, 0, 81
400601235, 2015-02-23, Manhattan, (15-12; 12-6 MAAC), 27, 40, 0, 67, Marist, (5-23; 4-14 MAAC), 31, 23, 0, 54
400762920, 2015-02-23, Austin Peay, (7-21; 2-12 OVC), 30, 34, 0, 64, E Kentucky, (17-10; 9-5 OVC), 33, 43, 0, 76
400595714, 2015-02-23, Northwestern St, (16-10; 11-4 Southland), 33, 46, 0, 79, Nicholls State, (7-17; 4-10 Southland), 33, 24, 0, 57
400598665, 2015-02-23, Howard, (15-13; 9-5 MEAC), 27, 48, 0, 75, S Carolina St, (10-19; 7-7 MEAC), 31, 34, 0, 65
400598666, 2015-02-23, Morgan State, (7-21; 5-9 MEAC), 26, 27, 4, 57, NC A&T, (7-21; 4-9 MEAC), 20, 33, 7, 60
400588467, 2015-02-23, Xavier, (18-11; 8-8 Big East), 20, 37, 0, 57, St John's, (19-9; 8-7 Big East), 28, 30, 0, 58
400595715, 2015-02-23, Houston Baptist, (11-13; 6-8 Southland), 31, 33, 0, 64, Incarnate Word, (17-7; 9-5 Southland), 29, 48, 0, 77
400595716, 2015-02-23, Lamar, (14-13; 8-7 Southland), 32, 42, 0, 74, SF Austin, (23-4; 13-1 Southland), 54, 49, 0, 103
400595717, 2015-02-23, New Orleans, (8-15; 4-10 Southland), 30, 44, 0, 74, SE Louisiana, (9-18; 6-8 Southland), 33, 40, 0, 73
400596438, 2015-02-23, Morehead State, (13-16; 8-6 OVC), 54, 32, 0, 86, Tennessee St, (5-24; 2-12 OVC), 38, 32, 0, 70
400601549, 2015-02-23, Alabama A&M, (8-16; 7-7 SWAC), 36, 37, 0, 73, Alcorn State, (5-22; 4-11 SWAC), 30, 39, 0, 69
400598681, 2015-02-23, Florida A&M, (1-26; 1-13 MEAC), 25, 27, 0, 52, Savannah State, (7-19; 3-9 MEAC), 32, 31, 0, 63
400598824, 2015-02-23, Miss Valley St, (5-23; 4-11 SWAC), 32, 41, 0, 73, Texas Southern, (15-12; 12-2 SWAC), 38, 45, 0, 83
400585852, 2015-02-23, Kansas, (22-6; 11-4 Big 12), 30, 33, 0, 63, Kansas State, (14-15; 7-9 Big 12), 31, 39, 0, 70
400591031, 2015-02-23, Alabama State, (16-7; 12-2 SWAC), 27, 29, 0, 56, Southern, (14-15; 11-4 SWAC), 31, 23, 0, 54
400598831, 2015-02-23, AR-Pine Bluff, (9-20; 6-9 SWAC), 28, 30, 0, 58, PV A&M, (11-16; 9-5 SWAC), 42, 37, 0, 79
400595535, 2015-02-24, Wisconsin, (25-3; 13-2 Big Ten), 20, 33, 0, 53, Maryland, (23-5; 11-4 Big Ten), 31, 28, 0, 59
400588468, 2015-02-24, Providence, (19-9; 9-6 Big East), 25, 36, 0, 61, Villanova, (26-2; 13-2 Big East), 34, 55, 0, 89
400585853, 2015-02-24, Texas, (17-11; 6-9 Big 12), 25, 39, 0, 64, West Virginia, (22-6; 10-5 Big 12), 36, 35, 0, 71
400587571, 2015-02-24, W Michigan, (17-11; 8-7 MAC), 25, 28, 0, 53, Ball State, (7-19; 2-13 MAC), 24, 24, 0, 48
400587572, 2015-02-24, Akron, (17-11; 8-7 MAC), 34, 28, 0, 62, Buffalo, (18-9; 9-6 MAC), 33, 34, 0, 67
400587573, 2015-02-24, Bowling Green, (18-8; 10-5 MAC), 40, 36, 0, 76, Ohio, (9-17; 4-11 MAC), 22, 43, 0, 65
400587574, 2015-02-24, Kent State, (19-9; 10-5 MAC), 38, 39, 4, 81, Miami (OH), (12-16; 7-8 MAC), 30, 47, 9, 86
400587576, 2015-02-24, Cent Michigan, (21-5; 11-4 MAC), 33, 39, 0, 72, E Michigan, (17-11; 6-9 MAC), 28, 28, 0, 56
400597410, 2015-02-24, LSU, (20-8; 9-6 SEC), 41, 43, 0, 84, Auburn, (12-16; 4-11 SEC), 34, 27, 0, 61
400597411, 2015-02-24, South Carolina, (13-14; 4-11 SEC), 22, 29, 0, 51, Alabama, (17-11; 7-8 SEC), 22, 37, 0, 59
400587999, 2015-02-24, Syracuse, (18-10; 9-6 ACC), 27, 38, 0, 65, Notre Dame, (24-5; 12-4 ACC), 22, 38, 0, 60
400587998, 2015-02-24, NC State, (17-11; 8-7 ACC), 29, 29, 0, 58, UNC, (19-9; 9-6 ACC), 18, 28, 0, 46
400595718, 2015-02-24, Texas A&M-CC, (15-12; 10-5 Southland), 28, 39, 0, 67, Abil Christian, (9-18; 3-11 Southland), 24, 20, 0, 44
400595719, 2015-02-24, McNeese State, (11-15; 5-10 Southland), 38, 39, 0, 77, Cent Arkansas, (1-24; 1-13 Southland), 33, 27, 0, 60
400600756, 2015-02-24, Niagara, (7-21; 6-13 MAAC), 31, 51, 0, 82, Canisius, (15-13; 10-9 MAAC), 35, 36, 0, 71
400597413, 2015-02-24, Texas A&M, (19-8; 10-5 SEC), 26, 49, 0, 75, Arkansas, (23-5; 12-3 SEC), 49, 32, 0, 81
400588000, 2015-02-24, Boston College, (9-18; 1-14 ACC), 30, 35, 0, 65, Pitt, (19-10; 8-7 ACC), 35, 36, 0, 71
400588469, 2015-02-24, Creighton, (13-15; 4-11 Big East), 34, 41, 0, 75, DePaul, (12-17; 6-10 Big East), 27, 35, 0, 62
400597412, 2015-02-24, Florida, (13-15; 6-9 SEC), 31, 21, 0, 52, Missouri, (8-20; 2-13 SEC), 27, 37, 0, 64
400591692, 2015-02-24, UNLV, (15-13; 6-9 MW), 38, 27, 0, 65, Utah State, (17-10; 10-5 MW), 35, 48, 0, 83
400590833, 2015-02-24, Non D-I School, NA, 29, 52, 0, 81, CSU Bakersfield, (13-16; 7-5 WAC), 44, 51, 0, 95
400591693, 2015-02-24, New Mexico, (14-14; 6-10 MW), 29, 36, 0, 65, Boise State, (21-7; 11-4 MW), 39, 37, 0, 76
400587575, 2015-02-24, N Illinois, (14-16; 8-10 MAC),  ,  , 0, 0, Toledo, (20-13; 11-7 MAC),  ,  , 0, 0
400588777, 2015-02-25, Lipscomb, (12-16; 6-7 A-Sun), 26, 21, 0, 47, USC Upstate, (21-9; 8-5 A-Sun), 32, 38, 0, 70
400597414, 2015-02-25, Kentucky, (28-0; 15-0 SEC), 36, 38, 0, 74, Miss St, (12-16; 5-10 SEC), 27, 29, 0, 56
400588001, 2015-02-25, UVA, (26-1; 14-1 ACC), 36, 34, 0, 70, Wake Forest, (12-16; 4-11 ACC), 15, 19, 0, 34
400599796, 2015-02-25, VCU, (21-7; 11-4 A 10), 20, 32, 11, 63, Richmond, (16-12; 9-6 A 10), 29, 23, 15, 67
400586843, 2015-02-25, UConn, (16-11; 9-6 American), 24, 36, 0, 60, ECU, (12-16; 5-10 American), 33, 16, 0, 49
400587200, 2015-02-25, Army, (15-13; 6-11 Patriot), 24, 33, 0, 57, Boston U, (13-15; 9-8 Patriot), 36, 27, 0, 63
400587201, 2015-02-25, Bucknell, (17-13; 12-5 Patriot), 26, 39, 0, 65, Lehigh, (16-12; 10-7 Patriot), 42, 42, 0, 84
400587202, 2015-02-25, Colgate, (14-16; 11-6 Patriot), 39, 56, 0, 95, Lafayette, (16-12; 8-9 Patriot), 32, 51, 0, 83
400588778, 2015-02-25, Jacksonville, (9-21; 3-10 A-Sun), 29, 38, 0, 67, Stetson, (9-20; 3-10 A-Sun), 38, 32, 0, 70
400588779, 2015-02-25, North Florida, (19-11; 11-2 A-Sun), 39, 37, 0, 76, FGCU, (21-8; 11-2 A-Sun), 35, 27, 0, 62
400591203, 2015-02-25, George Mason, (8-19; 3-12 A 10), 31, 32, 0, 63, Dayton, (21-6; 11-4 A 10), 35, 41, 0, 76
400591204, 2015-02-25, Davidson, (20-6; 11-4 A 10), 38, 22, 0, 60, URI, (19-7; 11-4 A 10), 31, 28, 0, 59
400591205, 2015-02-25, Saint Louis, (11-17; 3-12 A 10), 33, 33, 0, 66, Duquesne, (10-16; 5-10 A 10), 40, 39, 0, 79
400595536, 2015-02-25, Indiana, (19-10; 9-7 Big Ten), 40, 25, 0, 65, Northwestern, (14-14; 5-10 Big Ten), 40, 32, 0, 72
400596468, 2015-02-25, Albany, (20-8; 14-1 Am. East), 34, 33, 0, 67, UMBC, (4-24; 2-13 Am. East), 22, 27, 0, 49
400596499, 2015-02-25, Hartford, (14-14; 7-8 Am. East), 24, 39, 0, 63, Maine, (3-25; 2-13 Am. East), 29, 31, 0, 60
400596543, 2015-02-25, UMass Lowell, (12-17; 6-10 Am. East), 28, 32, 0, 60, Stony Brook, (20-10; 11-4 Am. East), 39, 36, 0, 75
400597714, 2015-02-25, UNH, (17-11; 10-5 Am. East), 23, 26, 0, 49, UVM, (17-11; 12-3 Am. East), 31, 33, 0, 64
400597766, 2015-02-25, Valparaiso, (25-5; 12-3 Horizon), 33, 27, 0, 60, Detroit, (14-17; 7-9 Horizon), 32, 31, 0, 63
400597816, 2015-02-25, Youngstown St, (11-19; 2-13 Horizon), 33, 38, 0, 71, Oakland, (16-14; 11-4 Horizon), 36, 46, 0, 82
400597851, 2015-02-25, Charleston, (8-22; 3-14 CAA), 14, 26, 0, 40, Hofstra, (19-11; 10-7 CAA), 31, 42, 0, 73
400597921, 2015-02-25, JMU, (18-12; 11-6 CAA), 25, 29, 0, 54, UNC-Wilmington, (17-11; 12-5 CAA), 36, 38, 0, 74
400597941, 2015-02-25, Towson, (12-18; 5-12 CAA), 15, 35, 0, 50, William & Mary, (18-10; 12-5 CAA), 28, 37, 0, 65
400598668, 2015-02-25, Bethune-Cookman, (10-18; 6-7 MEAC), 23, 26, 0, 49, Savannah State, (8-19; 4-9 MEAC), 26, 32, 0, 58
400599597, 2015-02-25, La Salle, (15-13; 7-8 A 10), 23, 25, 0, 48, Fordham, (9-17; 4-11 A 10), 32, 31, 0, 63
400599724, 2015-02-25, St Bonaventure, (14-12; 7-8 A 10), 18, 28, 0, 46, G Washington, (18-10; 8-7 A 10), 36, 33, 0, 69
400599783, 2015-02-25, Saint Joe's, (12-15; 6-9 A 10), 36, 46, 0, 82, UMass, (16-12; 9-6 A 10), 35, 36, 0, 71
400586472, 2015-02-25, Wichita State, (26-3; 16-1 MVC), 28, 35, 0, 63, Indiana State, (14-15; 10-7 MVC), 24, 29, 0, 53
400587204, 2015-02-25, Loyola (MD), (11-17; 7-10 Patriot), 32, 28, 0, 60, Holy Cross, (12-15; 7-10 Patriot), 38, 25, 0, 63
400586845, 2015-02-25, UCF, (12-15; 5-11 American), 30, 30, 0, 60, Cincinnati, (19-9; 10-5 American), 43, 40, 0, 83
400588470, 2015-02-25, Marquette, (11-16; 3-12 Big East), 30, 22, 0, 52, Butler, (20-8; 10-5 Big East), 37, 36, 0, 73
400585855, 2015-02-25, Texas Tech, (12-17; 2-14 Big 12), 20, 34, 0, 54, TCU, (17-11; 4-11 Big 12), 27, 44, 0, 71
400586474, 2015-02-25, S Illinois, (10-20; 3-14 MVC), 36, 20, 0, 56, Illinois State, (18-11; 10-7 MVC), 36, 37, 0, 73
400586844, 2015-02-25, Tulane, (14-13; 5-10 American), 26, 29, 0, 55, Tulsa, (20-7; 13-2 American), 34, 42, 0, 76
400587017, 2015-02-25, Denver, (12-16; 6-9 Summit), 37, 29, 0, 66, South Dakota, (15-15; 8-7 Summit), 30, 18, 0, 48
400587203, 2015-02-25, Navy, (11-18; 7-10 Patriot), 17, 32, 0, 49, American U, (15-14; 8-9 Patriot), 34, 34, 0, 68
400764458, 2015-02-25, N Illinois, (11-15; 5-10 MAC), 41, 43, 0, 84, Toledo, (18-10; 10-5 MAC), 34, 48, 0, 82
400586471, 2015-02-25, Bradley, (8-22; 3-14 MVC), 23, 27, 27, 77, Missouri State, (11-18; 5-12 MVC), 32, 18, 30, 80
400586475, 2015-02-25, Loyola (CHI), (17-12; 7-10 MVC), 35, 32, 13, 80, Drake, (9-20; 6-11 MVC), 30, 37, 8, 75
400588002, 2015-02-25, Duke, (25-3; 12-3 ACC), 37, 40, 14, 91, VT, (10-18; 2-13 ACC), 39, 38, 9, 86
400586473, 2015-02-25, Evansville, (19-10; 9-8 MVC), 24, 33, 0, 57, Northern Iowa, (27-2; 16-1 MVC), 36, 32, 0, 68
400585854, 2015-02-25, Baylor, (21-7; 9-6 Big 12), 40, 39, 0, 79, Iowa State, (20-7; 10-5 Big 12), 37, 33, 0, 70
400588003, 2015-02-25, FSU, (15-14; 7-9 ACC), 25, 52, 0, 77, Miami (FL), (18-10; 8-7 ACC), 29, 52, 0, 81
400591694, 2015-02-25, Nevada, (8-19; 4-11 MW), 33, 37, 0, 70, Air Force, (13-14; 6-10 MW), 32, 43, 0, 75
400591695, 2015-02-25, San Jose State, (2-25; 0-15 MW), 23, 33, 0, 56, Colorado State, (24-5; 11-5 MW), 41, 31, 0, 72
400595537, 2015-02-25, Illinois, (17-11; 7-8 Big Ten), 32, 28, 0, 60, Iowa, (18-10; 9-6 Big Ten), 33, 35, 0, 68
400597415, 2015-02-25, Georgia, (18-9; 9-6 SEC), 34, 42, 0, 76, Ole Miss, (19-9; 10-5 SEC), 23, 49, 0, 72
400591696, 2015-02-25, Fresno State, (13-15; 8-7 MW), 25, 39, 0, 64, Wyoming, (21-7; 10-5 MW), 21, 38, 0, 59
400593327, 2015-02-25, Washington St, (12-15; 6-9 Pac-12), 37, 33, 0, 70, USC, (10-18; 2-14 Pac-12), 27, 39, 0, 66
400593328, 2015-02-25, Washington, (15-12; 4-11 Pac-12), 25, 41, 0, 66, UCLA, (17-12; 9-7 Pac-12), 46, 42, 0, 88
400593329, 2015-02-25, Oregon, (21-8; 11-5 Pac-12), 39, 41, 0, 80, Cal, (16-12; 6-9 Pac-12), 37, 32, 0, 69
400764936, 2015-02-25, N Kentucky, (13-17; 7-7 A-Sun),  ,  , 0, 0, Kennesaw St, (10-22; 4-10 A-Sun),  ,  , 0, 0
400588780, 2015-02-26, N Kentucky, (12-16; 6-7 A-Sun), 44, 34, 0, 78, Kennesaw St, (10-20; 4-9 A-Sun), 24, 29, 0, 53
400589227, 2015-02-26, East Tenn St, (16-12; 8-9 Southern), 37, 36, 0, 73, The Citadel, (11-17; 6-11 Southern), 38, 36, 0, 74
400586846, 2015-02-26, Houston, (9-18; 1-14 American), 34, 20, 0, 54, Temple, (20-9; 11-5 American), 29, 37, 0, 66
400587018, 2015-02-26, Omaha, (10-17; 4-11 Summit), 28, 45, 0, 73, IPFW, (15-13; 8-7 Summit), 36, 31, 0, 67
400587019, 2015-02-26, W Illinois, (8-18; 3-12 Summit), 25, 41, 0, 66, IUPUI, (10-19; 6-9 Summit), 34, 37, 0, 71
400589228, 2015-02-26, W Carolina, (13-16; 8-9 Southern), 24, 25, 0, 49, Furman, (8-20; 5-12 Southern), 19, 34, 0, 53
400589229, 2015-02-26, Wofford, (24-6; 15-2 Southern), 35, 41, 0, 76, Mercer, (16-14; 11-6 Southern), 25, 47, 0, 72
400589230, 2015-02-26, Samford, (12-18; 5-12 Southern), 33, 34, 0, 67, UNC Greensboro, (10-20; 6-11 Southern), 36, 45, 0, 81
400589231, 2015-02-26, Chattanooga, (21-9; 14-3 Southern), 31, 36, 19, 86, VMI, (11-17; 7-10 Southern), 36, 31, 15, 82
400589425, 2015-02-26, Charleston So, (18-10; 12-5 Big South), 37, 44, 0, 81, Gardner-Webb, (18-12; 10-7 Big South), 44, 47, 0, 91
400589426, 2015-02-26, Winthrop, (16-12; 11-6 Big South), 25, 25, 0, 50, Campbell, (10-20; 4-13 Big South), 30, 35, 0, 65
400589427, 2015-02-26, Coast Carolina, (21-9; 12-6 Big South), 23, 46, 0, 69, Presbyterian, (10-20; 6-11 Big South), 34, 46, 0, 80
400589428, 2015-02-26, High Point, (22-7; 13-4 Big South), 42, 33, 0, 75, UNC Asheville, (13-15; 9-8 Big South), 41, 30, 0, 71
400589429, 2015-02-26, Radford, (20-10; 11-6 Big South), 30, 39, 0, 69, Liberty, (8-22; 2-15 Big South), 32, 48, 0, 80
400591730, 2015-02-26, Cent Conn St, (5-25; 3-14 NEC), 34, 35, 0, 69, Bryant, (14-14; 11-6 NEC), 29, 48, 0, 77
400591788, 2015-02-26, St Francis (BKN), (21-9; 15-2 NEC), 27, 35, 12, 74, LIU Brooklyn, (12-16; 8-9 NEC), 32, 30, 7, 69
400591802, 2015-02-26, Mt St Mary's, (14-14; 10-7 NEC), 26, 34, 0, 60, St Francis (PA), (15-13; 9-8 NEC), 30, 33, 0, 63
400591819, 2015-02-26, Wagner, (10-18; 8-9 NEC), 29, 30, 0, 59, Robert Morris, (15-14; 11-6 NEC), 44, 47, 0, 91
400595538, 2015-02-26, Minnesota, (17-12; 6-10 Big Ten), 36, 42, 18, 96, Michigan State, (19-9; 10-5 Big Ten), 41, 37, 12, 90
400595539, 2015-02-26, Nebraska, (13-15; 5-11 Big Ten), 24, 33, 0, 57, OSU, (20-8; 9-6 Big Ten), 42, 39, 0, 81
400596444, 2015-02-26, Jacksonville St, (12-18; 5-10 OVC), 23, 34, 0, 57, E Kentucky, (18-10; 10-5 OVC), 29, 34, 0, 63
400597416, 2015-02-26, Vanderbilt, (16-12; 6-9 SEC), 19, 54, 0, 73, Tennessee, (14-13; 6-9 SEC), 30, 35, 0, 65
400597805, 2015-02-26, Milwaukee, (13-16; 8-7 Horizon), 26, 35, 0, 61, Wright State, (11-18; 3-12 Horizon), 28, 30, 0, 58
400597868, 2015-02-26, Delaware, (9-19; 8-9 CAA), 35, 23, 0, 58, Drexel, (10-18; 8-9 CAA), 28, 16, 0, 44
400597898, 2015-02-26, Northeastern, (19-11; 11-6 CAA), 27, 38, 0, 65, Elon, (13-17; 5-12 CAA), 28, 44, 0, 72
400760036, 2015-02-26, Sacred Heart, (14-16; 8-9 NEC), 44, 46, 0, 90, Fair Dickinson, (7-21; 2-15 NEC), 40, 45, 0, 85
400595332, 2015-02-26, Ga Southern, (20-6; 13-4 Sun Belt), 36, 41, 0, 77, Appalachian St, (9-17; 6-11 Sun Belt), 20, 38, 0, 58
400586086, 2015-02-26, N Arizona, (16-12; 11-4 Big Sky), 42, 43, 0, 85, North Dakota, (8-19; 4-12 Big Sky), 36, 39, 0, 75
400586233, 2015-02-26, Rider, (20-10; 14-5 MAAC), 25, 38, 0, 63, Monmouth, (16-14; 12-7 MAAC), 25, 35, 0, 60
400587020, 2015-02-26, North Dakota St, (20-9; 12-4 Summit), 21, 37, 0, 58, Oral Roberts, (16-13; 9-6 Summit), 41, 33, 0, 74
400590834, 2015-02-26, Grand Canyon, (16-13; 7-5 WAC), 26, 44, 0, 70, Chicago State, (7-22; 3-9 WAC), 39, 35, 0, 74
400591524, 2015-02-26, Charlotte, (12-16; 5-10 C-USA), 28, 37, 0, 65, North Texas, (14-13; 8-7 C-USA), 41, 40, 0, 81
400591525, 2015-02-26, FIU, (13-15; 6-9 C-USA), 28, 41, 0, 69, Marshall, (10-18; 6-9 C-USA), 44, 43, 0, 87
400591526, 2015-02-26, FAU, (8-18; 1-14 C-USA), 32, 36, 0, 68, W Kentucky, (17-10; 10-5 C-USA), 29, 42, 0, 71
400591527, 2015-02-26, UTEP, (19-8; 11-4 C-USA), 29, 31, 0, 60, LA Tech, (22-7; 13-3 C-USA), 38, 39, 0, 77
400591528, 2015-02-26, Old Dominion, (21-6; 10-5 C-USA), 30, 33, 0, 63, Rice, (10-17; 7-8 C-USA), 20, 34, 0, 54
400591529, 2015-02-26, UTSA, (13-13; 7-8 C-USA), 28, 38, 0, 66, Southern Miss, (8-19; 3-13 C-USA), 37, 33, 0, 70
400596445, 2015-02-26, E Illinois, (16-13; 9-7 OVC), 21, 36, 0, 57, Murray State, (25-4; 15-0 OVC), 34, 31, 0, 65
400596446, 2015-02-26, SIU-ED, (12-15; 8-8 OVC), 25, 36, 0, 61, Austin Peay, (8-21; 3-12 OVC), 28, 36, 0, 64
400596447, 2015-02-26, UT Martin, (18-10; 10-5 OVC), 34, 35, 0, 69, Tennessee St, (5-25; 2-13 OVC), 32, 20, 0, 52
400597780, 2015-02-26, Green Bay, (22-7; 11-4 Horizon), 40, 32, 0, 72, UIC, (7-23; 3-12 Horizon), 25, 42, 0, 67
400590835, 2015-02-26, Utah Valley, (10-17; 4-8 WAC), 26, 24, 0, 50, UMKC, (12-17; 7-5 WAC), 32, 37, 0, 69
400595333, 2015-02-26, UT-Arlington, (15-12; 9-8 Sun Belt), 35, 45, 0, 80, Arkansas State, (11-15; 6-11 Sun Belt), 37, 44, 0, 81
400595336, 2015-02-26, Georgia State, (19-9; 12-5 Sun Belt), 35, 48, 0, 83, AR-Little Rock, (13-15; 8-10 Sun Belt), 41, 51, 0, 92
400595334, 2015-02-26, UL Monroe, (19-9; 13-4 Sun Belt), 36, 39, 0, 75, South Alabama, (9-20; 7-11 Sun Belt), 28, 29, 0, 57
400595335, 2015-02-26, Troy, (10-17; 5-13 Sun Belt), 27, 34, 0, 61, Texas State, (12-14; 6-11 Sun Belt), 35, 32, 0, 67
400593330, 2015-02-26, Arizona, (25-3; 13-2 Pac-12), 37, 45, 0, 82, Colorado, (12-15; 5-10 Pac-12), 25, 29, 0, 54
400586847, 2015-02-26, SMU, (23-5; 14-2 American), 30, 36, 0, 66, Memphis, (17-11; 9-6 American), 28, 29, 0, 57
400586089, 2015-02-26, Southern Utah, (8-18; 5-10 Big Sky), 27, 40, 0, 67, N Colorado, (13-14; 8-8 Big Sky), 41, 36, 0, 77
400595540, 2015-02-26, Rutgers, (10-19; 2-14 Big Ten), 30, 55, 0, 85, Purdue, (19-9; 11-4 Big Ten), 46, 46, 0, 92
400596448, 2015-02-26, Tenn Tech, (12-17; 4-11 OVC), 33, 40, 0, 73, Morehead State, (14-16; 9-6 OVC), 50, 36, 0, 86
400586087, 2015-02-26, Montana State, (7-21; 4-12 Big Sky), 28, 40, 0, 68, E Washington, (21-7; 12-3 Big Sky), 37, 55, 0, 92
400586088, 2015-02-26, Montana, (16-11; 12-4 Big Sky), 33, 25, 29, 87, Idaho, (12-14; 7-8 Big Sky), 24, 34, 34, 92
400587357, 2015-02-26, BYU, (22-8; 12-5 WCC), 33, 49, 0, 82, Portland, (16-13; 7-10 WCC), 41, 28, 0, 69
400587358, 2015-02-26, Pacific, (12-17; 4-13 WCC), 22, 42, 0, 64, Santa Clara, (12-17; 6-11 WCC), 19, 38, 0, 57
400596000, 2015-02-26, CS Fullerton, (9-19; 1-12 Big West), 39, 33, 0, 72, CS Northridge, (8-22; 3-11 Big West), 35, 47, 0, 82
400596001, 2015-02-26, UC Davis, (21-5; 11-2 Big West), 30, 30, 0, 60, UCSB, (15-12; 8-5 Big West), 30, 44, 0, 74
400596002, 2015-02-26, UC Irvine, (17-10; 10-3 Big West), 40, 23, 0, 63, Cal Poly, (13-13; 6-8 Big West), 30, 26, 0, 56
400593331, 2015-02-26, Arizona State, (15-13; 7-8 Pac-12), 9, 32, 0, 41, Utah, (22-5; 12-3 Pac-12), 41, 42, 0, 83
400587356, 2015-02-26, San Diego, (14-15; 7-10 WCC), 17, 22, 0, 39, Gonzaga, (29-1; 17-0 WCC), 22, 37, 0, 59
400587359, 2015-02-26, Saint Mary's, (21-7; 13-4 WCC), 49, 35, 0, 84, San Francisco, (12-17; 6-11 WCC), 29, 24, 0, 53
400593332, 2015-02-26, Oregon State, (17-11; 8-8 Pac-12), 30, 18, 0, 48, Stanford, (18-9; 9-6 Pac-12), 28, 47, 0, 75
400596003, 2015-02-26, LBSU, (13-16; 7-6 Big West), 29, 30, 0, 59, Hawaii, (19-11; 7-7 Big West), 39, 39, 0, 78
400586165, 2015-02-27, Siena, (10-18; 7-12 MAAC), 20, 43, 0, 63, Quinnipiac, (15-13; 9-10 MAAC), 37, 36, 0, 73
400591269, 2015-02-27, Harvard, (19-6; 9-2 Ivy), 21, 28, 0, 49, Cornell, (13-14; 5-6 Ivy), 22, 35, 0, 57
400591234, 2015-02-27, Penn, (7-17; 2-8 Ivy), 28, 41, 0, 69, Brown, (13-15; 4-7 Ivy), 41, 34, 0, 75
400591320, 2015-02-27, Princeton, (12-14; 5-5 Ivy), 35, 25, 0, 60, Yale, (20-8; 9-2 Ivy), 32, 49, 0, 81
400600757, 2015-02-27, Fairfield, (7-22; 5-14 MAAC), 34, 31, 0, 65, Canisius, (16-13; 11-9 MAAC), 34, 38, 0, 72
400601224, 2015-02-27, Manhattan, (15-13; 12-7 MAAC), 35, 40, 0, 75, Iona, (24-6; 17-2 MAAC), 41, 38, 0, 79
400601246, 2015-02-27, St Peter's, (13-17; 7-12 MAAC), 25, 42, 0, 67, Marist, (6-23; 5-14 MAAC), 43, 26, 0, 69
400587582, 2015-02-27, Ohio, (9-18; 4-12 MAC), 23, 35, 0, 58, Akron, (18-11; 9-7 MAC), 27, 43, 0, 70
400591254, 2015-02-27, Dartmouth, (11-14; 4-7 Ivy), 40, 44, 0, 84, Columbia, (13-12; 5-6 Ivy), 38, 33, 0, 71
400597748, 2015-02-27, Valparaiso, (26-5; 13-3 Horizon), 23, 33, 0, 56, Cleveland State, (17-13; 11-5 Horizon), 17, 36, 0, 53
400587209, 2015-02-28, Navy, (12-18; 8-10 Patriot), 32, 25, 0, 57, Loyola (MD), (11-18; 7-11 Patriot), 21, 26, 0, 47
400588782, 2015-02-28, Kennesaw St, (10-21; 4-10 A-Sun), 32, 43, 0, 75, Lipscomb, (13-16; 7-7 A-Sun), 47, 47, 0, 94
400595543, 2015-02-28, Michigan, (14-14; 7-9 Big Ten), 21, 35, 0, 56, Maryland, (24-5; 12-4 Big Ten), 30, 36, 0, 66
400588008, 2015-02-28, Louisville, (23-6; 11-5 ACC), 36, 45, 0, 81, FSU, (15-15; 7-10 ACC), 26, 33, 0, 59
400586850, 2015-02-28, ECU, (13-16; 6-10 American), 25, 46, 0, 71, UCF, (12-16; 5-12 American), 31, 35, 0, 66
400587205, 2015-02-28, Army, (15-14; 6-12 Patriot), 31, 33, 0, 64, Lafayette, (17-12; 9-9 Patriot), 41, 33, 0, 74
400587206, 2015-02-28, Bucknell, (18-13; 13-5 Patriot), 32, 39, 0, 71, American U, (15-15; 8-10 Patriot), 31, 38, 0, 69
400587208, 2015-02-28, Lehigh, (16-13; 10-8 Patriot), 32, 23, 0, 55, Colgate, (15-16; 12-6 Patriot), 42, 19, 0, 61
400588004, 2015-02-28, NC State, (17-12; 8-8 ACC), 26, 37, 0, 63, Boston College, (10-18; 2-14 ACC), 43, 36, 0, 79
400588005, 2015-02-28, Georgia Tech, (12-17; 3-14 ACC), 16, 44, 3, 63, Clemson, (16-12; 8-8 ACC), 35, 25, 10, 70
400588471, 2015-02-28, Georgetown, (18-9; 10-6 Big East), 32, 38, 0, 70, St John's, (20-9; 9-7 Big East), 43, 38, 0, 81
400597417, 2015-02-28, Missouri, (8-21; 2-14 SEC), 23, 21, 0, 44, Georgia, (19-9; 10-6 SEC), 41, 27, 0, 68
400599774, 2015-02-28, URI, (20-7; 12-4 A 10), 36, 23, 0, 59, La Salle, (15-14; 7-9 A 10), 24, 32, 0, 56
400587022, 2015-02-28, Omaha, (11-17; 5-11 Summit), 39, 32, 16, 87, IUPUI, (10-20; 6-10 Summit), 34, 37, 9, 80
400589232, 2015-02-28, W Carolina, (14-16; 9-9 Southern), 34, 33, 0, 67, The Citadel, (11-18; 6-12 Southern), 25, 29, 0, 54
400589236, 2015-02-28, Samford, (13-18; 6-12 Southern), 38, 42, 0, 80, VMI, (11-18; 7-11 Southern), 26, 43, 0, 69
400589431, 2015-02-28, Presbyterian, (10-21; 6-12 Big South), 24, 29, 0, 53, Winthrop, (17-12; 12-6 Big South), 38, 42, 0, 80
400596532, 2015-02-28, Maine, (3-26; 2-14 Am. East), 25, 31, 0, 56, UNH, (18-11; 11-5 Am. East), 31, 34, 0, 65
400588473, 2015-02-28, Villanova, (27-2; 14-2 Big East), 33, 45, 0, 78, Xavier, (18-12; 8-9 Big East), 40, 26, 0, 66
400586480, 2015-02-28, Northern Iowa, (27-3; 16-2 MVC), 26, 34, 0, 60, Wichita State, (27-3; 17-1 MVC), 38, 36, 0, 74
400588006, 2015-02-28, UNC, (20-9; 10-6 ACC), 32, 41, 0, 73, Miami (FL), (18-11; 8-8 ACC), 30, 34, 0, 64
400585856, 2015-02-28, TCU, (17-12; 4-12 Big 12), 36, 24, 0, 60, Oklahoma, (20-8; 11-5 Big 12), 28, 39, 0, 67
400591206, 2015-02-28, Dayton, (22-6; 12-4 A 10), 33, 26, 0, 59, VCU, (21-8; 11-5 A 10), 29, 26, 0, 55
400588472, 2015-02-28, Butler, (21-8; 11-5 Big East), 29, 38, 0, 67, DePaul, (12-18; 6-11 Big East), 24, 29, 0, 53
400586476, 2015-02-28, Indiana State, (15-15; 11-7 MVC), 27, 33, 0, 60, Bradley, (8-23; 3-15 MVC), 20, 32, 0, 52
400586478, 2015-02-28, Illinois State, (19-11; 11-7 MVC), 31, 30, 8, 69, Evansville, (19-11; 9-9 MVC), 27, 34, 6, 67
400586848, 2015-02-28, Cincinnati, (20-9; 11-5 American), 30, 33, 0, 63, Tulane, (14-14; 5-11 American), 16, 31, 0, 47
400588781, 2015-02-28, FGCU, (21-9; 11-3 A-Sun), 27, 40, 0, 67, Jacksonville, (10-21; 4-10 A-Sun), 38, 37, 0, 75
400589430, 2015-02-28, Campbell, (10-21; 4-14 Big South), 15, 50, 0, 65, Longwood, (9-22; 5-13 Big South), 34, 36, 0, 70
400591697, 2015-02-28, Utah State, (18-10; 11-5 MW), 30, 44, 0, 74, Air Force, (13-15; 6-11 MW), 21, 39, 0, 60
400591803, 2015-02-28, Wagner, (10-19; 8-10 NEC), 27, 37, 0, 64, Mt St Mary's, (15-14; 11-7 NEC), 34, 40, 0, 74
400596469, 2015-02-28, UVM, (17-12; 12-4 Am. East), 39, 34, 0, 73, Albany, (21-8; 15-1 Am. East), 37, 42, 0, 79
400596485, 2015-02-28, UMBC, (4-25; 2-14 Am. East), 24, 45, 0, 69, Binghamton, (6-25; 5-11 Am. East), 31, 45, 0, 76
400597418, 2015-02-28, Ole Miss, (19-10; 10-6 SEC), 27, 36, 0, 63, LSU, (21-8; 10-6 SEC), 23, 50, 0, 73
400597781, 2015-02-28, Oakland, (16-15; 11-5 Horizon), 31, 32, 0, 63, Green Bay, (23-7; 12-4 Horizon), 41, 42, 0, 83
400597794, 2015-02-28, Wright State, (11-19; 3-13 Horizon), 18, 28, 0, 46, UIC, (8-23; 4-12 Horizon), 24, 37, 0, 61
400597869, 2015-02-28, Delaware, (10-19; 9-9 CAA), 31, 34, 0, 65, Towson, (12-19; 5-13 CAA), 30, 30, 0, 60
400597884, 2015-02-28, Drexel, (11-18; 9-9 CAA), 37, 43, 0, 80, William & Mary, (18-11; 12-6 CAA), 21, 45, 0, 66
400598840, 2015-02-28, Non D-I School, NA, 23, 32, 0, 55, NJIT, (17-11; 11-2 home), 40, 50, 0, 90
400586090, 2015-02-28, Southern Utah, (9-18; 6-10 Big Sky), 37, 34, 0, 71, North Dakota, (8-20; 4-13 Big Sky), 24, 41, 0, 65
400589432, 2015-02-28, UNC Asheville, (14-15; 10-8 Big South), 46, 49, 0, 95, Liberty, (8-23; 2-16 Big South), 26, 51, 0, 77
400590838, 2015-02-28, Utah Valley, (10-18; 4-9 WAC), 14, 30, 0, 44, Chicago State, (8-22; 4-9 WAC), 30, 35, 0, 65
400591534, 2015-02-28, Mid Tennessee, (15-14; 8-8 C-USA), 25, 44, 26, 95, UAB, (16-13; 12-4 C-USA), 37, 32, 31, 100
400587577, 2015-02-28, Bowling Green, (19-8; 11-5 MAC), 31, 31, 0, 62, Miami (OH), (12-17; 7-9 MAC), 27, 30, 0, 57
400591789, 2015-02-28, LIU Brooklyn, (12-17; 8-10 NEC), 39, 34, 0, 73, Sacred Heart, (15-16; 9-9 NEC), 41, 43, 0, 84
400595337, 2015-02-28, UL Monroe, (19-10; 13-5 Sun Belt), 19, 24, 0, 43, Appalachian St, (10-17; 7-11 Sun Belt), 34, 32, 0, 66
400597420, 2015-02-28, Arkansas, (23-6; 12-4 SEC), 26, 41, 0, 67, Kentucky, (29-0; 16-0 SEC), 42, 42, 0, 84
400588007, 2015-02-28, VT, (10-19; 2-14 ACC), 24, 33, 0, 57, UVA, (27-1; 15-1 ACC), 28, 41, 0, 69
400585859, 2015-02-28, Iowa State, (20-8; 10-6 Big 12), 40, 29, 0, 69, Kansas State, (15-15; 8-9 Big 12), 33, 37, 0, 70
400585858, 2015-02-28, West Virginia, (22-7; 10-6 Big 12), 29, 37, 0, 66, Baylor, (22-7; 10-6 Big 12), 45, 33, 0, 78
400585857, 2015-02-28, Oklahoma State, (17-11; 7-9 Big 12), 17, 45, 0, 62, Texas Tech, (13-17; 3-14 Big 12), 31, 32, 0, 63
400586477, 2015-02-28, Drake, (9-21; 6-12 MVC), 25, 32, 0, 57, S Illinois, (11-20; 4-14 MVC), 37, 26, 0, 63
400586479, 2015-02-28, Missouri State, (11-19; 5-13 MVC), 29, 22, 0, 51, Loyola (CHI), (18-12; 8-10 MVC), 31, 34, 0, 65
400587207, 2015-02-28, Holy Cross, (13-15; 8-10 Patriot), 31, 46, 0, 77, Boston U, (13-16; 9-9 Patriot), 29, 41, 0, 70
400587364, 2015-02-28, San Diego, (15-15; 8-10 WCC), 31, 47, 0, 78, Portland, (16-14; 7-11 WCC), 31, 35, 0, 66
400588474, 2015-02-28, Creighton, (13-16; 4-12 Big East), 34, 32, 0, 66, Seton Hall, (16-12; 6-10 Big East), 24, 43, 0, 67
400589233, 2015-02-28, Wofford, (25-6; 16-2 Southern), 25, 37, 0, 62, Furman, (8-21; 5-13 Southern), 24, 36, 0, 60
400589234, 2015-02-28, East Tenn St, (16-13; 8-10 Southern), 38, 26, 0, 64, Mercer, (17-14; 12-6 Southern), 34, 35, 0, 69
400589433, 2015-02-28, Gardner-Webb, (18-13; 10-8 Big South), 33, 29, 0, 62, Radford, (21-10; 12-6 Big South), 33, 39, 0, 72
400591207, 2015-02-28, Duquesne, (10-17; 5-11 A 10), 34, 41, 0, 75, St Bonaventure, (15-12; 8-8 A 10), 46, 46, 0, 92
400591731, 2015-02-28, St Francis (BKN), (21-10; 15-3 NEC), 18, 33, 0, 51, Bryant, (15-14; 12-6 NEC), 31, 30, 0, 61
400591820, 2015-02-28, St Francis (PA), (15-14; 9-9 NEC), 33, 24, 13, 70, Robert Morris, (16-14; 12-6 NEC), 26, 31, 14, 71
400595720, 2015-02-28, Nicholls State, (7-18; 4-11 Southland), 29, 41, 8, 78, McNeese State, (12-15; 6-10 Southland), 39, 31, 13, 83
400597419, 2015-02-28, Alabama, (17-12; 7-9 SEC), 38, 28, 0, 66, Vanderbilt, (17-12; 7-9 SEC), 27, 46, 0, 73
400597911, 2015-02-28, Hofstra, (19-12; 10-8 CAA), 25, 48, 0, 73, JMU, (19-12; 12-6 CAA), 41, 41, 0, 82
400598670, 2015-02-28, MD-E Shore, (17-13; 10-5 MEAC), 41, 28, 0, 69, Delaware State, (13-16; 7-7 MEAC), 40, 25, 0, 65
400599598, 2015-02-28, Fordham, (9-18; 4-12 A 10), 37, 37, 0, 74, UMass, (17-12; 10-6 A 10), 33, 49, 0, 82
400586092, 2015-02-28, Montana State, (7-22; 4-13 Big Sky), 39, 34, 0, 73, Idaho, (13-14; 8-8 Big Sky), 39, 41, 0, 80
400598672, 2015-02-28, Bethune-Cookman, (10-19; 6-8 MEAC), 33, 16, 0, 49, NC Central, (22-6; 14-0 MEAC), 35, 37, 0, 72
400587578, 2015-02-28, E Michigan, (17-12; 6-10 MAC), 28, 44, 0, 72, W Michigan, (18-11; 9-7 MAC), 35, 45, 0, 80
400591753, 2015-02-28, Cent Conn St, (5-26; 3-15 NEC), 21, 45, 0, 66, Fair Dickinson, (8-21; 3-15 NEC), 33, 40, 0, 73
400598631, 2015-02-28, Coppin State, (7-21; 6-9 MEAC), 51, 37, 0, 88, Morgan State, (7-22; 5-10 MEAC), 43, 34, 0, 77
400589434, 2015-02-28, High Point, (22-8; 13-5 Big South), 34, 35, 24, 93, Charleston So, (19-10; 13-5 Big South), 28, 41, 28, 97
400585860, 2015-02-28, Texas, (17-12; 6-10 Big 12), 34, 30, 0, 64, Kansas, (23-6; 12-4 Big 12), 31, 38, 0, 69
400586095, 2015-02-28, Montana, (17-11; 13-4 Big Sky), 42, 35, 0, 77, E Washington, (21-8; 12-4 Big Sky), 39, 37, 0, 76
400587024, 2015-02-28, South Dakota St, (21-9; 12-4 Summit), 34, 30, 0, 64, South Dakota, (16-15; 9-7 Summit), 44, 36, 0, 80
400589235, 2015-02-28, Chattanooga, (22-9; 15-3 Southern), 25, 36, 0, 61, UNC Greensboro, (10-21; 6-12 Southern), 27, 31, 0, 58
400595339, 2015-02-28, Georgia State, (20-9; 13-5 Sun Belt), 39, 36, 0, 75, Troy, (10-18; 5-14 Sun Belt), 25, 39, 0, 64
400595721, 2015-02-28, SE Louisiana, (9-19; 6-9 Southland), 33, 39, 0, 72, Cent Arkansas, (2-24; 2-13 Southland), 31, 43, 0, 74
400591535, 2015-02-28, Old Dominion, (22-6; 11-5 C-USA), 27, 43, 0, 70, North Texas, (14-14; 8-8 C-USA), 33, 24, 0, 57
400595338, 2015-02-28, Arkansas State, (11-16; 6-12 Sun Belt), 23, 37, 0, 60, Texas State, (13-14; 7-11 Sun Belt), 34, 36, 0, 70
400587361, 2015-02-28, Loyola Mary, (8-22; 4-14 WCC), 29, 20, 0, 49, Pepperdine, (17-12; 10-8 WCC), 31, 34, 0, 65
400591235, 2015-02-28, Princeton, (13-14; 6-5 Ivy), 43, 37, 0, 80, Brown, (13-16; 4-8 Ivy), 29, 33, 0, 62
400591270, 2015-02-28, Dartmouth, (12-14; 5-7 Ivy), 26, 30, 0, 56, Cornell, (13-15; 5-7 Ivy), 14, 31, 0, 45
400591698, 2015-02-28, San Jose State, (2-26; 0-16 MW), 31, 20, 0, 51, Nevada, (9-19; 5-11 MW), 30, 32, 0, 62
400595541, 2015-02-28, Iowa, (19-10; 10-6 Big Ten), 31, 37, 13, 81, Penn State, (15-14; 3-13 Big Ten), 29, 39, 9, 77
400596449, 2015-02-28, Tennessee St, (5-26; 2-14 OVC), 28, 34, 0, 62, Belmont, (19-10; 11-5 OVC), 50, 38, 0, 88
400596453, 2015-02-28, Jacksonville St, (12-19; 5-11 OVC), 31, 24, 0, 55, Morehead State, (15-16; 10-6 OVC), 41, 46, 0, 87
400597421, 2015-02-28, Miss St, (12-17; 5-11 SEC), 31, 37, 0, 68, South Carolina, (14-14; 5-11 SEC), 39, 42, 0, 81
400597423, 2015-02-28, Tennessee, (14-14; 6-10 SEC), 22, 27, 0, 49, Florida, (14-15; 7-9 SEC), 40, 26, 0, 66
400598652, 2015-02-28, Florida A&M, (1-27; 1-14 MEAC), 22, 43, 0, 65, NC A&T, (8-21; 5-9 MEAC), 30, 47, 0, 77
400598673, 2015-02-28, Savannah State, (9-19; 5-9 MEAC), 34, 34, 0, 68, S Carolina St, (10-20; 7-8 MEAC), 30, 27, 0, 57
400591033, 2015-02-28, Alcorn State, (5-23; 4-12 SWAC), 29, 34, 0, 63, Southern, (15-15; 12-4 SWAC), 29, 42, 0, 71
400591056, 2015-02-28, Miss Valley St, (5-24; 4-12 SWAC), 23, 26, 0, 49, Jackson State, (10-18; 8-7 SWAC), 45, 28, 0, 73
400598800, 2015-02-28, Texas Southern, (16-12; 13-2 SWAC), 31, 27, 0, 58, Alabama State, (16-8; 12-3 SWAC), 33, 16, 0, 49
400588009, 2015-02-28, Syracuse, (18-11; 9-7 ACC), 25, 29, 0, 54, Duke, (26-3; 13-3 ACC), 34, 39, 0, 73
400587021, 2015-02-28, W Illinois, (8-19; 3-13 Summit), 33, 31, 0, 64, IPFW, (16-13; 9-7 Summit), 41, 43, 0, 84
400587580, 2015-02-28, Ball State, (7-20; 2-14 MAC), 25, 34, 0, 59, Toledo, (19-10; 11-5 MAC), 36, 34, 0, 70
400587581, 2015-02-28, Buffalo, (19-9; 10-6 MAC), 34, 37, 0, 71, Kent State, (19-10; 10-6 MAC), 31, 34, 0, 65
400588783, 2015-02-28, Stetson, (9-21; 3-11 A-Sun), 33, 38, 0, 71, North Florida, (20-11; 12-2 A-Sun), 42, 44, 0, 86
400588784, 2015-02-28, USC Upstate, (21-10; 8-6 A-Sun), 32, 33, 0, 65, N Kentucky, (13-16; 7-7 A-Sun), 35, 49, 0, 84
400590836, 2015-02-28, Grand Canyon, (16-14; 7-6 WAC), 27, 38, 0, 65, UMKC, (13-17; 8-5 WAC), 20, 50, 0, 70
400591208, 2015-02-28, G Washington, (18-11; 8-8 A 10), 30, 36, 0, 66, Davidson, (21-6; 12-4 A 10), 32, 45, 0, 77
400591255, 2015-02-28, Harvard, (20-6; 10-2 Ivy), 37, 43, 0, 80, Columbia, (13-13; 5-7 Ivy), 24, 46, 0, 70
400591310, 2015-02-28, Penn, (7-18; 2-9 Ivy), 28, 22, 0, 50, Yale, (21-8; 10-2 Ivy), 25, 30, 0, 55
400591532, 2015-02-28, FAU, (8-19; 1-15 C-USA), 41, 22, 0, 63, Marshall, (11-18; 7-9 C-USA), 37, 42, 0, 79
400591533, 2015-02-28, UTSA, (13-14; 7-9 C-USA), 25, 41, 0, 66, LA Tech, (23-7; 14-3 C-USA), 34, 42, 0, 76
400595542, 2015-02-28, Northwestern, (14-15; 5-11 Big Ten), 23, 37, 0, 60, Illinois, (18-11; 8-8 Big Ten), 45, 41, 0, 86
400595722, 2015-02-28, Incarnate Word, (17-8; 9-6 Southland), 33, 33, 0, 66, Lamar, (15-13; 9-7 Southland), 37, 42, 0, 79
400596004, 2015-02-28, CS Fullerton, (9-20; 1-13 Big West), 27, 20, 0, 47, LBSU, (14-16; 8-6 Big West), 43, 27, 0, 70
400596451, 2015-02-28, Austin Peay, (8-22; 3-13 OVC), 27, 38, 0, 65, SE Missouri St, (13-16; 7-9 OVC), 41, 48, 0, 89
400596452, 2015-02-28, Tenn Tech, (12-18; 4-12 OVC), 30, 37, 0, 67, E Kentucky, (19-10; 11-5 OVC), 26, 44, 0, 70
400596500, 2015-02-28, Stony Brook, (21-10; 12-4 Am. East), 40, 34, 0, 74, Hartford, (14-15; 7-9 Am. East), 25, 34, 0, 59
400597806, 2015-02-28, Milwaukee, (14-16; 9-7 Horizon), 46, 36, 0, 82, Youngstown St, (11-20; 2-14 Horizon), 29, 45, 0, 74
400597899, 2015-02-28, UNC-Wilmington, (17-12; 12-6 CAA), 22, 33, 0, 55, Elon, (14-17; 6-12 CAA), 37, 37, 0, 74
400599610, 2015-02-28, George Mason, (9-19; 4-12 A 10), 43, 35, 0, 78, Saint Louis, (11-18; 3-13 A 10), 24, 26, 0, 50
400599797, 2015-02-28, Richmond, (17-12; 10-6 A 10), 31, 32, 0, 63, Saint Joe's, (12-16; 6-10 A 10), 25, 32, 0, 57
400595723, 2015-02-28, Abil Christian, (9-19; 3-12 Southland), 20, 35, 0, 55, New Orleans, (9-15; 5-10 Southland), 38, 37, 0, 75
400596450, 2015-02-28, Murray State, (26-4; 16-0 OVC), 31, 42, 0, 73, UT Martin, (18-11; 10-6 OVC), 34, 33, 0, 67
400764934, 2015-02-28, PV A&M, (12-16; 10-5 SWAC), 34, 41, 0, 75, Alabama A&M, (8-17; 7-8 SWAC), 43, 29, 0, 72
400598674, 2015-02-28, Hampton, (12-15; 8-6 MEAC), 40, 28, 0, 68, Howard, (15-14; 9-6 MEAC), 33, 34, 0, 67
400591700, 2015-02-28, Boise State, (22-7; 12-4 MW), 21, 35, 0, 56, San Diego State, (22-7; 12-4 MW), 24, 22, 0, 46
400586849, 2015-02-28, Tulsa, (21-7; 14-2 American), 34, 32, 8, 74, Memphis, (17-12; 9-7 American), 36, 30, 6, 72
400587023, 2015-02-28, Denver, (12-17; 6-10 Summit), 23, 34, 0, 57, Oral Roberts, (17-13; 10-6 Summit), 27, 33, 0, 60
400587363, 2015-02-28, Saint Mary's, (21-8; 13-5 WCC), 24, 46, 0, 70, Santa Clara, (13-17; 7-11 WCC), 25, 46, 0, 71
400587579, 2015-02-28, Cent Michigan, (21-6; 11-5 MAC), 20, 35, 0, 55, N Illinois, (12-15; 6-10 MAC), 33, 40, 0, 73
400591530, 2015-02-28, Charlotte, (13-16; 6-10 C-USA), 38, 39, 0, 77, Rice, (10-18; 7-9 C-USA), 31, 45, 0, 76
400591531, 2015-02-28, FIU, (13-16; 6-10 C-USA), 28, 33, 0, 61, W Kentucky, (18-10; 11-5 C-USA), 36, 41, 0, 77
400591536, 2015-02-28, UTEP, (19-9; 11-5 C-USA), 35, 25, 0, 60, Southern Miss, (9-19; 4-13 C-USA), 20, 43, 0, 63
400591699, 2015-02-28, Wyoming, (21-8; 10-6 MW), 25, 32, 0, 57, UNLV, (16-13; 7-9 MW), 32, 37, 0, 69
400595724, 2015-02-28, SF Austin, (24-4; 14-1 Southland), 50, 52, 0, 102, Houston Baptist, (11-14; 6-9 Southland), 41, 46, 0, 87
400595725, 2015-02-28, Sam Houston, (22-6; 13-2 Southland), 27, 32, 0, 59, Texas A&M-CC, (16-12; 11-5 Southland), 30, 31, 0, 61
400597852, 2015-02-28, Northeastern, (20-11; 12-6 CAA), 32, 33, 0, 65, Charleston, (8-23; 3-15 CAA), 33, 23, 0, 56
400595340, 2015-02-28, Ga Southern, (20-7; 13-5 Sun Belt), 33, 25, 0, 58, LA-Lafayette, (17-12; 11-7 Sun Belt), 34, 34, 0, 68
400595341, 2015-02-28, AR-Little Rock, (13-16; 8-11 Sun Belt), 31, 42, 0, 73, UT-Arlington, (16-12; 10-8 Sun Belt), 40, 42, 0, 82
400597422, 2015-02-28, Auburn, (12-17; 4-12 SEC), 28, 27, 0, 55, Texas A&M, (20-8; 11-5 SEC), 36, 44, 0, 80
400598813, 2015-02-28, Grambling St, (2-23; 0-15 SWAC), 21, 36, 0, 57, AR-Pine Bluff, (10-20; 7-9 SWAC), 28, 38, 0, 66
400593334, 2015-02-28, Arizona, (26-3; 14-2 Pac-12), 29, 34, 0, 63, Utah, (22-6; 12-4 Pac-12), 28, 29, 0, 57
400586094, 2015-02-28, N Arizona, (16-13; 11-5 Big Sky), 33, 41, 0, 74, N Colorado, (14-14; 9-8 Big Sky), 31, 45, 0, 76
400587360, 2015-02-28, BYU, (23-8; 13-5 WCC), 36, 37, 0, 73, Gonzaga, (29-2; 17-1 WCC), 36, 34, 0, 70
400586091, 2015-02-28, Idaho State, (6-22; 3-13 Big Sky), 23, 34, 0, 57, Weber State, (12-15; 7-9 Big Sky), 29, 32, 0, 61
400587362, 2015-02-28, Pacific, (12-18; 4-14 WCC), 29, 26, 0, 55, San Francisco, (13-17; 7-11 WCC), 27, 38, 0, 65
400591701, 2015-02-28, New Mexico, (14-15; 6-11 MW), 25, 30, 0, 55, Fresno State, (14-15; 9-7 MW), 32, 27, 0, 59
400596006, 2015-02-28, UC Davis, (22-5; 12-2 Big West), 30, 36, 0, 66, Cal Poly, (13-14; 6-9 Big West), 22, 34, 0, 56
400586093, 2015-02-28, Sacramento St, (19-8; 13-3 Big Sky), 31, 42, 0, 73, Portland State, (14-12; 8-8 Big Sky), 27, 33, 0, 60
400590839, 2015-02-28, CSU Bakersfield, (13-17; 7-6 WAC), 14, 29, 0, 43, Seattle, (14-13; 7-6 WAC), 24, 29, 0, 53
400593333, 2015-02-28, Washington, (15-13; 4-12 Pac-12), 22, 33, 0, 55, USC, (11-18; 3-14 Pac-12), 27, 43, 0, 70
400596007, 2015-02-28, UC Riverside, (14-14; 7-7 Big West), 36, 40, 0, 76, CS Northridge, (9-22; 4-11 Big West), 36, 47, 0, 83
400596005, 2015-02-28, UC Irvine, (17-11; 10-4 Big West), 26, 25, 0, 51, UCSB, (16-12; 9-5 Big West), 27, 27, 0, 54
400590837, 2015-02-28, New Mexico St, (23-10; 13-1 WAC),  ,  , 0, 0, UT Pan American, (10-21; 4-10 WAC),  ,  , 0, 0
400586851, 2015-03-01, SMU, (23-6; 14-3 American), 26, 47, 0, 73, UConn, (17-11; 10-6 American), 32, 49, 0, 81
400586166, 2015-03-01, Marist, (6-24; 5-15 MAAC), 23, 26, 0, 49, Rider, (21-10; 15-5 MAAC), 21, 38, 0, 59
400601219, 2015-03-01, Fairfield, (7-23; 5-15 MAAC), 32, 24, 0, 56, Niagara, (8-21; 7-13 MAAC), 26, 31, 0, 57
400601236, 2015-03-01, Quinnipiac, (15-14; 9-11 MAAC), 34, 31, 0, 65, Manhattan, (16-13; 13-7 MAAC), 37, 32, 0, 69
400601358, 2015-03-01, Iona, (24-7; 17-3 MAAC), 29, 31, 0, 60, St Peter's, (14-17; 8-12 MAAC), 38, 30, 0, 68
400586852, 2015-03-01, USF, (8-21; 2-14 American), 29, 26, 0, 55, Houston, (10-18; 2-14 American), 33, 39, 0, 72
400593335, 2015-03-01, Oregon State, (17-12; 8-9 Pac-12), 31, 25, 0, 56, Cal, (17-12; 7-9 Pac-12), 32, 41, 0, 73
400588475, 2015-03-01, Marquette, (11-17; 3-13 Big East), 29, 37, 0, 66, Providence, (20-9; 10-6 Big East), 40, 37, 0, 77
400595544, 2015-03-01, Michigan State, (19-10; 10-6 Big Ten), 25, 36, 0, 61, Wisconsin, (26-3; 14-2 Big Ten), 36, 32, 0, 68
400586285, 2015-03-01, Siena, (10-19; 7-13 MAAC), 30, 27, 0, 57, Monmouth, (17-14; 13-7 MAAC), 24, 39, 0, 63
400588010, 2015-03-01, Pitt, (19-11; 8-8 ACC), 35, 31, 0, 66, Wake Forest, (13-16; 5-11 ACC), 37, 32, 0, 69
400593336, 2015-03-01, Oregon, (22-8; 12-5 Pac-12), 36, 37, 0, 73, Stanford, (18-10; 9-7 Pac-12), 30, 40, 0, 70
400595545, 2015-03-01, Purdue, (19-10; 11-5 Big Ten), 35, 26, 0, 61, OSU, (21-8; 10-6 Big Ten), 23, 42, 0, 65
400593337, 2015-03-01, Arizona State, (15-14; 7-9 Pac-12), 38, 43, 0, 81, Colorado, (13-15; 6-10 Pac-12), 40, 47, 0, 87
400593338, 2015-03-01, Washington St, (12-16; 6-10 Pac-12), 34, 33, 0, 67, UCLA, (18-12; 10-7 Pac-12), 32, 40, 0, 72
400588011, 2015-03-02, UVA, (28-1; 16-1 ACC), 23, 36, 0, 59, Syracuse, (18-12; 9-8 ACC), 20, 27, 0, 47
400585861, 2015-03-02, Baylor, (22-8; 10-7 Big 12), 31, 23, 5, 59, Texas, (18-12; 7-10 Big 12), 24, 30, 7, 61
400595726, 2015-03-02, Cent Arkansas, (2-25; 2-14 Southland), 26, 23, 0, 49, Sam Houston, (23-6; 14-2 Southland), 33, 43, 0, 76
400595727, 2015-03-02, SE Louisiana, (9-20; 6-10 Southland), 31, 48, 0, 79, Northwestern St, (17-10; 12-4 Southland), 44, 48, 0, 92
400598676, 2015-03-02, Bethune-Cookman, (10-20; 6-9 MEAC), 24, 26, 0, 50, NC A&T, (9-21; 6-9 MEAC), 30, 37, 0, 67
400595728, 2015-03-02, Incarnate Word, (17-9; 9-7 Southland), 25, 37, 0, 62, SF Austin, (25-4; 15-1 Southland), 35, 48, 0, 83
400595729, 2015-03-02, Lamar, (15-14; 9-8 Southland), 32, 37, 0, 69, McNeese State, (13-15; 7-10 Southland), 33, 37, 0, 70
400595730, 2015-03-02, Nicholls State, (8-18; 5-11 Southland), 28, 41, 20, 89, New Orleans, (9-16; 5-11 Southland), 26, 43, 10, 79
400598640, 2015-03-02, Norfolk State, (18-12; 11-4 MEAC), 31, 24, 4, 59, Howard, (16-14; 10-6 MEAC), 30, 25, 6, 61
400598662, 2015-03-02, Hampton, (12-16; 8-7 MEAC), 39, 36, 0, 75, Delaware State, (14-16; 8-7 MEAC), 39, 46, 0, 85
400598675, 2015-03-02, NC Central, (23-6; 15-0 MEAC), 33, 29, 0, 62, Savannah State, (9-20; 5-10 MEAC), 25, 24, 0, 49
400764935, 2015-03-02, Texas Southern, (17-12; 14-2 SWAC), 30, 47, 0, 77, Alabama A&M, (8-18; 7-9 SWAC), 32, 43, 0, 75
400585862, 2015-03-02, Oklahoma, (20-9; 11-6 Big 12), 37, 33, 0, 70, Iowa State, (21-8; 11-6 Big 12), 18, 59, 0, 77
400588012, 2015-03-02, Boston College, (11-18; 3-14 ACC), 41, 25, 0, 66, VT, (10-20; 2-15 ACC), 28, 31, 0, 59
400598801, 2015-03-02, PV A&M, (13-16; 11-5 SWAC), 29, 38, 0, 67, Alabama State, (16-9; 12-4 SWAC), 30, 35, 0, 65
400598814, 2015-03-02, Grambling St, (2-24; 0-16 SWAC), 26, 36, 0, 62, Miss Valley St, (6-24; 5-12 SWAC), 22, 44, 0, 66
400591057, 2015-03-02, Jackson State, (10-19; 8-8 SWAC), 30, 32, 0, 62, AR-Pine Bluff, (11-20; 8-9 SWAC), 39, 25, 0, 64
400595547, 2015-03-03, Maryland, (25-5; 13-4 Big Ten), 31, 29, 0, 60, Rutgers, (10-20; 2-15 Big Ten), 23, 27, 0, 50
400588013, 2015-03-03, UNC, (21-9; 11-6 ACC), 39, 42, 0, 81, Georgia Tech, (12-18; 3-15 ACC), 21, 28, 0, 49
400588476, 2015-03-03, Georgetown, (19-9; 11-6 Big East), 30, 30, 0, 60, Butler, (21-9; 11-6 Big East), 24, 30, 0, 54
400587583, 2015-03-03, Ohio, (9-19; 4-13 MAC), 29, 37, 0, 66, Buffalo, (20-9; 11-6 MAC), 41, 52, 0, 93
400587584, 2015-03-03, Toledo, (19-11; 11-6 MAC), 37, 40, 0, 77, Cent Michigan, (22-6; 12-5 MAC), 36, 49, 0, 85
400587585, 2015-03-03, E Michigan, (18-12; 7-10 MAC), 35, 32, 0, 67, Ball State, (7-21; 2-15 MAC), 24, 36, 0, 60
400587586, 2015-03-03, Kent State, (20-10; 11-6 MAC), 41, 40, 0, 81, Bowling Green, (19-9; 11-6 MAC), 36, 44, 0, 80
400587587, 2015-03-03, Akron, (18-12; 9-8 MAC), 23, 40, 0, 63, Miami (OH), (13-17; 8-9 MAC), 17, 53, 0, 70
400591209, 2015-03-03, URI, (20-8; 12-5 A 10), 28, 31, 0, 59, Dayton, (23-6; 13-4 A 10), 36, 39, 0, 75
400595546, 2015-03-03, Iowa, (20-10; 11-6 Big Ten), 32, 45, 0, 77, Indiana, (19-11; 9-8 Big Ten), 28, 35, 0, 63
400597424, 2015-03-03, Ole Miss, (20-10; 11-6 SEC), 27, 55, 0, 82, Alabama, (17-13; 7-10 SEC), 30, 44, 0, 74
400765054, 2015-03-03, Kennesaw St, (10-22; 4-10 A-Sun), 17, 37, 0, 54, USC Upstate, (22-10; 8-6 A-Sun), 42, 48, 0, 90
400765245, 2015-03-03, Army, (15-15; 6-12 Patriot), 26, 26, 0, 52, Navy, (13-18; 8-10 Patriot), 24, 32, 0, 56
400765246, 2015-03-03, Loyola (MD), (11-19; 7-11 Patriot), 20, 25, 0, 45, Holy Cross, (14-15; 8-10 Patriot), 32, 30, 0, 62
400765297, 2015-03-03, Lipscomb, (14-16; 7-7 A-Sun), 37, 31, 8, 76, N Kentucky, (13-17; 7-7 A-Sun), 38, 30, 5, 73
400765298, 2015-03-03, Jacksonville, (10-22; 4-10 A-Sun), 34, 29, 0, 63, FGCU, (22-9; 11-3 A-Sun), 38, 43, 0, 81
400765394, 2015-03-03, Youngstown St, (11-21; 2-14 Horizon), 37, 30, 0, 67, Detroit, (15-17; 7-9 Horizon), 31, 46, 0, 77
400765296, 2015-03-03, Stetson, (9-22; 3-11 A-Sun), 28, 39, 0, 67, North Florida, (21-11; 12-2 A-Sun), 45, 36, 0, 81
400586096, 2015-03-03, Omaha, (12-17; 5-11 Summit), 41, 39, 0, 80, North Dakota, (8-21; 4-13 Big Sky), 43, 35, 0, 78
400587588, 2015-03-03, W Michigan, (18-12; 9-8 MAC), 30, 33, 0, 63, N Illinois, (13-15; 7-10 MAC), 24, 41, 0, 65
400595731, 2015-03-03, Houston Baptist, (11-15; 6-10 Southland), 26, 45, 0, 71, Abil Christian, (10-19; 4-12 Southland), 41, 42, 0, 83
400765395, 2015-03-03, Wright State, (11-20; 3-13 Horizon), 39, 18, 0, 57, UIC, (9-23; 4-12 Horizon), 20, 40, 0, 60
400597425, 2015-03-03, Kentucky, (30-0; 17-0 SEC), 32, 40, 0, 72, Georgia, (19-10; 10-7 SEC), 32, 32, 0, 64
400585863, 2015-03-03, West Virginia, (22-8; 10-7 Big 12), 40, 19, 10, 69, Kansas, (24-6; 13-4 Big 12), 26, 33, 17, 76
400588014, 2015-03-03, NC State, (18-12; 9-8 ACC), 20, 46, 0, 66, Clemson, (16-13; 8-9 ACC), 21, 40, 0, 61
400595548, 2015-03-03, Michigan, (14-15; 7-10 Big Ten), 34, 25, 19, 78, Northwestern, (15-15; 6-11 Big Ten), 27, 32, 23, 82
400597426, 2015-03-03, Texas A&M, (20-9; 11-6 SEC), 23, 39, 0, 62, Florida, (15-15; 8-9 SEC), 26, 40, 0, 66
400597427, 2015-03-03, Auburn, (12-18; 4-13 SEC), 30, 31, 0, 61, Missouri, (9-21; 3-14 SEC), 30, 33, 0, 63
400588477, 2015-03-03, Villanova, (28-2; 15-2 Big East), 29, 47, 0, 76, Creighton, (13-17; 4-13 Big East), 30, 42, 0, 72
400765258, 2015-03-04, Longwood, (10-22; 5-13 Big South), 31, 34, 0, 65, Presbyterian, (10-22; 6-12 Big South), 35, 26, 0, 61
400765259, 2015-03-04, Campbell, (10-22; 4-14 Big South), 26, 38, 0, 64, Gardner-Webb, (19-13; 10-8 Big South), 40, 32, 0, 72
400595549, 2015-03-04, OSU, (22-8; 11-6 Big Ten), 29, 48, 0, 77, Penn State, (15-15; 3-14 Big Ten), 30, 37, 0, 67
400765260, 2015-03-04, Liberty, (8-24; 2-16 Big South), 30, 40, 0, 70, UNC Asheville, (15-15; 10-8 Big South), 33, 47, 0, 80
400588015, 2015-03-04, Notre Dame, (25-5; 13-4 ACC), 42, 29, 0, 71, Louisville, (23-7; 11-6 ACC), 31, 28, 0, 59
400588478, 2015-03-04, Providence, (21-9; 11-6 Big East), 29, 50, 0, 79, Seton Hall, (16-13; 6-11 Big East), 37, 29, 0, 66
400586855, 2015-03-04, UCF, (12-17; 5-13 American), 23, 22, 0, 45, USF, (9-21; 3-14 American), 43, 31, 0, 74
400591210, 2015-03-04, Duquesne, (11-17; 6-11 A 10), 38, 43, 0, 81, Fordham, (9-19; 4-13 A 10), 35, 31, 0, 66
400597428, 2015-03-04, Tennessee, (15-14; 7-10 SEC), 33, 45, 0, 78, LSU, (21-9; 10-7 SEC), 33, 30, 0, 63
400599611, 2015-03-04, G Washington, (19-11; 9-8 A 10), 29, 38, 0, 67, George Mason, (9-20; 4-13 A 10), 32, 19, 0, 51
400599775, 2015-03-04, La Salle, (15-15; 7-10 A 10), 23, 27, 0, 50, Saint Joe's, (13-16; 7-10 A 10), 24, 31, 0, 55
400765055, 2015-03-04, Binghamton, (6-26; 5-11 Am. East), 25, 32, 0, 57, Stony Brook, (22-10; 12-4 Am. East), 23, 39, 0, 62
400765056, 2015-03-04, Hartford, (14-16; 7-9 Am. East), 23, 31, 9, 63, UNH, (19-11; 11-5 Am. East), 32, 22, 13, 67
400765262, 2015-03-04, LIU Brooklyn, (12-18; 8-10 NEC), 22, 48, 0, 70, St Francis (BKN), (22-10; 15-3 NEC), 35, 44, 0, 79
400765263, 2015-03-04, Wagner, (10-20; 8-10 NEC), 28, 40, 0, 68, Robert Morris, (17-14; 12-6 NEC), 39, 52, 0, 91
400765264, 2015-03-04, Sacred Heart, (15-17; 9-9 NEC), 38, 25, 22, 85, Bryant, (16-14; 12-6 NEC), 30, 33, 28, 91
400765265, 2015-03-04, St Francis (PA), (16-14; 9-9 NEC), 29, 44, 0, 73, Mt St Mary's, (15-15; 11-7 NEC), 24, 34, 0, 58
400765294, 2015-03-04, SE Missouri St, (13-17; 7-9 OVC), 35, 39, 0, 74, Morehead State, (16-16; 10-6 OVC), 35, 44, 0, 79
400765303, 2015-03-04, Maine, (3-27; 2-14 Am. East), 25, 41, 0, 66, Albany, (22-8; 15-1 Am. East), 46, 37, 0, 83
400765304, 2015-03-04, UMBC, (4-26; 2-14 Am. East), 16, 23, 0, 39, UVM, (18-12; 12-4 Am. East), 32, 34, 0, 66
400599784, 2015-03-04, Richmond, (18-12; 11-6 A 10), 27, 29, 0, 56, UMass, (17-13; 10-7 A 10), 25, 28, 0, 53
400588017, 2015-03-04, Wake Forest, (13-17; 5-12 ACC), 15, 36, 0, 51, Duke, (27-3; 14-3 ACC), 52, 42, 0, 94
400586853, 2015-03-04, Houston, (11-18; 3-14 American), 22, 37, 9, 68, Tulane, (14-15; 5-12 American), 27, 32, 4, 63
400588016, 2015-03-04, Miami (FL), (19-11; 9-8 ACC), 29, 38, 0, 67, Pitt, (19-12; 8-9 ACC), 33, 30, 0, 63
400595550, 2015-03-04, Purdue, (19-11; 11-6 Big Ten), 30, 36, 0, 66, Michigan State, (20-10; 11-6 Big Ten), 27, 45, 0, 72
400598685, 2015-03-04, Howard, (16-15; 10-6 MEAC), 24, 38, 0, 62, NJIT, (18-11; 12-2 home), 39, 32, 0, 71
400599949, 2015-03-04, St Bonaventure, (16-12; 9-8 A 10), 26, 38, 0, 64, Saint Louis, (11-19; 3-14 A 10), 18, 30, 0, 48
400765214, 2015-03-04, New Mexico St, (20-10; 12-1 WAC), 32, 37, 0, 69, UT Pan American, (9-20; 3-10 WAC), 22, 26, 0, 48
400585864, 2015-03-04, TCU, (17-13; 4-13 Big 12), 30, 40, 0, 70, Oklahoma State, (18-11; 8-9 Big 12), 34, 48, 0, 82
400586854, 2015-03-04, Cincinnati, (21-9; 12-5 American), 27, 29, 0, 56, Tulsa, (21-8; 14-3 American), 20, 27, 0, 47
400588479, 2015-03-04, St John's, (21-9; 10-7 Big East), 34, 33, 0, 67, Marquette, (11-18; 3-14 Big East), 27, 24, 0, 51
400591702, 2015-03-04, Utah State, (18-11; 11-6 MW), 30, 23, 0, 53, Wyoming, (22-8; 11-6 MW), 40, 36, 0, 76
400593339, 2015-03-04, USC, (11-19; 3-15 Pac-12), 35, 39, 0, 74, UCLA, (19-12; 11-7 Pac-12), 46, 39, 0, 85
400597429, 2015-03-04, Miss St, (12-18; 5-12 SEC), 36, 20, 0, 56, Vanderbilt, (18-12; 8-9 SEC), 32, 34, 0, 66
400765295, 2015-03-04, SIU-ED, (12-16; 8-8 OVC), 26, 40, 0, 66, E Illinois, (17-13; 9-7 OVC), 30, 48, 0, 78
400591703, 2015-03-04, Air Force, (13-16; 6-12 MW), 23, 43, 0, 66, Fresno State, (15-15; 10-7 MW), 32, 36, 0, 68
400591704, 2015-03-04, Colorado State, (25-5; 12-5 MW), 43, 35, 0, 78, Nevada, (9-20; 5-12 MW), 32, 30, 0, 62
400595551, 2015-03-04, Nebraska, (13-16; 5-12 Big Ten), 25, 32, 0, 57, Illinois, (19-11; 9-8 Big Ten), 31, 38, 0, 69
400591705, 2015-03-04, Boise State, (23-7; 13-4 MW), 38, 30, 0, 68, San Jose State, (2-27; 0-17 MW), 21, 30, 0, 51
400591706, 2015-03-04, San Diego State, (23-7; 13-4 MW), 28, 32, 0, 60, UNLV, (16-14; 7-10 MW), 31, 27, 0, 58
400593340, 2015-03-04, Oregon, (23-8; 13-5 Pac-12), 32, 33, 0, 65, Oregon State, (17-13; 8-10 Pac-12), 32, 30, 0, 62
400596011, 2015-03-04, UCSB, (17-12; 10-5 Big West), 49, 49, 0, 98, Hawaii, (19-12; 7-8 Big West), 39, 51, 0, 90
400598684, 2015-03-05, Morgan State, (7-23; 5-11 MEAC), 29, 47, 0, 76, MD-E Shore, (18-13; 11-5 MEAC), 42, 47, 0, 89
400765408, 2015-03-05, Niagara, (8-22; 7-13 MAAC), 22, 32, 0, 54, Siena, (11-19; 7-13 MAAC), 34, 37, 0, 71
400595552, 2015-03-05, Wisconsin, (27-3; 15-2 Big Ten), 44, 32, 0, 76, Minnesota, (17-13; 6-11 Big Ten), 34, 29, 0, 63
400597430, 2015-03-05, Arkansas, (24-6; 13-4 SEC), 49, 29, 0, 78, South Carolina, (14-15; 5-12 SEC), 38, 36, 0, 74
400591537, 2015-03-05, W Kentucky, (19-10; 12-5 C-USA), 39, 35, 14, 88, Charlotte, (13-17; 6-11 C-USA), 33, 41, 10, 84
400591539, 2015-03-05, UAB, (16-14; 12-5 C-USA), 27, 32, 0, 59, FAU, (9-19; 2-15 C-USA), 32, 30, 0, 62
400765241, 2015-03-05, S Illinois, (12-20; 4-14 MVC), 25, 30, 0, 55, Missouri State, (11-20; 5-13 MVC), 19, 29, 0, 48
400765247, 2015-03-05, Boston U, (13-17; 9-9 Patriot), 34, 30, 0, 64, Lafayette, (18-12; 9-9 Patriot), 40, 49, 0, 89
400765248, 2015-03-05, American U, (16-15; 8-10 Patriot), 23, 45, 0, 68, Lehigh, (16-14; 10-8 Patriot), 27, 35, 0, 62
400765410, 2015-03-05, Fairfield, (7-24; 5-15 MAAC), 7, 26, 0, 33, St Peter's, (15-17; 8-12 MAAC), 22, 41, 0, 63
400765743, 2015-03-05, Lipscomb, (14-17; 7-7 A-Sun), 24, 33, 0, 57, North Florida, (22-11; 12-2 A-Sun), 37, 34, 0, 71
400765744, 2015-03-05, USC Upstate, (23-10; 8-6 A-Sun), 27, 36, 0, 63, FGCU, (22-10; 11-3 A-Sun), 25, 37, 0, 62
400765745, 2015-03-05, Holy Cross, (14-16; 8-10 Patriot), 27, 49, 7, 83, Bucknell, (19-13; 13-5 Patriot), 36, 40, 14, 90
400765746, 2015-03-05, Navy, (13-19; 8-10 Patriot), 22, 40, 0, 62, Colgate, (16-16; 12-6 Patriot), 27, 45, 0, 72
400766100, 2015-03-05, Morehead State, (17-16; 10-6 OVC), 36, 40, 0, 76, UT Martin, (18-12; 10-6 OVC), 28, 37, 0, 65
400586856, 2015-03-05, Temple, (21-9; 12-5 American), 41, 29, 0, 70, ECU, (13-17; 6-11 American), 33, 23, 0, 56
400591538, 2015-03-05, Mid Tennessee, (15-15; 8-9 C-USA), 30, 24, 0, 54, FIU, (14-16; 7-10 C-USA), 24, 35, 0, 59
400595342, 2015-03-05, Texas State, (13-15; 7-12 Sun Belt), 27, 37, 0, 64, Appalachian St, (11-17; 8-11 Sun Belt), 32, 35, 0, 67
400595344, 2015-03-05, UT-Arlington, (16-13; 10-9 Sun Belt), 36, 28, 0, 64, Ga Southern, (21-7; 14-5 Sun Belt), 30, 46, 0, 76
400598658, 2015-03-05, Delaware State, (15-16; 9-7 MEAC), 34, 70, 0, 104, Coppin State, (7-22; 6-10 MEAC), 29, 63, 0, 92
400591540, 2015-03-05, Southern Miss, (9-20; 4-14 C-USA), 24, 37, 0, 61, LA Tech, (24-7; 15-3 C-USA), 26, 46, 0, 72
400591541, 2015-03-05, Marshall, (11-19; 7-10 C-USA), 29, 21, 0, 50, Old Dominion, (23-6; 12-5 C-USA), 33, 34, 0, 67
400591543, 2015-03-05, Rice, (11-18; 8-9 C-USA), 46, 30, 0, 76, UTSA, (13-15; 7-10 C-USA), 35, 39, 0, 74
400595346, 2015-03-05, Georgia State, (21-9; 14-5 Sun Belt), 26, 32, 0, 58, UL Monroe, (19-11; 13-6 Sun Belt), 29, 21, 0, 50
400598628, 2015-03-05, Norfolk State, (19-12; 12-4 MEAC), 36, 44, 0, 80, Hampton, (12-17; 8-8 MEAC), 29, 40, 0, 69
400598682, 2015-03-05, NC A&T, (9-22; 6-10 MEAC), 31, 27, 0, 58, NC Central, (24-6; 16-0 MEAC), 36, 33, 0, 69
400598683, 2015-03-05, S Carolina St, (10-21; 7-9 MEAC), 32, 30, 0, 62, Bethune-Cookman, (11-20; 7-9 MEAC), 38, 34, 0, 72
400601359, 2015-03-05, Savannah State, (9-21; 5-11 MEAC), 28, 29, 0, 57, Florida A&M, (2-27; 2-14 MEAC), 23, 41, 0, 64
400586099, 2015-03-05, Portland State, (14-13; 8-9 Big Sky), 23, 28, 0, 51, N Arizona, (17-13; 12-5 Big Sky), 22, 36, 0, 58
400591034, 2015-03-05, Southern, (16-15; 13-4 SWAC), 31, 46, 0, 77, PV A&M, (13-17; 11-6 SWAC), 44, 29, 0, 73
400595343, 2015-03-05, South Alabama, (10-20; 8-11 Sun Belt), 47, 34, 0, 81, Arkansas State, (11-17; 6-13 Sun Belt), 33, 43, 0, 76
400595733, 2015-03-05, Cent Arkansas, (2-26; 2-15 Southland), 24, 46, 0, 70, Nicholls State, (9-18; 6-11 Southland), 40, 37, 0, 77
400595734, 2015-03-05, Houston Baptist, (11-16; 6-11 Southland), 29, 43, 0, 72, Texas A&M-CC, (17-12; 12-5 Southland), 46, 39, 0, 85
400591078, 2015-03-05, Alcorn State, (5-24; 4-13 SWAC), 30, 43, 0, 73, Texas Southern, (18-12; 15-2 SWAC), 40, 54, 0, 94
400591058, 2015-03-05, Alabama A&M, (8-19; 7-10 SWAC), 28, 26, 0, 54, Jackson State, (11-19; 9-8 SWAC), 42, 30, 0, 72
400595345, 2015-03-05, AR-Little Rock, (13-17; 8-12 Sun Belt), 27, 42, 0, 69, LA-Lafayette, (18-12; 12-7 Sun Belt), 32, 43, 0, 75
400593341, 2015-03-05, Cal, (17-13; 7-10 Pac-12), 27, 33, 0, 60, Arizona, (27-3; 15-2 Pac-12), 48, 51, 0, 99
400586097, 2015-03-05, Idaho, (13-15; 8-9 Big Sky), 32, 31, 0, 63, Weber State, (13-15; 8-9 Big Sky), 40, 34, 0, 74
400586098, 2015-03-05, Sacramento St, (19-9; 13-4 Big Sky), 36, 29, 0, 65, Southern Utah, (10-18; 7-10 Big Sky), 37, 32, 0, 69
400586857, 2015-03-05, Memphis, (18-12; 10-7 American), 26, 28, 0, 54, UConn, (17-12; 10-7 American), 26, 27, 0, 53
400591211, 2015-03-05, VCU, (21-9; 11-6 A 10), 21, 34, 0, 55, Davidson, (22-6; 13-4 A 10), 40, 42, 0, 82
400591542, 2015-03-05, North Texas, (14-15; 8-9 C-USA), 22, 38, 0, 60, UTEP, (20-9; 12-5 C-USA), 38, 45, 0, 83
400593342, 2015-03-05, Colorado, (14-15; 7-10 Pac-12), 30, 34, 0, 64, Washington, (15-14; 4-13 Pac-12), 17, 30, 0, 47
400595732, 2015-03-05, Sam Houston, (24-6; 15-2 Southland), 32, 35, 0, 67, Lamar, (15-15; 9-9 Southland), 32, 29, 0, 61
400595735, 2015-03-05, SE Louisiana, (9-21; 6-11 Southland), 34, 45, 0, 79, New Orleans, (10-16; 6-11 Southland), 42, 43, 0, 85
400595737, 2015-03-05, Northwestern St, (17-11; 12-5 Southland), 34, 32, 0, 66, SF Austin, (26-4; 16-1 Southland), 52, 40, 0, 92
400598802, 2015-03-05, Alabama State, (17-9; 13-4 SWAC), 34, 44, 0, 78, Grambling St, (2-25; 0-17 SWAC), 21, 25, 0, 46
400765409, 2015-03-05, Marist, (7-24; 5-15 MAAC), 41, 39, 0, 80, Quinnipiac, (15-15; 9-11 MAAC), 27, 47, 0, 74
400586100, 2015-03-05, E Washington, (22-8; 13-4 Big Sky), 41, 44, 0, 85, Idaho State, (6-23; 3-14 Big Sky), 26, 55, 0, 81
400595736, 2015-03-05, Abil Christian, (10-20; 4-13 Southland), 19, 33, 0, 52, Incarnate Word, (18-9; 10-7 Southland), 23, 41, 0, 64
400766114, 2015-03-05, E Illinois, (17-14; 9-7 OVC), 24, 40, 0, 64, Belmont, (20-10; 11-5 OVC), 47, 50, 0, 97
400765242, 2015-03-05, Bradley, (9-23; 3-15 MVC), 21, 22, 9, 52, Drake, (9-22; 6-12 MVC), 17, 26, 7, 50
400596008, 2015-03-05, CS Fullerton, (9-21; 1-14 Big West), 22, 40, 0, 62, UC Irvine, (18-11; 11-4 Big West), 25, 43, 0, 68
400596009, 2015-03-05, CS Northridge, (9-23; 4-12 Big West), 25, 33, 0, 58, LBSU, (15-16; 9-6 Big West), 30, 39, 0, 69
400596010, 2015-03-05, UC Riverside, (14-15; 7-8 Big West), 30, 29, 0, 59, UC Davis, (23-5; 13-2 Big West), 25, 36, 0, 61
400593344, 2015-03-05, Utah, (23-6; 13-4 Pac-12), 23, 44, 0, 67, Washington St, (12-17; 6-11 Pac-12), 23, 36, 0, 59
400593343, 2015-03-05, Stanford, (18-11; 9-8 Pac-12), 23, 39, 0, 62, Arizona State, (16-14; 8-9 Pac-12), 37, 30, 0, 67
400598825, 2015-03-05, AR-Pine Bluff, (12-20; 9-9 SWAC),  ,  , 0, 0, Miss Valley St, (6-26; 5-13 SWAC),  ,  , 0, 0
400766074, 2015-03-06, Longwood, (11-22; 5-13 Big South), 29, 39, 0, 68, Charleston So, (19-11; 13-5 Big South), 20, 40, 0, 60
400766405, 2015-03-06, AR-Pine Bluff, (12-20; 9-9 SWAC), 41, 53, 0, 94, Miss Valley St, (6-25; 5-13 SWAC), 33, 42, 0, 75
400766451, 2015-03-06, S Illinois, (12-21; 4-14 MVC), 20, 25, 0, 45, Wichita State, (28-3; 17-1 MVC), 28, 28, 0, 56
400765261, 2015-03-06, Winthrop, (18-12; 12-6 Big South), 21, 46, 0, 67, Radford, (21-11; 12-6 Big South), 24, 42, 0, 66
400765243, 2015-03-06, Evansville, (19-12; 9-9 MVC), 37, 30, 0, 67, Illinois State, (20-11; 11-7 MVC), 31, 40, 0, 71
400765270, 2015-03-06, Samford, (13-19; 6-12 Southern), 32, 44, 0, 76, UNC Greensboro, (11-21; 6-12 Southern), 38, 43, 0, 81
400765310, 2015-03-06, Towson, (12-20; 5-13 CAA), 32, 30, 7, 69, Elon, (15-17; 6-12 CAA), 33, 29, 12, 74
400766084, 2015-03-06, Gardner-Webb, (20-13; 10-8 Big South), 32, 31, 9, 72, High Point, (22-9; 13-5 Big South), 34, 29, 8, 71
400587589, 2015-03-06, N Illinois, (14-15; 8-10 MAC), 20, 37, 14, 71, Ball State, (7-22; 2-16 MAC), 22, 35, 10, 67
400587590, 2015-03-06, Akron, (18-13; 9-9 MAC), 29, 48, 0, 77, Kent State, (21-10; 12-6 MAC), 37, 42, 0, 79
400587591, 2015-03-06, Miami (OH), (13-18; 8-10 MAC), 30, 35, 0, 65, Ohio, (10-19; 5-13 MAC), 53, 42, 0, 95
400587592, 2015-03-06, Toledo, (19-12; 11-7 MAC), 29, 30, 0, 59, E Michigan, (19-12; 8-10 MAC), 31, 54, 0, 85
400587593, 2015-03-06, Cent Michigan, (22-7; 12-6 MAC), 22, 40, 0, 62, W Michigan, (19-12; 10-8 MAC), 39, 35, 0, 74
400587594, 2015-03-06, Bowling Green, (19-10; 11-7 MAC), 35, 40, 0, 75, Buffalo, (21-9; 12-6 MAC), 35, 42, 0, 77
400591236, 2015-03-06, Brown, (13-17; 4-9 Ivy), 35, 34, 0, 69, Dartmouth, (13-14; 6-7 Ivy), 22, 53, 0, 75
400591256, 2015-03-06, Columbia, (13-14; 5-8 Ivy), 9, 37, 0, 46, Penn, (8-18; 3-9 Ivy), 23, 31, 0, 54
400591271, 2015-03-06, Cornell, (13-16; 5-8 Ivy), 25, 28, 0, 53, Princeton, (14-14; 7-5 Ivy), 32, 34, 0, 66
400765747, 2015-03-06, UIC, (10-23; 4-12 Horizon), 25, 47, 0, 72, Oakland, (16-16; 11-5 Horizon), 30, 39, 0, 69
400766524, 2015-03-06, Bradley, (9-24; 3-15 MVC), 25, 21, 0, 46, Northern Iowa, (28-3; 16-2 MVC), 27, 44, 0, 71
400766450, 2015-03-06, Morehead State, (17-17; 10-6 OVC), 32, 45, 0, 77, Murray State, (27-4; 16-0 OVC), 43, 37, 0, 80
400591302, 2015-03-06, Yale, (22-8; 11-2 Ivy), 22, 40, 0, 62, Harvard, (20-7; 10-3 Ivy), 19, 33, 0, 52
400765271, 2015-03-06, Furman, (9-21; 5-13 Southern), 38, 35, 0, 73, The Citadel, (11-19; 6-12 Southern), 27, 29, 0, 56
400765311, 2015-03-06, Charleston, (9-23; 3-15 CAA), 24, 32, 0, 56, Drexel, (11-19; 9-9 CAA), 29, 19, 0, 48
400766094, 2015-03-06, UNC Asheville, (15-16; 10-8 Big South), 31, 26, 0, 57, Coast Carolina, (22-9; 12-6 Big South), 27, 47, 0, 74
400585865, 2015-03-06, Texas Tech, (13-18; 3-15 Big 12), 33, 41, 0, 74, Baylor, (23-8; 11-7 Big 12), 32, 45, 0, 77
400765396, 2015-03-06, Pacific, (12-19; 4-14 WCC), 28, 30, 0, 58, San Francisco, (14-17; 7-11 WCC), 28, 34, 0, 62
400765244, 2015-03-06, Loyola (CHI), (19-12; 8-10 MVC), 38, 43, 0, 81, Indiana State, (15-16; 11-7 MVC), 20, 33, 0, 53
400765742, 2015-03-06, Detroit, (15-18; 7-9 Horizon), 21, 32, 0, 53, Cleveland State, (18-13; 11-5 Horizon), 31, 39, 0, 70
400766521, 2015-03-06, Belmont, (21-10; 11-5 OVC), 26, 27, 0, 53, E Kentucky, (19-11; 11-5 OVC), 33, 19, 0, 52
400765397, 2015-03-06, Loyola Mary, (8-23; 4-14 WCC), 22, 32, 0, 54, Santa Clara, (14-17; 7-11 WCC), 36, 49, 0, 85
400588480, 2015-03-07, Butler, (22-9; 12-6 Big East), 33, 35, 0, 68, Providence, (21-10; 11-7 Big East), 22, 42, 0, 64
400588018, 2015-03-07, Syracuse, (18-13; 9-9 ACC), 25, 32, 0, 57, NC State, (19-12; 10-8 ACC), 26, 45, 0, 71
400588019, 2015-03-07, Miami (FL), (20-11; 10-8 ACC), 46, 36, 0, 82, VT, (10-21; 2-16 ACC), 18, 43, 0, 61
400588023, 2015-03-07, Pitt, (19-13; 8-10 ACC), 23, 29, 0, 52, FSU, (16-15; 8-10 ACC), 25, 36, 0, 61
400588481, 2015-03-07, Seton Hall, (16-14; 6-12 Big East), 24, 43, 0, 67, Georgetown, (20-9; 12-6 Big East), 32, 41, 0, 73
400595554, 2015-03-07, Northwestern, (15-16; 6-12 Big Ten), 27, 25, 0, 52, Iowa, (21-10; 12-6 Big Ten), 33, 36, 0, 69
400595556, 2015-03-07, Michigan State, (21-10; 12-6 Big Ten), 34, 40, 0, 74, Indiana, (19-12; 9-9 Big Ten), 34, 38, 0, 72
400766104, 2015-03-07, Bryant, (16-15; 12-6 NEC), 25, 28, 0, 53, Robert Morris, (18-14; 12-6 NEC), 30, 36, 0, 66
400766444, 2015-03-07, Siena, (11-20; 7-13 MAAC), 37, 34, 0, 71, Iona, (25-7; 17-3 MAAC), 45, 29, 0, 74
400766505, 2015-03-07, Longwood, (11-23; 5-13 Big South), 20, 38, 0, 58, Winthrop, (19-12; 12-6 Big South), 30, 41, 0, 71
400766597, 2015-03-07, Elon, (15-18; 6-12 CAA), 26, 33, 0, 59, William & Mary, (19-11; 12-6 CAA), 36, 36, 0, 72
400766598, 2015-03-07, UNC Greensboro, (11-22; 6-12 Southern), 20, 32, 0, 52, Wofford, (26-6; 16-2 Southern), 30, 40, 0, 70
400597432, 2015-03-07, Florida, (15-16; 8-10 SEC), 27, 23, 0, 50, Kentucky, (31-0; 18-0 SEC), 30, 37, 0, 67
400588482, 2015-03-07, St John's, (21-10; 10-8 Big East), 46, 22, 0, 68, Villanova, (29-2; 16-2 Big East), 50, 55, 0, 105
400585866, 2015-03-07, Oklahoma State, (18-12; 8-10 Big 12), 33, 39, 0, 72, West Virginia, (23-8; 11-7 Big 12), 39, 42, 0, 81
400586859, 2015-03-07, UConn, (17-13; 10-8 American), 37, 26, 0, 63, Temple, (22-9; 13-5 American), 32, 43, 0, 75
400588020, 2015-03-07, Wake Forest, (13-18; 5-13 ACC), 30, 31, 0, 61, Boston College, (12-18; 4-14 ACC), 38, 41, 0, 79
400588483, 2015-03-07, DePaul, (12-19; 6-12 Big East), 19, 29, 0, 48, Marquette, (12-18; 4-14 Big East), 28, 30, 0, 58
400597431, 2015-03-07, Alabama, (18-13; 8-10 SEC), 22, 39, 0, 61, Texas A&M, (20-10; 11-7 SEC), 36, 24, 0, 60
400599791, 2015-03-07, Saint Joe's, (13-17; 7-11 A 10), 38, 30, 0, 68, URI, (21-8; 13-5 A 10), 37, 41, 0, 78
400766105, 2015-03-07, St Francis (PA), (16-15; 9-9 NEC), 27, 21, 0, 48, St Francis (BKN), (23-10; 15-3 NEC), 30, 32, 0, 62
400588484, 2015-03-07, Xavier, (19-12; 9-9 Big East), 30, 44, 0, 74, Creighton, (13-18; 4-14 Big East), 31, 42, 0, 73
400597437, 2015-03-07, LSU, (22-9; 11-7 SEC), 41, 40, 0, 81, Arkansas, (24-7; 13-5 SEC), 35, 43, 0, 78
400595553, 2015-03-07, Rutgers, (10-21; 2-16 Big Ten), 28, 41, 0, 69, Michigan, (15-15; 8-10 Big Ten), 47, 32, 0, 79
400595349, 2015-03-07, Ga Southern, (21-8; 14-6 Sun Belt), 21, 34, 0, 55, Georgia State, (22-9; 15-5 Sun Belt), 32, 40, 0, 72
400593345, 2015-03-07, Cal, (17-14; 7-11 Pac-12), 32, 38, 0, 70, Arizona State, (17-14; 9-9 Pac-12), 35, 39, 0, 74
400765272, 2015-03-07, East Tenn St, (16-14; 8-10 Southern), 27, 29, 5, 61, W Carolina, (15-16; 9-9 Southern), 35, 21, 11, 67
400765312, 2015-03-07, Hofstra, (20-12; 10-8 CAA), 39, 35, 0, 74, JMU, (19-13; 12-6 CAA), 33, 24, 0, 57
400765411, 2015-03-07, Canisius, (16-14; 11-9 MAAC), 27, 27, 0, 54, Monmouth, (18-14; 13-7 MAAC), 27, 33, 0, 60
400766594, 2015-03-07, Illinois State, (21-11; 11-7 MVC), 22, 43, 0, 65, Wichita State, (28-4; 17-1 MVC), 30, 32, 0, 62
400766612, 2015-03-07, Gardner-Webb, (20-14; 10-8 Big South), 28, 42, 0, 70, Coast Carolina, (23-9; 12-6 Big South), 36, 37, 0, 73
400590843, 2015-03-07, UMKC, (13-18; 8-6 WAC), 28, 23, 0, 51, UT Pan American, (10-20; 4-10 WAC), 26, 27, 0, 53
400591548, 2015-03-07, North Texas, (14-16; 8-10 C-USA), 42, 26, 0, 68, UTSA, (14-15; 8-10 C-USA), 33, 36, 0, 69
400765398, 2015-03-07, Portland, (17-14; 7-11 WCC), 32, 37, 0, 69, Saint Mary's, (21-9; 13-5 WCC), 26, 26, 0, 52
400595347, 2015-03-07, UT-Arlington, (16-14; 10-10 Sun Belt), 27, 33, 0, 60, Appalachian St, (12-17; 9-11 Sun Belt), 26, 46, 0, 72
400599725, 2015-03-07, UMass, (17-14; 10-8 A 10), 28, 37, 0, 65, G Washington, (20-11; 10-8 A 10), 50, 37, 0, 87
400593346, 2015-03-07, Stanford, (18-12; 9-9 Pac-12), 31, 38, 0, 69, Arizona, (28-3; 16-2 Pac-12), 47, 44, 0, 91
400585868, 2015-03-07, Kansas, (24-7; 13-5 Big 12), 30, 43, 0, 73, Oklahoma, (21-9; 12-6 Big 12), 32, 43, 0, 75
400588021, 2015-03-07, Clemson, (16-14; 8-10 ACC), 31, 36, 0, 67, Notre Dame, (26-5; 14-4 ACC), 38, 43, 0, 81
400585869, 2015-03-07, Kansas State, (15-16; 8-10 Big 12), 26, 23, 0, 49, Texas, (19-12; 8-10 Big 12), 34, 28, 0, 62
400586858, 2015-03-07, Tulane, (15-15; 6-12 American), 32, 35, 0, 67, USF, (9-22; 3-15 American), 21, 42, 0, 63
400591212, 2015-03-07, Dayton, (23-7; 13-5 A 10), 19, 34, 0, 53, La Salle, (16-15; 8-10 A 10), 23, 32, 0, 55
400591549, 2015-03-07, Rice, (11-19; 8-10 C-USA), 27, 38, 0, 65, UTEP, (21-9; 13-5 C-USA), 29, 39, 0, 68
400597433, 2015-03-07, Georgia, (20-10; 11-7 SEC), 31, 33, 0, 64, Auburn, (12-19; 4-14 SEC), 28, 33, 0, 61
400597434, 2015-03-07, South Carolina, (15-15; 6-12 SEC), 36, 24, 0, 60, Tennessee, (15-15; 7-11 SEC), 21, 28, 0, 49
400599599, 2015-03-07, Fordham, (9-20; 4-14 A 10), 28, 24, 0, 52, St Bonaventure, (17-12; 10-8 A 10), 23, 43, 0, 66
400586105, 2015-03-07, Sacramento St, (19-10; 13-5 Big Sky), 39, 29, 0, 68, N Arizona, (18-13; 13-5 Big Sky), 33, 37, 0, 70
400595738, 2015-03-07, New Orleans, (10-17; 6-12 Southland), 35, 43, 0, 78, Northwestern St, (18-11; 13-5 Southland), 51, 37, 0, 88
400593347, 2015-03-07, Utah, (23-7; 13-5 Pac-12), 36, 32, 0, 68, Washington, (16-14; 5-13 Pac-12), 31, 46, 0, 77
400595555, 2015-03-07, Illinois, (19-12; 9-9 Big Ten), 26, 32, 0, 58, Purdue, (20-11; 12-6 Big Ten), 21, 42, 0, 63
400595739, 2015-03-07, Abil Christian, (10-21; 4-14 Southland), 11, 16, 0, 27, Texas A&M-CC, (18-12; 13-5 Southland), 26, 32, 0, 58
400766619, 2015-03-07, Loyola (CHI), (19-13; 8-10 MVC), 23, 26, 0, 49, Northern Iowa, (29-3; 16-2 MVC), 32, 31, 0, 63
400591547, 2015-03-07, W Kentucky, (19-11; 12-6 C-USA), 21, 31, 0, 52, Old Dominion, (24-6; 13-5 C-USA), 40, 35, 0, 75
400599612, 2015-03-07, George Mason, (9-21; 4-14 A 10), 19, 41, 0, 60, VCU, (22-9; 12-6 A 10), 33, 38, 0, 71
400765399, 2015-03-07, San Diego, (15-16; 8-10 WCC), 24, 23, 0, 47, Pepperdine, (18-12; 10-8 WCC), 18, 32, 0, 50
400766494, 2015-03-07, St Peter's, (16-17; 8-12 MAAC), 34, 34, 0, 68, Rider, (21-11; 15-5 MAAC), 20, 39, 0, 59
400595350, 2015-03-07, Troy, (10-19; 5-15 Sun Belt), 42, 51, 0, 93, South Alabama, (11-20; 9-11 Sun Belt), 45, 51, 0, 96
400595351, 2015-03-07, Texas State, (13-16; 7-13 Sun Belt), 26, 27, 0, 53, UL Monroe, (20-11; 14-6 Sun Belt), 27, 29, 0, 56
400591079, 2015-03-07, Alcorn State, (5-25; 4-14 SWAC), 36, 44, 0, 80, PV A&M, (14-17; 12-6 SWAC), 29, 54, 0, 83
400591237, 2015-03-07, Brown, (13-18; 4-10 Ivy), 28, 34, 0, 62, Harvard, (21-7; 11-3 Ivy), 27, 45, 0, 72
400591257, 2015-03-07, Columbia, (13-15; 5-9 Ivy), 38, 45, 0, 83, Princeton, (15-14; 8-5 Ivy), 38, 47, 0, 85
400596012, 2015-03-07, Cal Poly, (13-15; 6-10 Big West), 20, 36, 0, 56, UCSB, (18-12; 11-5 Big West), 30, 34, 0, 64
400598815, 2015-03-07, Alabama A&M, (9-19; 8-10 SWAC), 29, 41, 0, 70, Grambling St, (2-26; 0-18 SWAC), 24, 42, 0, 66
400766610, 2015-03-07, Furman, (10-21; 5-13 Southern), 26, 43, 0, 69, Chattanooga, (22-10; 15-3 Southern), 31, 36, 0, 67
400766613, 2015-03-07, Charleston, (9-24; 3-15 CAA), 25, 28, 0, 53, UNC-Wilmington, (18-12; 12-6 CAA), 36, 43, 0, 79
400588024, 2015-03-07, UVA, (28-2; 16-2 ACC), 25, 32, 0, 57, Louisville, (24-7; 12-6 ACC), 30, 29, 0, 59
400591059, 2015-03-07, Alabama State, (18-9; 14-4 SWAC), 24, 38, 0, 62, Jackson State, (11-20; 9-9 SWAC), 22, 20, 0, 42
400593348, 2015-03-07, Colorado, (14-16; 7-11 Pac-12), 38, 39, 14, 91, Washington St, (13-17; 7-11 Pac-12), 45, 32, 19, 96
400597435, 2015-03-07, Missouri, (9-22; 3-15 SEC), 19, 24, 0, 43, Miss St, (13-18; 6-12 SEC), 27, 25, 0, 52
400766705, 2015-03-07, Belmont, (22-10; 11-5 OVC), 41, 47, 0, 88, Murray State, (27-5; 16-0 OVC), 49, 38, 0, 87
400591213, 2015-03-07, Davidson, (23-6; 14-4 A 10), 55, 52, 0, 107, Duquesne, (11-18; 6-12 A 10), 33, 45, 0, 78
400591272, 2015-03-07, Cornell, (13-17; 5-9 Ivy), 27, 45, 0, 72, Penn, (9-18; 4-9 Ivy), 29, 50, 0, 79
400591289, 2015-03-07, Yale, (22-9; 11-3 Ivy), 30, 28, 0, 58, Dartmouth, (14-14; 7-7 Ivy), 29, 30, 0, 59
400591544, 2015-03-07, Marshall, (11-20; 7-11 C-USA), 32, 41, 0, 73, Charlotte, (14-17; 7-11 C-USA), 37, 49, 0, 86
400591546, 2015-03-07, Mid Tennessee, (16-15; 9-9 C-USA), 38, 39, 0, 77, FAU, (9-20; 2-16 C-USA), 21, 33, 0, 54
400765314, 2015-03-07, W Illinois, (8-20; 3-13 Summit), 21, 29, 0, 50, South Dakota St, (22-9; 12-4 Summit), 50, 37, 0, 87
400766606, 2015-03-07, UIC, (10-24; 4-12 Horizon), 30, 26, 0, 56, Green Bay, (24-7; 12-4 Horizon), 29, 41, 0, 70
400595742, 2015-03-07, Sam Houston, (24-7; 15-3 Southland), 25, 30, 0, 55, SF Austin, (27-4; 17-1 Southland), 26, 38, 0, 64
400591545, 2015-03-07, UAB, (16-15; 12-6 C-USA), 26, 40, 0, 66, FIU, (15-16; 8-10 C-USA), 31, 39, 0, 70
400591707, 2015-03-07, Fresno State, (15-16; 10-8 MW), 19, 33, 0, 52, Boise State, (24-7; 14-4 MW), 28, 43, 0, 71
400591708, 2015-03-07, Wyoming, (22-9; 11-7 MW), 14, 30, 5, 49, New Mexico, (15-15; 7-11 MW), 17, 27, 8, 52
400595740, 2015-03-07, Incarnate Word, (18-10; 10-8 Southland), 25, 41, 11, 77, Houston Baptist, (12-16; 7-11 Southland), 42, 24, 12, 78
400595741, 2015-03-07, Nicholls State, (10-18; 7-11 Southland), 35, 40, 0, 75, SE Louisiana, (9-22; 6-12 Southland), 34, 35, 0, 69
400596013, 2015-03-07, LBSU, (16-16; 10-6 Big West), 35, 24, 0, 59, UC Riverside, (14-16; 7-9 Big West), 26, 32, 0, 58
400596014, 2015-03-07, Hawaii, (20-12; 8-8 Big West), 39, 52, 0, 91, CS Fullerton, (9-22; 1-15 Big West), 31, 39, 0, 70
400599798, 2015-03-07, Saint Louis, (11-20; 3-15 A 10), 27, 24, 0, 51, Richmond, (19-12; 12-6 A 10), 36, 31, 0, 67
400766522, 2015-03-07, Marist, (7-25; 5-15 MAAC), 22, 36, 0, 58, Manhattan, (17-13; 13-7 MAAC), 38, 36, 0, 74
400595348, 2015-03-07, LA-Lafayette, (19-12; 13-7 Sun Belt), 43, 38, 0, 81, Arkansas State, (11-18; 6-14 Sun Belt), 33, 24, 0, 57
400585867, 2015-03-07, Iowa State, (22-8; 12-6 Big 12), 26, 63, 0, 89, TCU, (17-14; 4-14 Big 12), 32, 44, 0, 76
400591035, 2015-03-07, Southern, (16-16; 13-5 SWAC), 44, 34, 0, 78, Texas Southern, (19-12; 16-2 SWAC), 51, 37, 0, 88
400765273, 2015-03-07, VMI, (11-19; 7-11 Southern), 20, 41, 0, 61, Mercer, (18-14; 12-6 Southern), 42, 47, 0, 89
400765313, 2015-03-07, Delaware, (10-20; 9-9 CAA), 31, 33, 0, 64, Northeastern, (21-11; 12-6 CAA), 35, 32, 0, 67
400588022, 2015-03-07, Duke, (28-3; 15-3 ACC), 31, 53, 0, 84, UNC, (21-10; 11-7 ACC), 33, 44, 0, 77
400766614, 2015-03-07, San Francisco, (14-18; 7-11 WCC), 29, 43, 0, 72, Gonzaga, (30-2; 17-1 WCC), 27, 54, 0, 81
400586101, 2015-03-07, North Dakota, (8-22; 4-14 Big Sky), 28, 43, 0, 71, N Colorado, (15-14; 10-8 Big Sky), 42, 30, 0, 72
400586102, 2015-03-07, E Washington, (23-8; 14-4 Big Sky), 27, 42, 10, 79, Weber State, (13-16; 8-10 Big Sky), 39, 30, 2, 71
400586104, 2015-03-07, Idaho, (13-16; 8-10 Big Sky), 30, 35, 0, 65, Idaho State, (7-23; 4-14 Big Sky), 34, 33, 0, 67
400586106, 2015-03-07, Portland State, (15-13; 9-9 Big Sky), 32, 54, 0, 86, Southern Utah, (10-19; 7-11 Big Sky), 36, 37, 0, 73
400590841, 2015-03-07, Seattle, (14-14; 7-7 WAC), 38, 32, 0, 70, Grand Canyon, (17-14; 8-6 WAC), 38, 45, 0, 83
400590842, 2015-03-07, Chicago State, (8-23; 4-10 WAC), 27, 30, 0, 57, New Mexico St, (21-10; 13-1 WAC), 37, 24, 0, 61
400591709, 2015-03-07, Colorado State, (26-5; 13-5 MW), 32, 43, 0, 75, Utah State, (18-12; 11-7 MW), 33, 37, 0, 70
400597436, 2015-03-07, Vanderbilt, (19-12; 9-9 SEC), 46, 40, 0, 86, Ole Miss, (20-11; 11-7 SEC), 33, 44, 0, 77
400586103, 2015-03-07, Montana, (18-11; 14-4 Big Sky), 31, 39, 0, 70, Montana State, (7-23; 4-14 Big Sky), 27, 27, 0, 54
400590840, 2015-03-07, CSU Bakersfield, (13-18; 7-7 WAC), 29, 40, 0, 69, Utah Valley, (11-18; 5-9 WAC), 39, 35, 0, 74
400765315, 2015-03-07, Denver, (12-18; 6-10 Summit), 27, 23, 0, 50, North Dakota St, (21-9; 12-4 Summit), 23, 38, 0, 61
400766620, 2015-03-07, Cleveland State, (18-14; 11-5 Horizon), 27, 28, 0, 55, Valparaiso, (27-5; 13-3 Horizon), 29, 31, 0, 60
400591710, 2015-03-07, Nevada, (9-21; 5-13 MW), 20, 23, 0, 43, San Diego State, (24-7; 14-4 MW), 37, 30, 0, 67
400591711, 2015-03-07, UNLV, (17-14; 8-10 MW), 31, 40, 0, 71, San Jose State, (2-28; 0-18 MW), 24, 34, 0, 58
400596015, 2015-03-07, UC Irvine, (18-12; 11-5 Big West), 28, 33, 0, 61, UC Davis, (24-5; 14-2 Big West), 24, 56, 0, 80
400766707, 2015-03-07, Santa Clara, (14-18; 7-11 WCC), 36, 40, 0, 76, BYU, (24-8; 13-5 WCC), 36, 42, 0, 78
400586860, 2015-03-08, Memphis, (18-13; 10-8 American), 21, 44, 0, 65, Cincinnati, (22-9; 13-5 American), 34, 43, 0, 77
400766751, 2015-03-08, Winthrop, (19-13; 12-6 Big South), 38, 32, 0, 70, Coast Carolina, (24-9; 12-6 Big South), 38, 43, 0, 81
400595559, 2015-03-08, Penn State, (16-15; 4-14 Big Ten), 43, 36, 0, 79, Minnesota, (17-14; 6-12 Big Ten), 34, 42, 0, 76
400766102, 2015-03-08, Stony Brook, (23-10; 12-4 Am. East), 29, 50, 0, 79, UVM, (18-13; 12-4 Am. East), 41, 36, 0, 77
400595743, 2015-03-08, Cent Arkansas, (2-27; 2-16 Southland), 30, 38, 0, 68, McNeese State, (14-15; 8-10 Southland), 26, 44, 0, 70
400766103, 2015-03-08, UNH, (19-12; 11-5 Am. East), 35, 23, 0, 58, Albany, (23-8; 15-1 Am. East), 32, 28, 0, 60
400766514, 2015-03-08, Lafayette, (19-12; 9-9 Patriot), 31, 49, 0, 80, Bucknell, (19-14; 13-5 Patriot), 34, 40, 0, 74
400766805, 2015-03-08, Illinois State, (21-12; 11-7 MVC), 36, 24, 0, 60, Northern Iowa, (30-3; 16-2 MVC), 22, 47, 0, 69
400766516, 2015-03-08, USC Upstate, (23-11; 8-6 A-Sun), 25, 32, 0, 57, North Florida, (23-11; 12-2 A-Sun), 34, 29, 0, 63
400766749, 2015-03-08, Hofstra, (20-13; 10-8 CAA), 32, 41, 18, 91, William & Mary, (20-11; 12-6 CAA), 35, 38, 19, 92
400586862, 2015-03-08, Tulsa, (21-9; 14-4 American), 28, 34, 0, 62, SMU, (24-6; 15-3 American), 29, 38, 0, 67
400586861, 2015-03-08, ECU, (13-18; 6-12 American), 24, 30, 0, 54, Houston, (12-18; 4-14 American), 35, 37, 0, 72
400766515, 2015-03-08, American U, (17-15; 8-10 Patriot), 38, 35, 0, 73, Colgate, (16-17; 12-6 Patriot), 21, 41, 0, 62
400595557, 2015-03-08, Wisconsin, (28-3; 16-2 Big Ten), 37, 35, 0, 72, OSU, (22-9; 11-7 Big Ten), 23, 25, 0, 48
400766750, 2015-03-08, Monmouth, (18-15; 13-7 MAAC), 45, 32, 0, 77, Iona, (26-7; 17-3 MAAC), 57, 38, 0, 95
400766880, 2015-03-08, Northeastern, (22-11; 12-6 CAA), 33, 45, 0, 78, UNC-Wilmington, (18-13; 12-6 CAA), 30, 41, 0, 71
400766753, 2015-03-08, W Carolina, (15-17; 9-9 Southern), 24, 37, 0, 61, Wofford, (27-6; 16-2 Southern), 35, 38, 0, 73
400765316, 2015-03-08, South Dakota, (17-15; 9-7 Summit), 44, 38, 0, 82, IPFW, (16-14; 9-7 Summit), 23, 50, 0, 73
400766879, 2015-03-08, St Peter's, (16-18; 8-12 MAAC), 23, 25, 0, 48, Manhattan, (18-13; 13-7 MAAC), 33, 32, 0, 65
400595558, 2015-03-08, Maryland, (26-5; 14-4 Big Ten), 31, 33, 0, 64, Nebraska, (13-17; 5-13 Big Ten), 29, 32, 0, 61
400766881, 2015-03-08, Furman, (11-21; 5-13 Southern), 23, 29, 0, 52, Mercer, (18-15; 12-6 Southern), 31, 18, 0, 49
400765317, 2015-03-08, IUPUI, (10-21; 6-10 Summit), 25, 31, 0, 56, Oral Roberts, (18-13; 10-6 Summit), 27, 31, 0, 58
400766582, 2015-03-09, Savannah State, (9-22; 5-11 MEAC), 26, 32, 0, 58, Delaware State, (16-16; 9-7 MEAC), 25, 39, 0, 64
400766774, 2015-03-09, N Illinois, (14-16; 8-10 MAC), 20, 32, 0, 52, Akron, (19-13; 9-9 MAC), 48, 28, 0, 76
400766775, 2015-03-09, Ball State, (7-23; 2-16 MAC), 34, 41, 0, 75, Bowling Green, (20-10; 11-7 MAC), 50, 38, 0, 88
400767054, 2015-03-09, Northeastern, (23-11; 12-6 CAA), 36, 36, 0, 72, William & Mary, (20-12; 12-6 CAA), 26, 35, 0, 61
400767055, 2015-03-09, South Dakota, (17-16; 9-7 Summit), 25, 40, 0, 65, South Dakota St, (23-9; 12-4 Summit), 44, 34, 0, 78
400767077, 2015-03-09, Furman, (11-22; 5-13 Southern), 36, 28, 0, 64, Wofford, (28-6; 16-2 Southern), 36, 31, 0, 67
400766776, 2015-03-09, Miami (OH), (13-19; 8-10 MAC), 33, 21, 7, 61, E Michigan, (20-12; 8-10 MAC), 29, 25, 8, 62
400766777, 2015-03-09, Ohio, (10-20; 5-13 MAC), 33, 41, 0, 74, W Michigan, (20-12; 10-8 MAC), 31, 51, 0, 82
400766905, 2015-03-09, Pepperdine, (18-13; 10-8 WCC), 33, 28, 0, 61, Gonzaga, (31-2; 17-1 WCC), 35, 44, 0, 79
400766583, 2015-03-09, Morgan State, (7-24; 5-11 MEAC), 32, 39, 0, 71, Hampton, (13-17; 8-8 MEAC), 37, 54, 0, 91
400767056, 2015-03-09, Manhattan, (19-13; 13-7 MAAC), 39, 40, 0, 79, Iona, (26-8; 17-3 MAAC), 37, 32, 0, 69
400767095, 2015-03-09, Oral Roberts, (18-14; 10-6 Summit), 26, 30, 0, 56, North Dakota St, (22-9; 12-4 Summit), 34, 26, 0, 60
400766986, 2015-03-09, Portland, (17-15; 7-11 WCC), 24, 46, 0, 70, BYU, (25-8; 13-5 WCC), 42, 42, 0, 84
400766811, 2015-03-10, Georgia Tech, (12-19; 3-15 ACC), 34, 31, 0, 65, Boston College, (13-18; 4-14 ACC), 35, 31, 0, 66
400766812, 2015-03-10, VT, (11-21; 2-16 ACC), 41, 40, 0, 81, Wake Forest, (13-19; 5-13 ACC), 31, 49, 0, 80
400766581, 2015-03-10, Coppin State, (8-22; 6-10 MEAC), 29, 35, 0, 64, Bethune-Cookman, (11-21; 7-9 MEAC), 23, 37, 0, 60
400766744, 2015-03-10, Robert Morris, (19-14; 12-6 NEC), 29, 37, 0, 66, St Francis (BKN), (23-11; 15-3 NEC), 35, 28, 0, 63
400766909, 2015-03-10, Green Bay, (24-8; 12-4 Horizon), 25, 19, 0, 44, Valparaiso, (28-5; 13-3 Horizon), 19, 35, 0, 54
400591311, 2015-03-10, Princeton, (16-14; 9-5 Ivy), 37, 36, 0, 73, Penn, (9-19; 4-10 Ivy), 31, 21, 0, 52
400766584, 2015-03-10, NC A&T, (9-23; 6-10 MEAC), 21, 33, 0, 54, S Carolina St, (11-21; 7-9 MEAC), 37, 26, 0, 63
400768043, 2015-03-10, BYU, (25-9; 13-5 WCC), 42, 33, 0, 75, Gonzaga, (32-2; 17-1 WCC), 48, 43, 0, 91
400768040, 2015-03-10, North Dakota St, (23-9; 12-4 Summit), 23, 34, 0, 57, South Dakota St, (23-10; 12-4 Summit), 23, 33, 0, 56
400766994, 2015-03-10, Grambling St, (2-27; 0-18 SWAC), 18, 34, 0, 52, Alcorn State, (6-25; 4-14 SWAC), 29, 37, 0, 66
400766813, 2015-03-11, FSU, (17-15; 8-10 ACC), 33, 43, 0, 76, Clemson, (16-15; 8-10 ACC), 26, 47, 0, 73
400766873, 2015-03-11, FIU, (16-16; 8-10 C-USA), 25, 32, 0, 57, UTSA, (14-16; 8-10 C-USA), 26, 28, 0, 54
400768119, 2015-03-11, Boston College, (13-19; 4-14 ACC), 30, 33, 0, 63, UNC, (22-10; 11-7 ACC), 43, 38, 0, 81
400766856, 2015-03-11, Washington St, (13-18; 7-11 Pac-12), 26, 33, 0, 59, Cal, (18-14; 7-11 Pac-12), 37, 47, 0, 84
400766998, 2015-03-11, Air Force, (14-16; 6-12 MW), 28, 40, 0, 68, New Mexico, (15-16; 7-11 MW), 32, 29, 0, 61
400766914, 2015-03-11, Charlotte, (14-18; 7-11 C-USA), 30, 30, 0, 60, Mid Tennessee, (17-15; 9-9 C-USA), 29, 34, 0, 63
400766997, 2015-03-11, Miss Valley St, (6-26; 5-13 SWAC), 46, 35, 0, 81, Alabama State, (19-9; 14-4 SWAC), 50, 43, 0, 93
400767073, 2015-03-11, Penn State, (17-15; 4-14 Big Ten), 34, 34, 0, 68, Nebraska, (13-18; 5-13 Big Ten), 29, 36, 0, 65
400766857, 2015-03-11, USC, (12-19; 3-15 Pac-12), 28, 39, 0, 67, Arizona State, (17-15; 9-9 Pac-12), 38, 26, 0, 64
400766999, 2015-03-11, Nevada, (9-22; 5-13 MW), 17, 29, 0, 46, UNLV, (18-14; 8-10 MW), 27, 40, 0, 67
400767023, 2015-03-11, SE Louisiana, (9-23; 6-12 Southland), 27, 28, 5, 60, McNeese State, (15-15; 8-10 Southland), 27, 28, 7, 62
400768154, 2015-03-11, Coppin State, (8-23; 6-10 MEAC), 22, 21, 0, 43, NC Central, (25-6; 16-0 MEAC), 44, 47, 0, 91
400766862, 2015-03-11, George Mason, (9-22; 4-14 A 10), 28, 37, 0, 65, Fordham, (10-20; 4-14 A 10), 34, 37, 0, 71
400768035, 2015-03-11, E Michigan, (21-12; 8-10 MAC), 40, 33, 0, 73, Bowling Green, (20-11; 11-7 MAC), 39, 28, 0, 67
400766778, 2015-03-11, Marquette, (13-18; 4-14 Big East), 35, 43, 0, 78, Seton Hall, (16-15; 6-12 Big East), 22, 34, 0, 56
400766834, 2015-03-11, Pitt, (19-14; 8-10 ACC), 23, 47, 0, 70, NC State, (20-12; 10-8 ACC), 37, 44, 0, 81
400766866, 2015-03-11, Auburn, (13-19; 4-14 SEC), 34, 40, 0, 74, Miss St, (13-19; 6-12 SEC), 36, 32, 0, 68
400766883, 2015-03-11, TCU, (18-14; 4-14 Big 12), 35, 32, 0, 67, Kansas State, (15-17; 8-10 Big 12), 27, 38, 0, 65
400766915, 2015-03-11, Marshall, (11-21; 7-11 C-USA), 20, 25, 0, 45, W Kentucky, (20-11; 12-6 C-USA), 26, 33, 0, 59
400767074, 2015-03-11, Rutgers, (10-22; 2-16 Big Ten), 27, 41, 0, 68, Minnesota, (18-14; 6-12 Big Ten), 30, 50, 0, 80
400767031, 2015-03-11, American U, (17-16; 8-10 Patriot), 25, 38, 0, 63, Lafayette, (20-12; 9-9 Patriot), 34, 31, 0, 65
400768174, 2015-03-11, S Carolina St, (11-22; 7-9 MEAC), 31, 23, 0, 54, Norfolk State, (20-12; 12-4 MEAC), 30, 38, 0, 68
400767024, 2015-03-11, New Orleans, (11-17; 6-12 Southland), 39, 43, 0, 82, Nicholls State, (10-19; 7-11 Southland), 42, 31, 0, 73
400766858, 2015-03-11, Colorado, (15-16; 7-11 Pac-12), 38, 40, 0, 78, Oregon State, (17-14; 8-10 Pac-12), 40, 31, 0, 71
400766863, 2015-03-11, Saint Louis, (11-21; 3-15 A 10), 26, 29, 0, 55, Duquesne, (12-18; 6-12 A 10), 23, 38, 0, 61
400768037, 2015-03-11, Akron, (20-13; 9-9 MAC), 27, 31, 0, 58, W Michigan, (20-13; 10-8 MAC), 20, 25, 0, 45
400766779, 2015-03-11, Creighton, (14-18; 4-14 Big East), 35, 43, 0, 78, DePaul, (12-20; 6-12 Big East), 33, 30, 0, 63
400766884, 2015-03-11, Texas Tech, (13-19; 3-15 Big 12), 26, 27, 0, 53, Texas, (20-12; 8-10 Big 12), 30, 35, 0, 65
400766916, 2015-03-11, Rice, (12-19; 8-10 C-USA), 38, 44, 0, 82, North Texas, (14-17; 8-10 C-USA), 30, 24, 0, 54
400768176, 2015-03-11, Alcorn State, (6-26; 4-14 SWAC), 36, 38, 0, 74, Texas Southern, (20-12; 16-2 SWAC), 49, 46, 0, 95
400766867, 2015-03-11, Missouri, (9-23; 3-15 SEC), 24, 30, 0, 54, South Carolina, (16-15; 6-12 SEC), 30, 33, 0, 63
400768122, 2015-03-11, VT, (11-22; 2-16 ACC), 19, 30, 0, 49, Miami (FL), (21-11; 10-8 ACC), 25, 34, 0, 59
400766859, 2015-03-11, Washington, (16-15; 5-13 Pac-12), 32, 37, 0, 69, Stanford, (19-12; 9-9 Pac-12), 32, 39, 0, 71
400768333, 2015-03-12, FSU, (17-16; 8-10 ACC), 17, 27, 0, 44, UVA, (29-2; 16-2 ACC), 34, 24, 0, 58
400768417, 2015-03-12, Marquette, (13-19; 4-14 Big East), 21, 28, 0, 49, Villanova, (30-2; 16-2 Big East), 39, 45, 0, 84
400766864, 2015-03-12, La Salle, (17-15; 8-10 A 10), 31, 45, 0, 76, UMass, (17-15; 10-8 A 10), 30, 39, 0, 69
400767075, 2015-03-12, Michigan, (16-15; 8-10 Big Ten), 40, 33, 0, 73, Illinois, (19-13; 9-9 Big Ten), 23, 32, 0, 55
400766885, 2015-03-12, West Virginia, (23-9; 11-7 Big 12), 36, 34, 0, 70, Baylor, (24-8; 11-7 Big 12), 38, 42, 0, 80
400766868, 2015-03-12, Alabama, (18-14; 8-10 SEC), 29, 32, 0, 61, Florida, (16-16; 8-10 SEC), 33, 36, 0, 69
400766966, 2015-03-12, Idaho, (13-17; 8-10 Big Sky), 41, 42, 0, 83, E Washington, (24-8; 14-4 Big Sky), 38, 53, 0, 91
400768335, 2015-03-12, FIU, (16-17; 8-10 C-USA), 33, 38, 0, 71, UTEP, (22-9; 13-5 C-USA), 47, 36, 0, 83
400768355, 2015-03-12, Penn State, (18-15; 4-14 Big Ten), 19, 48, 0, 67, Iowa, (21-11; 12-6 Big Ten), 27, 31, 0, 58
400766780, 2015-03-12, St John's, (21-11; 10-8 Big East), 27, 30, 0, 57, Providence, (22-10; 11-7 Big East), 40, 34, 0, 74
400768341, 2015-03-12, UNC, (23-10; 11-7 ACC), 32, 38, 0, 70, Louisville, (24-8; 12-6 ACC), 37, 23, 0, 60
400768416, 2015-03-12, Fordham, (10-21; 4-14 A 10), 30, 27, 0, 57, VCU, (23-9; 12-6 A 10), 30, 33, 0, 63
400768342, 2015-03-12, Cal, (18-15; 7-11 Pac-12), 27, 24, 0, 51, Arizona, (29-3; 16-2 Pac-12), 33, 40, 0, 73
400768343, 2015-03-12, Air Force, (14-17; 6-12 MW), 28, 40, 0, 68, Boise State, (25-7; 14-4 MW), 32, 48, 0, 80
400766970, 2015-03-12, CS Northridge, (9-24; 4-12 Big West), 36, 31, 0, 67, UC Davis, (25-5; 14-2 Big West), 28, 43, 0, 71
400768419, 2015-03-12, TCU, (18-15; 4-14 Big 12), 26, 33, 0, 59, Kansas, (25-7; 13-5 Big 12), 33, 31, 0, 64
400766967, 2015-03-12, Portland State, (15-14; 9-9 Big Sky), 31, 29, 0, 60, Sacramento St, (20-10; 13-5 Big Sky), 27, 43, 0, 70
400766996, 2015-03-12, Alabama A&M, (9-20; 8-10 SWAC), 29, 31, 0, 60, Southern, (17-16; 13-5 SWAC), 27, 37, 0, 64
400767027, 2015-03-12, UCF, (12-18; 5-13 American), 30, 46, 4, 80, ECU, (14-18; 6-12 American), 38, 38, 5, 81
400768344, 2015-03-12, Mid Tennessee, (18-15; 9-9 C-USA), 25, 34, 0, 59, Old Dominion, (24-7; 13-5 C-USA), 20, 32, 0, 52
400768421, 2015-03-12, Auburn, (14-19; 4-14 SEC), 23, 43, 0, 66, Texas A&M, (20-11; 11-7 SEC), 33, 26, 0, 59
400766870, 2015-03-12, Utah Valley, (11-19; 5-9 WAC), 22, 18, 0, 40, CSU Bakersfield, (14-18; 7-7 WAC), 24, 31, 0, 55
400766971, 2015-03-12, Hawaii, (21-12; 8-8 Big West), 47, 32, 0, 79, LBSU, (16-17; 10-6 Big West), 41, 31, 0, 72
400767000, 2015-03-12, Utah State, (18-13; 11-7 MW), 26, 39, 0, 65, Wyoming, (23-9; 11-7 MW), 26, 41, 0, 67
400768402, 2015-03-12, USC, (12-20; 3-15 Pac-12), 29, 41, 0, 70, UCLA, (20-12; 11-7 Pac-12), 47, 49, 0, 96
400766854, 2015-03-12, Texas State, (14-16; 7-13 Sun Belt), 33, 35, 0, 68, UT-Arlington, (16-15; 10-10 Sun Belt), 29, 33, 0, 62
400767028, 2015-03-12, Houston, (13-18; 4-14 American), 28, 38, 0, 66, Tulane, (15-16; 6-12 American), 25, 35, 0, 60
400768039, 2015-03-12, Hampton, (14-17; 8-8 MEAC), 37, 39, 0, 76, MD-E Shore, (18-14; 11-5 MEAC), 33, 38, 0, 71
400768414, 2015-03-12, McNeese State, (15-16; 8-10 Southland), 34, 55, 0, 89, Northwestern St, (19-11; 13-5 Southland), 41, 55, 0, 96
400766865, 2015-03-12, Saint Joe's, (13-18; 7-11 A 10), 28, 21, 0, 49, St Bonaventure, (18-12; 10-8 A 10), 23, 37, 0, 60
400767076, 2015-03-12, Northwestern, (15-17; 6-12 Big Ten), 22, 34, 0, 56, Indiana, (20-12; 9-9 Big Ten), 36, 35, 0, 71
400768418, 2015-03-12, E Michigan, (21-13; 8-10 MAC), 29, 38, 0, 67, Toledo, (20-12; 11-7 MAC), 38, 40, 0, 78
400768420, 2015-03-12, NC State, (20-13; 10-8 ACC), 22, 31, 0, 53, Duke, (29-3; 15-3 ACC), 49, 28, 0, 77
400768441, 2015-03-12, Texas, (20-13; 8-10 Big 12), 36, 31, 0, 67, Iowa State, (23-8; 12-6 Big 12), 25, 44, 0, 69
400768446, 2015-03-12, Creighton, (14-19; 4-14 Big East), 25, 30, 0, 55, Georgetown, (21-9; 12-6 Big East), 31, 29, 0, 60
400766869, 2015-03-12, Tennessee, (16-15; 7-11 SEC), 32, 35, 0, 67, Vanderbilt, (19-13; 9-9 SEC), 38, 23, 0, 61
400768425, 2015-03-12, W Kentucky, (20-12; 12-6 C-USA), 26, 26, 0, 52, UAB, (17-15; 12-6 C-USA), 26, 27, 0, 53
400766871, 2015-03-12, UT Pan American, (10-21; 4-10 WAC), 29, 32, 0, 61, UMKC, (14-18; 8-6 WAC), 33, 37, 0, 70
400766968, 2015-03-12, N Colorado, (15-15; 10-8 Big Sky), 30, 27, 0, 57, N Arizona, (19-13; 13-5 Big Sky), 34, 29, 0, 63
400767029, 2015-03-12, USF, (9-23; 3-15 American), 14, 29, 0, 43, UConn, (18-13; 10-8 American), 29, 40, 0, 69
400766855, 2015-03-12, AR-Little Rock, (13-18; 8-12 Sun Belt), 22, 33, 0, 55, South Alabama, (12-20; 9-11 Sun Belt), 32, 25, 0, 57
400768437, 2015-03-12, New Orleans, (11-18; 6-12 Southland), 34, 24, 0, 58, Texas A&M-CC, (19-12; 13-5 Southland), 33, 28, 0, 61
400768422, 2015-03-12, Minnesota, (18-15; 6-12 Big Ten), 35, 38, 0, 73, OSU, (23-9; 11-7 Big Ten), 35, 44, 0, 79
400766972, 2015-03-12, UC Riverside, (14-17; 7-9 Big West), 23, 31, 0, 54, UC Irvine, (19-12; 11-5 Big West), 24, 39, 0, 63
400768025, 2015-03-12, Delaware State, (17-16; 9-7 MEAC), 26, 39, 0, 65, Howard, (16-16; 10-6 MEAC), 25, 35, 0, 60
400768401, 2015-03-12, UNLV, (18-15; 8-10 MW), 29, 35, 0, 64, San Diego State, (25-7; 14-4 MW), 23, 44, 0, 67
400768439, 2015-03-12, Akron, (21-13; 9-9 MAC), 19, 34, 0, 53, Kent State, (21-11; 12-6 MAC), 27, 24, 0, 51
400768440, 2015-03-12, Colorado, (15-17; 7-11 Pac-12), 37, 48, 0, 85, Oregon, (24-8; 13-5 Pac-12), 34, 59, 0, 93
400768445, 2015-03-12, Duquesne, (12-19; 6-12 A 10), 27, 28, 0, 55, G Washington, (21-11; 10-8 A 10), 40, 33, 0, 73
400768443, 2015-03-12, South Carolina, (17-15; 6-12 SEC), 27, 33, 0, 60, Ole Miss, (20-12; 11-7 SEC), 24, 34, 0, 58
400766886, 2015-03-12, Oklahoma State, (18-13; 8-10 Big 12), 26, 23, 0, 49, Oklahoma, (22-9; 12-6 Big 12), 21, 43, 0, 64
400766781, 2015-03-12, Xavier, (20-12; 9-9 Big East), 30, 23, 14, 67, Butler, (22-10; 12-6 Big East), 28, 25, 8, 61
400766995, 2015-03-12, Jackson State, (11-21; 9-9 SWAC), 26, 30, 0, 56, PV A&M, (15-17; 12-6 SWAC), 35, 27, 0, 62
400768442, 2015-03-12, Rice, (12-20; 8-10 C-USA), 25, 39, 0, 64, LA Tech, (25-7; 15-3 C-USA), 35, 35, 0, 70
400768444, 2015-03-12, Miami (FL), (21-12; 10-8 ACC), 25, 38, 0, 63, Notre Dame, (27-5; 14-4 ACC), 43, 27, 0, 70
400766969, 2015-03-12, Weber State, (13-17; 8-10 Big Sky), 27, 40, 6, 73, Montana, (19-11; 14-4 Big Sky), 35, 32, 9, 76
400766872, 2015-03-12, Chicago State, (8-24; 4-10 WAC), 33, 12, 0, 45, Seattle, (15-14; 7-7 WAC), 23, 26, 0, 49
400767001, 2015-03-12, Fresno State, (15-17; 10-8 MW), 22, 37, 0, 59, Colorado State, (27-5; 13-5 MW), 40, 31, 0, 71
400766973, 2015-03-12, Cal Poly, (13-16; 6-10 Big West), 22, 28, 0, 50, UCSB, (19-12; 11-5 Big West), 27, 27, 0, 54
400768452, 2015-03-12, Stanford, (19-13; 9-9 Pac-12), 39, 17, 0, 56, Utah, (24-7; 13-5 Pac-12), 34, 46, 0, 80
400784915, 2015-03-13, Michigan, (16-16; 8-10 Big Ten), 26, 34, 0, 60, Wisconsin, (29-3; 16-2 Big Ten), 31, 40, 0, 71
400768708, 2015-03-13, ECU, (14-19; 6-12 American), 32, 36, 0, 68, SMU, (25-6; 15-3 American), 37, 37, 0, 74
400768711, 2015-03-13, La Salle, (17-16; 8-10 A 10), 46, 20, 0, 66, Davidson, (24-6; 14-4 A 10), 37, 30, 0, 67
400784919, 2015-03-13, Florida, (16-17; 8-10 SEC), 27, 22, 0, 49, Kentucky, (32-0; 18-0 SEC), 31, 33, 0, 64
400784916, 2015-03-13, Penn State, (18-16; 4-14 Big Ten), 37, 22, 0, 59, Purdue, (21-11; 12-6 Big Ten), 32, 32, 0, 64
400767030, 2015-03-13, Memphis, (18-14; 10-8 American), 32, 43, 0, 75, Temple, (23-9; 13-5 American), 31, 49, 0, 80
400768712, 2015-03-13, VCU, (24-9; 12-6 A 10), 37, 33, 0, 70, Richmond, (19-13; 12-6 A 10), 36, 31, 0, 67
400784920, 2015-03-13, Auburn, (15-19; 4-14 SEC), 24, 40, 9, 73, LSU, (22-10; 11-7 SEC), 28, 36, 6, 70
400784966, 2015-03-13, Southern, (18-16; 13-5 SWAC), 35, 33, 0, 68, Alabama State, (19-10; 14-4 SWAC), 32, 34, 0, 66
400784969, 2015-03-13, Mid Tennessee, (19-15; 9-9 C-USA), 20, 33, 0, 53, UTEP, (22-10; 13-5 C-USA), 25, 25, 0, 50
400784973, 2015-03-13, Northwestern St, (19-12; 13-5 Southland), 41, 38, 0, 79, SF Austin, (28-4; 17-1 Southland), 45, 46, 0, 91
400784974, 2015-03-13, Texas State, (14-17; 7-13 Sun Belt), 21, 22, 0, 43, LA-Lafayette, (20-12; 13-7 Sun Belt), 18, 35, 0, 53
400784997, 2015-03-13, Delaware State, (18-16; 9-7 MEAC), 23, 40, 0, 63, NC Central, (25-7; 16-0 MEAC), 32, 25, 0, 57
400784918, 2015-03-13, Indiana, (20-13; 9-9 Big Ten), 40, 29, 0, 69, Maryland, (27-5; 14-4 Big Ten), 42, 33, 0, 75
400784914, 2015-03-13, St Bonaventure, (18-13; 10-8 A 10), 36, 35, 0, 71, Dayton, (24-7; 13-5 A 10), 34, 41, 0, 75
400784976, 2015-03-13, Toledo, (20-13; 11-7 MAC), 26, 40, 0, 66, Cent Michigan, (23-7; 12-6 MAC), 33, 42, 0, 75
400785002, 2015-03-13, UAB, (18-15; 12-6 C-USA), 36, 22, 14, 72, LA Tech, (25-8; 15-3 C-USA), 26, 32, 4, 62
400784957, 2015-03-13, UNC, (24-10; 11-7 ACC), 30, 41, 0, 71, UVA, (29-3; 16-2 ACC), 23, 44, 0, 67
400784956, 2015-03-13, Providence, (22-11; 11-7 Big East), 28, 33, 0, 61, Villanova, (31-2; 16-2 Big East), 33, 30, 0, 63
400784968, 2015-03-13, Baylor, (24-9; 11-7 Big 12), 18, 34, 0, 52, Kansas, (26-7; 13-5 Big 12), 26, 36, 0, 62
400784922, 2015-03-13, Tennessee, (16-16; 7-11 SEC), 25, 47, 0, 72, Arkansas, (25-7; 13-5 SEC), 45, 35, 0, 80
400768710, 2015-03-13, Houston, (13-19; 4-14 American), 24, 27, 0, 51, Tulsa, (22-9; 14-4 American), 28, 31, 0, 59
400784967, 2015-03-13, Sacramento St, (20-11; 13-5 Big Sky), 34, 49, 0, 83, E Washington, (25-8; 14-4 Big Sky), 49, 42, 0, 91
400784975, 2015-03-13, Hampton, (15-17; 8-8 MEAC), 36, 39, 0, 75, Norfolk State, (20-13; 12-4 MEAC), 33, 31, 0, 64
400784996, 2015-03-13, South Alabama, (12-21; 9-11 Sun Belt), 26, 33, 0, 59, UL Monroe, (21-11; 14-6 Sun Belt), 36, 41, 0, 77
400784995, 2015-03-13, Texas A&M-CC, (19-13; 13-5 Southland), 29, 38, 0, 67, Sam Houston, (25-7; 15-3 Southland), 21, 49, 0, 70
400784972, 2015-03-13, Wyoming, (24-9; 11-7 MW), 36, 21, 14, 71, Boise State, (25-8; 14-4 MW), 38, 19, 9, 66
400768713, 2015-03-13, G Washington, (21-12; 10-8 A 10), 32, 26, 0, 58, URI, (22-8; 13-5 A 10), 30, 41, 0, 71
400784970, 2015-03-13, CSU Bakersfield, (14-19; 7-7 WAC), 23, 30, 0, 53, New Mexico St, (22-10; 13-1 WAC), 28, 29, 0, 57
400785001, 2015-03-13, Akron, (21-14; 9-9 MAC), 32, 27, 0, 59, Buffalo, (22-9; 12-6 MAC), 33, 35, 0, 68
400784965, 2015-03-13, UCLA, (20-13; 11-7 Pac-12), 27, 37, 0, 64, Arizona, (30-3; 16-2 Pac-12), 27, 43, 0, 70
400784917, 2015-03-13, OSU, (23-10; 11-7 Big Ten), 28, 39, 0, 67, Michigan State, (22-10; 12-6 Big Ten), 36, 40, 0, 76
400768709, 2015-03-13, UConn, (19-13; 10-8 American), 21, 36, 0, 57, Cincinnati, (22-10; 13-5 American), 22, 32, 0, 54
400784980, 2015-03-13, Xavier, (21-12; 9-9 Big East), 35, 30, 0, 65, Georgetown, (21-10; 12-6 Big East), 26, 37, 0, 63
400784931, 2015-03-13, Hawaii, (22-12; 8-8 Big West), 26, 39, 0, 65, UC Davis, (25-6; 14-2 Big West), 23, 35, 0, 58
400785000, 2015-03-13, PV A&M, (15-18; 12-6 SWAC), 33, 44, 0, 77, Texas Southern, (21-12; 16-2 SWAC), 41, 49, 0, 90
400784977, 2015-03-13, Oklahoma, (22-10; 12-6 Big 12), 29, 36, 0, 65, Iowa State, (24-8; 12-6 Big 12), 29, 38, 0, 67
400784978, 2015-03-13, Notre Dame, (28-5; 14-4 ACC), 41, 33, 0, 74, Duke, (29-4; 15-3 ACC), 26, 38, 0, 64
400784921, 2015-03-13, South Carolina, (17-16; 6-12 SEC), 26, 36, 0, 62, Georgia, (21-10; 11-7 SEC), 33, 41, 0, 74
400784929, 2015-03-13, N Arizona, (19-14; 13-5 Big Sky), 30, 29, 0, 59, Montana, (20-11; 14-4 Big Sky), 33, 28, 0, 61
400784930, 2015-03-13, Seattle, (16-14; 7-7 WAC), 34, 35, 0, 69, UMKC, (14-19; 8-6 WAC), 18, 45, 0, 63
400784999, 2015-03-13, Utah, (24-8; 13-5 Pac-12), 31, 33, 0, 64, Oregon, (25-8; 13-5 Pac-12), 30, 37, 0, 67
400784933, 2015-03-13, Colorado State, (27-6; 13-5 MW), 18, 25, 0, 43, San Diego State, (26-7; 14-4 MW), 24, 32, 0, 56
400784932, 2015-03-13, UC Irvine, (20-12; 11-5 Big West), 34, 25, 13, 72, UCSB, (19-13; 11-5 Big West), 27, 32, 4, 63
400767020, 2015-03-14, Stony Brook, (23-11; 12-4 Am. East), 20, 30, 0, 50, Albany, (24-8; 15-1 Am. East), 16, 35, 0, 51
400785062, 2015-03-14, Auburn, (15-20; 4-14 SEC), 29, 38, 0, 67, Kentucky, (33-0; 18-0 SEC), 47, 44, 0, 91
400785059, 2015-03-14, Purdue, (21-12; 12-6 Big Ten), 35, 16, 0, 51, Wisconsin, (30-3; 16-2 Big Ten), 30, 41, 0, 71
400785115, 2015-03-14, Hampton, (16-17; 8-8 MEAC), 32, 50, 0, 82, Delaware State, (18-17; 9-7 MEAC), 32, 29, 0, 61
400785065, 2015-03-14, VCU, (25-9; 12-6 A 10), 44, 49, 0, 93, Davidson, (24-7; 14-4 A 10), 28, 45, 0, 73
400785097, 2015-03-14, LA-Lafayette, (20-13; 13-7 Sun Belt), 27, 52, 0, 79, Georgia State, (23-9; 15-5 Sun Belt), 44, 39, 0, 83
400785060, 2015-03-14, Temple, (23-10; 13-5 American), 28, 28, 0, 56, SMU, (26-6; 15-3 American), 26, 43, 0, 69
400785101, 2015-03-14, Michigan State, (23-10; 12-6 Big Ten), 25, 37, 0, 62, Maryland, (27-6; 14-4 Big Ten), 33, 25, 0, 58
400785103, 2015-03-14, Mid Tennessee, (19-16; 9-9 C-USA), 26, 34, 0, 60, UAB, (19-15; 12-6 C-USA), 37, 36, 0, 73
400785111, 2015-03-14, Georgia, (21-11; 11-7 SEC), 17, 32, 0, 49, Arkansas, (26-7; 13-5 SEC), 25, 35, 0, 60
400766836, 2015-03-14, Harvard, (22-7; 11-3 Ivy), 23, 30, 0, 53, Yale, (22-10; 11-3 Ivy), 27, 24, 0, 51
400785100, 2015-03-14, URI, (22-9; 13-5 A 10), 24, 28, 0, 52, Dayton, (25-7; 13-5 A 10), 24, 32, 0, 56
400785113, 2015-03-14, UL Monroe, (21-12; 14-6 Sun Belt), 22, 21, 0, 43, Ga Southern, (22-8; 14-6 Sun Belt), 20, 24, 0, 44
400785102, 2015-03-14, UConn, (20-13; 10-8 American), 19, 28, 0, 47, Tulsa, (22-10; 14-4 American), 23, 19, 0, 42
400785105, 2015-03-14, Iowa State, (25-8; 12-6 Big 12), 23, 47, 0, 70, Kansas, (26-8; 13-5 Big 12), 37, 29, 0, 66
400785255, 2015-03-14, Wyoming, (25-9; 11-7 MW), 28, 17, 0, 45, San Diego State, (26-8; 14-4 MW), 25, 18, 0, 43
400785118, 2015-03-14, Southern, (18-17; 13-5 SWAC), 27, 31, 0, 58, Texas Southern, (22-12; 16-2 SWAC), 28, 34, 0, 62
400785119, 2015-03-14, Buffalo, (23-9; 12-6 MAC), 42, 47, 0, 89, Cent Michigan, (23-8; 12-6 MAC), 39, 45, 0, 84
400785106, 2015-03-14, Xavier, (21-13; 9-9 Big East), 21, 31, 0, 52, Villanova, (32-2; 16-2 Big East), 34, 35, 0, 69
400785107, 2015-03-14, UNC, (24-11; 11-7 ACC), 34, 48, 0, 82, Notre Dame, (29-5; 14-4 ACC), 39, 51, 0, 90
400785121, 2015-03-14, E Washington, (26-8; 14-4 Big Sky), 29, 40, 0, 69, Montana, (20-12; 14-4 Big Sky), 30, 35, 0, 65
400785116, 2015-03-14, Sam Houston, (25-8; 15-3 Southland), 27, 43, 0, 70, SF Austin, (29-4; 17-1 Southland), 37, 46, 0, 83
400785117, 2015-03-14, Oregon, (25-9; 13-5 Pac-12), 21, 31, 0, 52, Arizona, (31-3; 16-2 Pac-12), 36, 44, 0, 80
400785254, 2015-03-14, Seattle, (16-15; 7-7 WAC), 22, 39, 0, 61, New Mexico St, (23-10; 13-1 WAC), 33, 47, 0, 80
400785274, 2015-03-14, Hawaii, (22-13; 8-8 Big West), 33, 25, 0, 58, UC Irvine, (21-12; 11-5 Big West), 29, 38, 0, 67
400785256, 2015-03-15, Arkansas, (26-8; 13-5 SEC), 25, 38, 0, 63, Kentucky, (34-0; 18-0 SEC), 41, 37, 0, 78
400785258, 2015-03-15, VCU, (26-9; 12-6 A 10), 33, 38, 0, 71, Dayton, (25-8; 13-5 A 10), 26, 39, 0, 65
400785334, 2015-03-15, Ga Southern, (22-9; 14-6 Sun Belt), 16, 20, 0, 36, Georgia State, (24-9; 15-5 Sun Belt), 19, 19, 0, 38
400785259, 2015-03-15, UConn, (20-14; 10-8 American), 19, 35, 0, 54, SMU, (27-6; 15-3 American), 33, 29, 0, 62
400785257, 2015-03-15, Michigan State, (23-11; 12-6 Big Ten), 32, 37, 0, 69, Wisconsin, (31-3; 16-2 Big Ten), 31, 38, 11, 80
400785480, 2015-03-17, Iona, (26-9; 17-3 MAAC), 39, 36, 0, 75, URI, (23-9; 13-5 A 10), 51, 37, 0, 88
400785497, 2015-03-17, NC Central, (25-8; 16-0 MEAC), 25, 46, 0, 71, Miami (FL), (22-12; 10-8 ACC), 34, 41, 0, 75
400785498, 2015-03-17, G Washington, (22-12; 10-8 A 10), 28, 32, 0, 60, Pitt, (19-15; 8-10 ACC), 23, 31, 0, 54
400785478, 2015-03-17, Cent Michigan, (23-9; 12-6 MAC), 33, 46, 0, 79, LA Tech, (26-8; 15-3 C-USA), 45, 44, 0, 89
400785501, 2015-03-17, William & Mary, (20-13; 12-6 CAA), 32, 35, 0, 67, Tulsa, (23-10; 14-4 American), 39, 31, 0, 70
400785477, 2015-03-17, Alabama, (19-14; 8-10 SEC), 46, 33, 0, 79, Illinois, (19-14; 9-9 Big Ten), 22, 36, 0, 58
400785479, 2015-03-17, UTEP, (22-11; 13-5 C-USA), 32, 34, 0, 66, Murray State, (28-5; 16-0 OVC), 37, 44, 0, 81
400785499, 2015-03-17, Montana, (20-13; 14-4 Big Sky), 33, 31, 0, 64, Texas A&M, (21-11; 11-7 SEC), 38, 43, 0, 81
400785503, 2015-03-17, UC Davis, (25-7; 14-2 Big West), 36, 28, 0, 64, Stanford, (20-13; 9-9 Pac-12), 37, 40, 0, 77
400785495, 2015-03-18, Bucknell, (19-15; 13-5 Patriot), 35, 32, 0, 67, Temple, (24-10; 13-5 American), 35, 38, 0, 73
400785496, 2015-03-18, Arizona State, (18-15; 9-9 Pac-12), 37, 31, 0, 68, UConn, (20-15; 10-8 American), 24, 37, 0, 61
400785494, 2015-03-18, Charleston So, (19-12; 13-5 Big South), 33, 23, 0, 56, Old Dominion, (25-7; 13-5 C-USA), 27, 38, 0, 65
400785476, 2015-03-18, St Francis (BKN), (23-12; 15-3 NEC), 30, 44, 0, 74, Richmond, (20-13; 12-6 A 10), 41, 43, 0, 84
400785500, 2015-03-18, Green Bay, (24-9; 12-4 Horizon), 31, 25, 0, 56, Illinois State, (22-12; 11-7 MVC), 24, 45, 0, 69
400785502, 2015-03-18, Vanderbilt, (20-13; 9-9 SEC), 36, 39, 0, 75, Saint Mary's, (21-10; 13-5 WCC), 28, 36, 0, 64
400785475, 2015-03-18, South Dakota St, (24-10; 12-4 Summit), 47, 39, 0, 86, Colorado State, (27-7; 13-5 MW), 38, 38, 0, 76
400785985, 2015-03-20, South Dakota St, (24-11; 12-4 Summit), 27, 50, 0, 77, Vanderbilt, (21-13; 9-9 SEC), 33, 59, 0, 92
400785834, 2015-03-21, Alabama, (19-15; 8-10 SEC), 34, 32, 0, 66, Miami (FL), (23-12; 10-8 ACC), 30, 43, 0, 73
400785986, 2015-03-22, G Washington, (22-13; 10-8 A 10), 30, 47, 0, 77, Temple, (25-10; 13-5 American), 38, 52, 0, 90
400785987, 2015-03-22, Arizona State, (18-16; 9-9 Pac-12), 31, 29, 10, 70, Richmond, (21-13; 12-6 A 10), 32, 28, 16, 76
400785988, 2015-03-22, URI, (23-10; 13-5 A 10), 27, 38, 0, 65, Stanford, (21-13; 9-9 Pac-12), 31, 43, 0, 74
400785989, 2015-03-23, LA Tech, (27-8; 15-3 C-USA), 35, 49, 0, 84, Texas A&M, (21-12; 11-7 SEC), 34, 38, 0, 72
400785991, 2015-03-23, Illinois State, (22-13; 11-7 MVC), 22, 27, 0, 49, Old Dominion, (26-7; 13-5 C-USA), 27, 23, 0, 50
400785990, 2015-03-23, Murray State, (29-5; 16-0 OVC), 45, 38, 0, 83, Tulsa, (23-11; 14-4 American), 27, 35, 0, 62
400786513, 2015-03-24, Miami (FL), (24-12; 10-8 ACC), 18, 45, 0, 63, Richmond, (21-14; 12-6 A 10), 30, 31, 0, 61
400786515, 2015-03-24, Vanderbilt, (21-14; 9-9 SEC), 31, 44, 0, 75, Stanford, (22-13; 9-9 Pac-12), 36, 42, 0, 78
400786691, 2015-03-25, Murray State, (29-6; 16-0 OVC), 27, 42, 0, 69, Old Dominion, (27-7; 13-5 C-USA), 29, 43, 0, 72
400786654, 2015-03-25, LA Tech, (27-9; 15-3 C-USA), 33, 26, 0, 59, Temple, (26-10; 13-5 American), 41, 36, 0, 77
